Sample	Species	Taxonomy_ID	Taxonomy_level	Kraken_initial	Added_reads	Species_read_count	Species_read_fraction
C1_chow_A2_PL2_kneaddata	Firmicutes_A	14608	P	2781247	29585	2810832	0.60957
C1_chow_A2_PL2_kneaddata	Bacteroidota	4587	P	1534304	16546	1550850	0.33632
C1_chow_A2_PL2_kneaddata	Campylobacterota	8700	P	124809	5	124814	0.02707
C1_chow_A2_PL2_kneaddata	Desulfobacterota_A	11509	P	69891	195	70086	0.01520
C1_chow_A2_PL2_kneaddata	Firmicutes	12188	P	36029	2017	38046	0.00825
C1_chow_A2_PL2_kneaddata	Cyanobacteria	9876	P	7793	92	7885	0.00171
C1_chow_A2_PL2_kneaddata	Actinobacteriota	615	P	5787	50	5837	0.00127
C1_chow_A2_PL2_kneaddata	Proteobacteria	22518	P	2068	38	2106	0.00046
C1_chow_A2_PL2_kneaddata	Firmicutes_B	17289	P	263	23	286	0.00006
C1_chow_A2_PL2_kneaddata	Verrucomicrobiota	33333	P	184	15	199	0.00004
C1_chow_A2_PL2_kneaddata	Spirochaetota	32587	P	165	0	165	0.00004
C1_chow_A2_PL2_kneaddata	Firmicutes_C	17613	P	35	0	35	0.00001
C1_chow_A2_PL2_kneaddata	Firmicutes_I	18140	P	27	0	27	0.00001
C1_chow_A2_PL2_kneaddata	Deferribacterota	10822	P	12	0	12	0.00000
C1_chow_A2_PL2_kneaddata	Elusimicrobiota	11888	P	2	0	2	0.00000
C2_chow_A6_PL6_kneaddata	Firmicutes_A	14608	P	3234254	37393	3271647	0.51648
C2_chow_A6_PL6_kneaddata	Bacteroidota	4587	P	2595827	29390	2625217	0.41443
C2_chow_A6_PL6_kneaddata	Campylobacterota	8700	P	164971	7	164978	0.02604
C2_chow_A6_PL6_kneaddata	Desulfobacterota_A	11509	P	138336	321	138657	0.02189
C2_chow_A6_PL6_kneaddata	Firmicutes	12188	P	57711	2589	60300	0.00952
C2_chow_A6_PL6_kneaddata	Cyanobacteria	9876	P	37399	322	37721	0.00595
C2_chow_A6_PL6_kneaddata	Actinobacteriota	615	P	25544	317	25861	0.00408
C2_chow_A6_PL6_kneaddata	Proteobacteria	22518	P	7097	110	7207	0.00114
C2_chow_A6_PL6_kneaddata	Verrucomicrobiota	33333	P	1433	37	1470	0.00023
C2_chow_A6_PL6_kneaddata	Firmicutes_B	17289	P	856	84	940	0.00015
C2_chow_A6_PL6_kneaddata	Spirochaetota	32587	P	379	0	379	0.00006
C2_chow_A6_PL6_kneaddata	Firmicutes_I	18140	P	66	0	66	0.00001
C2_chow_A6_PL6_kneaddata	Firmicutes_C	17613	P	61	0	61	0.00001
C2_chow_A6_PL6_kneaddata	Deferribacterota	10822	P	21	0	21	0.00000
C2_chow_A6_PL6_kneaddata	Elusimicrobiota	11888	P	8	0	8	0.00000
C2_chow_A6_PL6_kneaddata	Thermotogota	33086	P	6	0	6	0.00000
C3_chow_C10_PL34_kneaddata	Firmicutes_A	14608	P	2915766	33488	2949254	0.50637
C3_chow_C10_PL34_kneaddata	Bacteroidota	4587	P	2316256	21242	2337498	0.40133
C3_chow_C10_PL34_kneaddata	Verrucomicrobiota	33333	P	391603	3898	395501	0.06791
C3_chow_C10_PL34_kneaddata	Desulfobacterota_A	11509	P	54415	193	54608	0.00938
C3_chow_C10_PL34_kneaddata	Firmicutes	12188	P	51309	2843	54152	0.00930
C3_chow_C10_PL34_kneaddata	Proteobacteria	22518	P	13407	94	13501	0.00232
C3_chow_C10_PL34_kneaddata	Actinobacteriota	615	P	10177	335	10512	0.00180
C3_chow_C10_PL34_kneaddata	Cyanobacteria	9876	P	5773	47	5820	0.00100
C3_chow_C10_PL34_kneaddata	Firmicutes_B	17289	P	2826	224	3050	0.00052
C3_chow_C10_PL34_kneaddata	Spirochaetota	32587	P	166	0	166	0.00003
C3_chow_C10_PL34_kneaddata	Campylobacterota	8700	P	119	0	119	0.00002
C3_chow_C10_PL34_kneaddata	Firmicutes_I	18140	P	41	0	41	0.00001
C3_chow_C10_PL34_kneaddata	Thermotogota	33086	P	32	0	32	0.00001
C3_chow_C10_PL34_kneaddata	Firmicutes_C	17613	P	27	0	27	0.00000
C3_chow_C10_PL34_kneaddata	Deferribacterota	10822	P	21	0	21	0.00000
C3_chow_C10_PL34_kneaddata	Elusimicrobiota	11888	P	3	0	3	0.00000
C4_chow_C12_PL36_kneaddata	Firmicutes_A	14608	P	2943125	38510	2981635	0.50818
C4_chow_C12_PL36_kneaddata	Bacteroidota	4587	P	2503114	20061	2523175	0.43004
C4_chow_C12_PL36_kneaddata	Verrucomicrobiota	33333	P	238435	2442	240877	0.04105
C4_chow_C12_PL36_kneaddata	Desulfobacterota_A	11509	P	49955	198	50153	0.00855
C4_chow_C12_PL36_kneaddata	Firmicutes	12188	P	44514	1926	46440	0.00792
C4_chow_C12_PL36_kneaddata	Proteobacteria	22518	P	12871	141	13012	0.00222
C4_chow_C12_PL36_kneaddata	Actinobacteriota	615	P	4982	142	5124	0.00087
C4_chow_C12_PL36_kneaddata	Cyanobacteria	9876	P	4017	35	4052	0.00069
C4_chow_C12_PL36_kneaddata	Firmicutes_B	17289	P	2312	190	2502	0.00043
C4_chow_C12_PL36_kneaddata	Spirochaetota	32587	P	133	0	133	0.00002
C4_chow_C12_PL36_kneaddata	Campylobacterota	8700	P	83	0	83	0.00001
C4_chow_C12_PL36_kneaddata	Thermotogota	33086	P	38	0	38	0.00001
C4_chow_C12_PL36_kneaddata	Deferribacterota	10822	P	27	0	27	0.00000
C4_chow_C12_PL36_kneaddata	Firmicutes_C	17613	P	26	0	26	0.00000
C4_chow_C12_PL36_kneaddata	Firmicutes_I	18140	P	23	0	23	0.00000
C4_chow_C12_PL36_kneaddata	Elusimicrobiota	11888	P	3	0	3	0.00000
C5_chow_D2_PL38_kneaddata	Bacteroidota	4587	P	3031873	25786	3057659	0.58131
C5_chow_D2_PL38_kneaddata	Firmicutes_A	14608	P	1984995	27470	2012465	0.38260
C5_chow_D2_PL38_kneaddata	Verrucomicrobiota	33333	P	72974	7475	80449	0.01529
C5_chow_D2_PL38_kneaddata	Desulfobacterota_A	11509	P	55109	125	55234	0.01050
C5_chow_D2_PL38_kneaddata	Firmicutes	12188	P	37871	3101	40972	0.00779
C5_chow_D2_PL38_kneaddata	Cyanobacteria	9876	P	5508	52	5560	0.00106
C5_chow_D2_PL38_kneaddata	Actinobacteriota	615	P	4131	40	4171	0.00079
C5_chow_D2_PL38_kneaddata	Proteobacteria	22518	P	2929	33	2962	0.00056
C5_chow_D2_PL38_kneaddata	Firmicutes_B	17289	P	158	10	168	0.00003
C5_chow_D2_PL38_kneaddata	Spirochaetota	32587	P	152	0	152	0.00003
C5_chow_D2_PL38_kneaddata	Campylobacterota	8700	P	46	0	46	0.00001
C5_chow_D2_PL38_kneaddata	Thermotogota	33086	P	40	0	40	0.00001
C5_chow_D2_PL38_kneaddata	Firmicutes_C	17613	P	16	0	16	0.00000
C5_chow_D2_PL38_kneaddata	Firmicutes_I	18140	P	14	0	14	0.00000
C5_chow_D2_PL38_kneaddata	Deferribacterota	10822	P	12	0	12	0.00000
C5_chow_D2_PL38_kneaddata	Elusimicrobiota	11888	P	3	0	3	0.00000
DRR014734_1_kneaddata_paired	Bacteroidota	4587	P	29361123	247224	29608347	0.79018
DRR014734_1_kneaddata_paired	Firmicutes_A	14608	P	7162609	43278	7205887	0.19231
DRR014734_1_kneaddata_paired	Firmicutes	12188	P	360685	3028	363713	0.00971
DRR014734_1_kneaddata_paired	Desulfobacterota_A	11509	P	125137	1257	126394	0.00337
DRR014734_1_kneaddata_paired	Deferribacterota	10822	P	59820	206	60026	0.00160
DRR014734_1_kneaddata_paired	Proteobacteria	22518	P	56263	194	56457	0.00151
DRR014734_1_kneaddata_paired	Actinobacteriota	615	P	30988	68	31056	0.00083
DRR014734_1_kneaddata_paired	Cyanobacteria	9876	P	11810	663	12473	0.00033
DRR014734_1_kneaddata_paired	Verrucomicrobiota	33333	P	3976	174	4150	0.00011
DRR014734_1_kneaddata_paired	Firmicutes_B	17289	P	501	17	518	0.00001
DRR014734_1_kneaddata_paired	Spirochaetota	32587	P	494	1	495	0.00001
DRR014734_1_kneaddata_paired	Campylobacterota	8700	P	372	0	372	0.00001
DRR014734_1_kneaddata_paired	Firmicutes_C	17613	P	291	0	291	0.00001
DRR014734_1_kneaddata_paired	Firmicutes_I	18140	P	106	0	106	0.00000
DRR014734_1_kneaddata_paired	Elusimicrobiota	11888	P	30	0	30	0.00000
DRR014734_1_kneaddata_paired	Thermotogota	33086	P	15	0	15	0.00000
DRR014782_1_kneaddata_paired	Bacteroidota	4587	P	25071953	194135	25266088	0.74703
DRR014782_1_kneaddata_paired	Firmicutes_A	14608	P	7468625	34958	7503583	0.22185
DRR014782_1_kneaddata_paired	Firmicutes	12188	P	513720	3210	516930	0.01528
DRR014782_1_kneaddata_paired	Deferribacterota	10822	P	223627	854	224481	0.00664
DRR014782_1_kneaddata_paired	Desulfobacterota_A	11509	P	217806	2567	220373	0.00652
DRR014782_1_kneaddata_paired	Proteobacteria	22518	P	46346	146	46492	0.00137
DRR014782_1_kneaddata_paired	Actinobacteriota	615	P	22278	51	22329	0.00066
DRR014782_1_kneaddata_paired	Cyanobacteria	9876	P	10900	614	11514	0.00034
DRR014782_1_kneaddata_paired	Firmicutes_B	17289	P	7156	269	7425	0.00022
DRR014782_1_kneaddata_paired	Campylobacterota	8700	P	881	0	881	0.00003
DRR014782_1_kneaddata_paired	Spirochaetota	32587	P	818	2	820	0.00002
DRR014782_1_kneaddata_paired	Verrucomicrobiota	33333	P	636	32	668	0.00002
DRR014782_1_kneaddata_paired	Firmicutes_C	17613	P	257	0	257	0.00001
DRR014782_1_kneaddata_paired	Firmicutes_I	18140	P	213	0	213	0.00001
DRR014782_1_kneaddata_paired	Thermotogota	33086	P	43	0	43	0.00000
DRR014782_1_kneaddata_paired	Elusimicrobiota	11888	P	36	0	36	0.00000
DRR014783_1_kneaddata_paired	Bacteroidota	4587	P	24851835	237637	25089472	0.70103
DRR014783_1_kneaddata_paired	Firmicutes_A	14608	P	6310319	35850	6346169	0.17732
DRR014783_1_kneaddata_paired	Firmicutes	12188	P	3751151	16488	3767639	0.10527
DRR014783_1_kneaddata_paired	Proteobacteria	22518	P	419938	869	420807	0.01176
DRR014783_1_kneaddata_paired	Deferribacterota	10822	P	70143	308	70451	0.00197
DRR014783_1_kneaddata_paired	Desulfobacterota_A	11509	P	69808	1055	70863	0.00198
DRR014783_1_kneaddata_paired	Actinobacteriota	615	P	8590	28	8618	0.00024
DRR014783_1_kneaddata_paired	Cyanobacteria	9876	P	8017	514	8531	0.00024
DRR014783_1_kneaddata_paired	Firmicutes_B	17289	P	4233	183	4416	0.00012
DRR014783_1_kneaddata_paired	Spirochaetota	32587	P	685	2	687	0.00002
DRR014783_1_kneaddata_paired	Campylobacterota	8700	P	576	0	576	0.00002
DRR014783_1_kneaddata_paired	Verrucomicrobiota	33333	P	569	34	603	0.00002
DRR014783_1_kneaddata_paired	Firmicutes_I	18140	P	230	0	230	0.00001
DRR014783_1_kneaddata_paired	Firmicutes_C	17613	P	129	0	129	0.00000
DRR014783_1_kneaddata_paired	Thermotogota	33086	P	37	0	37	0.00000
DRR014783_1_kneaddata_paired	Elusimicrobiota	11888	P	28	0	28	0.00000
DRR014784_1_kneaddata_paired	Firmicutes_A	14608	P	22791773	116759	22908532	0.50335
DRR014784_1_kneaddata_paired	Bacteroidota	4587	P	19590905	155985	19746890	0.43389
DRR014784_1_kneaddata_paired	Desulfobacterota_A	11509	P	1222358	13261	1235619	0.02715
DRR014784_1_kneaddata_paired	Deferribacterota	10822	P	1099626	3947	1103573	0.02425
DRR014784_1_kneaddata_paired	Firmicutes	12188	P	422080	6595	428675	0.00942
DRR014784_1_kneaddata_paired	Proteobacteria	22518	P	39800	179	39979	0.00088
DRR014784_1_kneaddata_paired	Actinobacteriota	615	P	26409	75	26484	0.00058
DRR014784_1_kneaddata_paired	Cyanobacteria	9876	P	13681	641	14322	0.00031
DRR014784_1_kneaddata_paired	Firmicutes_B	17289	P	2484	87	2571	0.00006
DRR014784_1_kneaddata_paired	Verrucomicrobiota	33333	P	1437	71	1508	0.00003
DRR014784_1_kneaddata_paired	Campylobacterota	8700	P	1329	0	1329	0.00003
DRR014784_1_kneaddata_paired	Spirochaetota	32587	P	1012	2	1014	0.00002
DRR014784_1_kneaddata_paired	Firmicutes_I	18140	P	486	0	486	0.00001
DRR014784_1_kneaddata_paired	Firmicutes_C	17613	P	444	0	444	0.00001
DRR014784_1_kneaddata_paired	Thermotogota	33086	P	270	0	270	0.00001
DRR014784_1_kneaddata_paired	Elusimicrobiota	11888	P	63	0	63	0.00000
DRR014785_1_kneaddata_paired	Bacteroidota	4587	P	25608505	202549	25811054	0.69156
DRR014785_1_kneaddata_paired	Firmicutes_A	14608	P	10096316	50864	10147180	0.27188
DRR014785_1_kneaddata_paired	Deferribacterota	10822	P	448454	1614	450068	0.01206
DRR014785_1_kneaddata_paired	Desulfobacterota_A	11509	P	399993	4101	404094	0.01083
DRR014785_1_kneaddata_paired	Firmicutes	12188	P	382004	4046	386050	0.01034
DRR014785_1_kneaddata_paired	Proteobacteria	22518	P	78590	253	78843	0.00211
DRR014785_1_kneaddata_paired	Actinobacteriota	615	P	24454	83	24537	0.00066
DRR014785_1_kneaddata_paired	Cyanobacteria	9876	P	12290	690	12980	0.00035
DRR014785_1_kneaddata_paired	Firmicutes_B	17289	P	5137	181	5318	0.00014
DRR014785_1_kneaddata_paired	Spirochaetota	32587	P	756	1	757	0.00002
DRR014785_1_kneaddata_paired	Campylobacterota	8700	P	647	0	647	0.00002
DRR014785_1_kneaddata_paired	Verrucomicrobiota	33333	P	642	30	672	0.00002
DRR014785_1_kneaddata_paired	Firmicutes_C	17613	P	239	0	239	0.00001
DRR014785_1_kneaddata_paired	Firmicutes_I	18140	P	237	0	237	0.00001
DRR014785_1_kneaddata_paired	Elusimicrobiota	11888	P	40	0	40	0.00000
DRR014785_1_kneaddata_paired	Thermotogota	33086	P	34	0	34	0.00000
DRR014786_1_kneaddata_paired	Bacteroidota	4587	P	20159998	162742	20322740	0.57684
DRR014786_1_kneaddata_paired	Firmicutes_A	14608	P	13213305	63499	13276804	0.37685
DRR014786_1_kneaddata_paired	Firmicutes	12188	P	986802	5072	991874	0.02815
DRR014786_1_kneaddata_paired	Deferribacterota	10822	P	331164	1104	332268	0.00943
DRR014786_1_kneaddata_paired	Desulfobacterota_A	11509	P	238875	2469	241344	0.00685
DRR014786_1_kneaddata_paired	Proteobacteria	22518	P	27946	137	28083	0.00080
DRR014786_1_kneaddata_paired	Actinobacteriota	615	P	19184	50	19234	0.00055
DRR014786_1_kneaddata_paired	Cyanobacteria	9876	P	10005	446	10451	0.00030
DRR014786_1_kneaddata_paired	Firmicutes_B	17289	P	4418	144	4562	0.00013
DRR014786_1_kneaddata_paired	Spirochaetota	32587	P	947	2	949	0.00003
DRR014786_1_kneaddata_paired	Campylobacterota	8700	P	921	0	921	0.00003
DRR014786_1_kneaddata_paired	Verrucomicrobiota	33333	P	887	39	926	0.00003
DRR014786_1_kneaddata_paired	Firmicutes_I	18140	P	347	0	347	0.00001
DRR014786_1_kneaddata_paired	Firmicutes_C	17613	P	266	0	266	0.00001
DRR014786_1_kneaddata_paired	Elusimicrobiota	11888	P	61	0	61	0.00000
DRR014786_1_kneaddata_paired	Thermotogota	33086	P	56	0	56	0.00000
DRR121530_1_kneaddata_paired	Firmicutes	12188	P	1731961	5342	1737303	0.90397
DRR121530_1_kneaddata_paired	Actinobacteriota	615	P	85208	425	85633	0.04456
DRR121530_1_kneaddata_paired	Firmicutes_A	14608	P	55247	131	55378	0.02882
DRR121530_1_kneaddata_paired	Bacteroidota	4587	P	24690	46	24736	0.01287
DRR121530_1_kneaddata_paired	Verrucomicrobiota	33333	P	9003	31	9034	0.00470
DRR121530_1_kneaddata_paired	Proteobacteria	22518	P	8982	3	8985	0.00468
DRR121530_1_kneaddata_paired	Cyanobacteria	9876	P	468	1	469	0.00024
DRR121530_1_kneaddata_paired	Campylobacterota	8700	P	233	0	233	0.00012
DRR121530_1_kneaddata_paired	Desulfobacterota_A	11509	P	44	0	44	0.00002
DRR121530_1_kneaddata_paired	Spirochaetota	32587	P	19	0	19	0.00001
DRR121530_1_kneaddata_paired	Firmicutes_I	18140	P	15	0	15	0.00001
DRR121530_1_kneaddata_paired	Deferribacterota	10822	P	8	0	8	0.00000
DRR121530_1_kneaddata_paired	Firmicutes_C	17613	P	4	0	4	0.00000
DRR121530_1_kneaddata_paired	Firmicutes_B	17289	P	2	0	2	0.00000
DRR121531_1_kneaddata_paired	Firmicutes	12188	P	2044291	6398	2050689	0.88579
DRR121531_1_kneaddata_paired	Actinobacteriota	615	P	139242	691	139933	0.06044
DRR121531_1_kneaddata_paired	Firmicutes_A	14608	P	67539	161	67700	0.02924
DRR121531_1_kneaddata_paired	Bacteroidota	4587	P	31822	60	31882	0.01377
DRR121531_1_kneaddata_paired	Verrucomicrobiota	33333	P	12468	45	12513	0.00541
DRR121531_1_kneaddata_paired	Proteobacteria	22518	P	11325	4	11329	0.00489
DRR121531_1_kneaddata_paired	Cyanobacteria	9876	P	585	2	587	0.00025
DRR121531_1_kneaddata_paired	Campylobacterota	8700	P	299	0	299	0.00013
DRR121531_1_kneaddata_paired	Desulfobacterota_A	11509	P	91	0	91	0.00004
DRR121531_1_kneaddata_paired	Firmicutes_I	18140	P	23	0	23	0.00001
DRR121531_1_kneaddata_paired	Spirochaetota	32587	P	16	0	16	0.00001
DRR121531_1_kneaddata_paired	Deferribacterota	10822	P	14	0	14	0.00001
DRR121531_1_kneaddata_paired	Firmicutes_B	17289	P	7	0	7	0.00000
DRR121531_1_kneaddata_paired	Firmicutes_C	17613	P	7	0	7	0.00000
DRR121531_1_kneaddata_paired	Thermotogota	33086	P	2	0	2	0.00000
DRR121532_1_kneaddata_paired	Firmicutes	12188	P	2047917	6194	2054111	0.90852
DRR121532_1_kneaddata_paired	Actinobacteriota	615	P	89706	448	90154	0.03987
DRR121532_1_kneaddata_paired	Firmicutes_A	14608	P	65199	152	65351	0.02890
DRR121532_1_kneaddata_paired	Bacteroidota	4587	P	29084	54	29138	0.01289
DRR121532_1_kneaddata_paired	Proteobacteria	22518	P	10878	4	10882	0.00481
DRR121532_1_kneaddata_paired	Verrucomicrobiota	33333	P	10372	35	10407	0.00460
DRR121532_1_kneaddata_paired	Cyanobacteria	9876	P	491	2	493	0.00022
DRR121532_1_kneaddata_paired	Campylobacterota	8700	P	267	0	267	0.00012
DRR121532_1_kneaddata_paired	Desulfobacterota_A	11509	P	76	0	76	0.00003
DRR121532_1_kneaddata_paired	Firmicutes_I	18140	P	23	0	23	0.00001
DRR121532_1_kneaddata_paired	Spirochaetota	32587	P	22	0	22	0.00001
DRR121532_1_kneaddata_paired	Deferribacterota	10822	P	10	0	10	0.00000
DRR121532_1_kneaddata_paired	Firmicutes_B	17289	P	2	0	2	0.00000
DRR121532_1_kneaddata_paired	Firmicutes_C	17613	P	1	0	1	0.00000
DRR121533_1_kneaddata_paired	Firmicutes	12188	P	1778263	4581	1782844	0.88316
DRR121533_1_kneaddata_paired	Actinobacteriota	615	P	92302	434	92736	0.04594
DRR121533_1_kneaddata_paired	Firmicutes_A	14608	P	80400	151	80551	0.03990
DRR121533_1_kneaddata_paired	Bacteroidota	4587	P	43302	68	43370	0.02148
DRR121533_1_kneaddata_paired	Proteobacteria	22518	P	11377	3	11380	0.00564
DRR121533_1_kneaddata_paired	Verrucomicrobiota	33333	P	7036	20	7056	0.00350
DRR121533_1_kneaddata_paired	Cyanobacteria	9876	P	481	1	482	0.00024
DRR121533_1_kneaddata_paired	Campylobacterota	8700	P	129	0	129	0.00006
DRR121533_1_kneaddata_paired	Desulfobacterota_A	11509	P	102	0	102	0.00005
DRR121533_1_kneaddata_paired	Spirochaetota	32587	P	27	0	27	0.00001
DRR121533_1_kneaddata_paired	Firmicutes_I	18140	P	11	0	11	0.00001
DRR121533_1_kneaddata_paired	Deferribacterota	10822	P	8	0	8	0.00000
DRR121533_1_kneaddata_paired	Firmicutes_B	17289	P	6	0	6	0.00000
DRR121533_1_kneaddata_paired	Firmicutes_C	17613	P	5	0	5	0.00000
DRR121533_1_kneaddata_paired	Thermotogota	33086	P	2	0	2	0.00000
DRR121534_1_kneaddata_paired	Firmicutes	12188	P	1966723	5125	1971848	0.87457
DRR121534_1_kneaddata_paired	Actinobacteriota	615	P	118225	555	118780	0.05268
DRR121534_1_kneaddata_paired	Firmicutes_A	14608	P	91081	175	91256	0.04047
DRR121534_1_kneaddata_paired	Bacteroidota	4587	P	50033	78	50111	0.02223
DRR121534_1_kneaddata_paired	Proteobacteria	22518	P	13110	4	13114	0.00582
DRR121534_1_kneaddata_paired	Verrucomicrobiota	33333	P	8596	24	8620	0.00382
DRR121534_1_kneaddata_paired	Cyanobacteria	9876	P	599	1	600	0.00027
DRR121534_1_kneaddata_paired	Campylobacterota	8700	P	132	0	132	0.00006
DRR121534_1_kneaddata_paired	Desulfobacterota_A	11509	P	105	0	105	0.00005
DRR121534_1_kneaddata_paired	Spirochaetota	32587	P	35	0	35	0.00002
DRR121534_1_kneaddata_paired	Firmicutes_I	18140	P	17	0	17	0.00001
DRR121534_1_kneaddata_paired	Deferribacterota	10822	P	11	0	11	0.00000
DRR121534_1_kneaddata_paired	Firmicutes_B	17289	P	8	0	8	0.00000
DRR121534_1_kneaddata_paired	Firmicutes_C	17613	P	5	0	5	0.00000
DRR121534_1_kneaddata_paired	Thermotogota	33086	P	3	0	3	0.00000
DRR121535_1_kneaddata_paired	Firmicutes	12188	P	1411845	3740	1415585	0.88989
DRR121535_1_kneaddata_paired	Firmicutes_A	14608	P	63713	125	63838	0.04013
DRR121535_1_kneaddata_paired	Actinobacteriota	615	P	62349	306	62655	0.03939
DRR121535_1_kneaddata_paired	Bacteroidota	4587	P	33759	54	33813	0.02126
DRR121535_1_kneaddata_paired	Proteobacteria	22518	P	8892	3	8895	0.00559
DRR121535_1_kneaddata_paired	Verrucomicrobiota	33333	P	5293	15	5308	0.00334
DRR121535_1_kneaddata_paired	Cyanobacteria	9876	P	394	1	395	0.00025
DRR121535_1_kneaddata_paired	Campylobacterota	8700	P	123	0	123	0.00008
DRR121535_1_kneaddata_paired	Desulfobacterota_A	11509	P	72	0	72	0.00005
DRR121535_1_kneaddata_paired	Spirochaetota	32587	P	27	0	27	0.00002
DRR121535_1_kneaddata_paired	Deferribacterota	10822	P	15	0	15	0.00001
DRR121535_1_kneaddata_paired	Firmicutes_I	18140	P	12	0	12	0.00001
DRR121535_1_kneaddata_paired	Firmicutes_B	17289	P	8	0	8	0.00001
DRR121535_1_kneaddata_paired	Firmicutes_C	17613	P	1	0	1	0.00000
DRR121535_1_kneaddata_paired	Thermotogota	33086	P	1	0	1	0.00000
DRR121536_1_kneaddata_paired	Firmicutes	12188	P	1956057	6800	1962857	0.89443
DRR121536_1_kneaddata_paired	Bacteroidota	4587	P	93048	183	93231	0.04248
DRR121536_1_kneaddata_paired	Actinobacteriota	615	P	79015	329	79344	0.03616
DRR121536_1_kneaddata_paired	Firmicutes_A	14608	P	25345	81	25426	0.01159
DRR121536_1_kneaddata_paired	Verrucomicrobiota	33333	P	21388	84	21472	0.00978
DRR121536_1_kneaddata_paired	Proteobacteria	22518	P	11598	5	11603	0.00529
DRR121536_1_kneaddata_paired	Cyanobacteria	9876	P	401	2	403	0.00018
DRR121536_1_kneaddata_paired	Campylobacterota	8700	P	103	0	103	0.00005
DRR121536_1_kneaddata_paired	Desulfobacterota_A	11509	P	34	0	34	0.00002
DRR121536_1_kneaddata_paired	Spirochaetota	32587	P	20	0	20	0.00001
DRR121536_1_kneaddata_paired	Deferribacterota	10822	P	14	0	14	0.00001
DRR121536_1_kneaddata_paired	Firmicutes_I	18140	P	12	0	12	0.00001
DRR121536_1_kneaddata_paired	Firmicutes_B	17289	P	10	0	10	0.00000
DRR121536_1_kneaddata_paired	Firmicutes_C	17613	P	1	0	1	0.00000
DRR121537_1_kneaddata_paired	Firmicutes	12188	P	2081992	7160	2089152	0.88902
DRR121537_1_kneaddata_paired	Bacteroidota	4587	P	102967	200	103167	0.04390
DRR121537_1_kneaddata_paired	Actinobacteriota	615	P	92646	378	93024	0.03959
DRR121537_1_kneaddata_paired	Firmicutes_A	14608	P	27361	88	27449	0.01168
DRR121537_1_kneaddata_paired	Verrucomicrobiota	33333	P	23843	89	23932	0.01018
DRR121537_1_kneaddata_paired	Proteobacteria	22518	P	12576	5	12581	0.00535
DRR121537_1_kneaddata_paired	Cyanobacteria	9876	P	449	2	451	0.00019
DRR121537_1_kneaddata_paired	Campylobacterota	8700	P	102	0	102	0.00004
DRR121537_1_kneaddata_paired	Desulfobacterota_A	11509	P	30	0	30	0.00001
DRR121537_1_kneaddata_paired	Deferribacterota	10822	P	15	0	15	0.00001
DRR121537_1_kneaddata_paired	Spirochaetota	32587	P	15	0	15	0.00001
DRR121537_1_kneaddata_paired	Firmicutes_I	18140	P	12	0	12	0.00001
DRR121537_1_kneaddata_paired	Firmicutes_B	17289	P	8	0	8	0.00000
DRR121537_1_kneaddata_paired	Firmicutes_C	17613	P	3	0	3	0.00000
DRR121537_1_kneaddata_paired	Thermotogota	33086	P	2	0	2	0.00000
DRR121538_1_kneaddata_paired	Firmicutes	12188	P	1766178	6160	1772338	0.89781
DRR121538_1_kneaddata_paired	Bacteroidota	4587	P	84543	168	84711	0.04291
DRR121538_1_kneaddata_paired	Actinobacteriota	615	P	63111	279	63390	0.03211
DRR121538_1_kneaddata_paired	Firmicutes_A	14608	P	23126	74	23200	0.01175
DRR121538_1_kneaddata_paired	Verrucomicrobiota	33333	P	19251	75	19326	0.00979
DRR121538_1_kneaddata_paired	Proteobacteria	22518	P	10584	5	10589	0.00536
DRR121538_1_kneaddata_paired	Cyanobacteria	9876	P	346	1	347	0.00018
DRR121538_1_kneaddata_paired	Campylobacterota	8700	P	96	0	96	0.00005
DRR121538_1_kneaddata_paired	Spirochaetota	32587	P	24	0	24	0.00001
DRR121538_1_kneaddata_paired	Desulfobacterota_A	11509	P	20	0	20	0.00001
DRR121538_1_kneaddata_paired	Firmicutes_B	17289	P	8	0	8	0.00000
DRR121538_1_kneaddata_paired	Firmicutes_I	18140	P	8	0	8	0.00000
DRR121538_1_kneaddata_paired	Deferribacterota	10822	P	7	0	7	0.00000
DRR121538_1_kneaddata_paired	Firmicutes_C	17613	P	5	0	5	0.00000
DRR121538_1_kneaddata_paired	Elusimicrobiota	11888	P	1	0	1	0.00000
DRR121538_1_kneaddata_paired	Thermotogota	33086	P	1	0	1	0.00000
DRR121539_1_kneaddata_paired	Firmicutes	12188	P	2030567	3426	2033993	0.88262
DRR121539_1_kneaddata_paired	Actinobacteriota	615	P	130909	470	131379	0.05701
DRR121539_1_kneaddata_paired	Bacteroidota	4587	P	81382	72	81454	0.03535
DRR121539_1_kneaddata_paired	Firmicutes_A	14608	P	32304	40	32344	0.01404
DRR121539_1_kneaddata_paired	Proteobacteria	22518	P	14853	2	14855	0.00645
DRR121539_1_kneaddata_paired	Verrucomicrobiota	33333	P	9720	17	9737	0.00423
DRR121539_1_kneaddata_paired	Cyanobacteria	9876	P	527	1	528	0.00023
DRR121539_1_kneaddata_paired	Campylobacterota	8700	P	109	0	109	0.00005
DRR121539_1_kneaddata_paired	Desulfobacterota_A	11509	P	51	0	51	0.00002
DRR121539_1_kneaddata_paired	Spirochaetota	32587	P	24	0	24	0.00001
DRR121539_1_kneaddata_paired	Firmicutes_I	18140	P	8	0	8	0.00000
DRR121539_1_kneaddata_paired	Deferribacterota	10822	P	6	0	6	0.00000
DRR121539_1_kneaddata_paired	Firmicutes_B	17289	P	5	0	5	0.00000
DRR121540_1_kneaddata_paired	Firmicutes	12188	P	1759930	2316	1762246	0.89695
DRR121540_1_kneaddata_paired	Actinobacteriota	615	P	86942	250	87192	0.04438
DRR121540_1_kneaddata_paired	Bacteroidota	4587	P	66751	47	66798	0.03400
DRR121540_1_kneaddata_paired	Firmicutes_A	14608	P	28048	27	28075	0.01429
DRR121540_1_kneaddata_paired	Proteobacteria	22518	P	12387	1	12388	0.00631
DRR121540_1_kneaddata_paired	Verrucomicrobiota	33333	P	7377	10	7387	0.00376
DRR121540_1_kneaddata_paired	Cyanobacteria	9876	P	444	0	444	0.00023
DRR121540_1_kneaddata_paired	Campylobacterota	8700	P	82	0	82	0.00004
DRR121540_1_kneaddata_paired	Desulfobacterota_A	11509	P	58	0	58	0.00003
DRR121540_1_kneaddata_paired	Spirochaetota	32587	P	20	0	20	0.00001
DRR121540_1_kneaddata_paired	Deferribacterota	10822	P	6	0	6	0.00000
DRR121540_1_kneaddata_paired	Firmicutes_C	17613	P	4	0	4	0.00000
DRR121540_1_kneaddata_paired	Firmicutes_I	18140	P	4	0	4	0.00000
DRR121540_1_kneaddata_paired	Firmicutes_B	17289	P	2	0	2	0.00000
DRR121540_1_kneaddata_paired	Thermotogota	33086	P	1	0	1	0.00000
DRR121541_1_kneaddata_paired	Firmicutes	12188	P	1403480	1796	1405276	0.90251
DRR121541_1_kneaddata_paired	Actinobacteriota	615	P	61752	177	61929	0.03977
DRR121541_1_kneaddata_paired	Bacteroidota	4587	P	51686	36	51722	0.03322
DRR121541_1_kneaddata_paired	Firmicutes_A	14608	P	21914	21	21935	0.01409
DRR121541_1_kneaddata_paired	Proteobacteria	22518	P	10003	1	10004	0.00643
DRR121541_1_kneaddata_paired	Verrucomicrobiota	33333	P	5692	7	5699	0.00366
DRR121541_1_kneaddata_paired	Cyanobacteria	9876	P	357	0	357	0.00023
DRR121541_1_kneaddata_paired	Campylobacterota	8700	P	78	0	78	0.00005
DRR121541_1_kneaddata_paired	Desulfobacterota_A	11509	P	36	0	36	0.00002
DRR121541_1_kneaddata_paired	Spirochaetota	32587	P	9	0	9	0.00001
DRR121541_1_kneaddata_paired	Firmicutes_I	18140	P	7	0	7	0.00000
DRR121541_1_kneaddata_paired	Deferribacterota	10822	P	6	0	6	0.00000
DRR121541_1_kneaddata_paired	Firmicutes_C	17613	P	4	0	4	0.00000
DRR121541_1_kneaddata_paired	Firmicutes_B	17289	P	3	0	3	0.00000
DRR121542_1_kneaddata_paired	Firmicutes	12188	P	1541719	2372	1544091	0.88282
DRR121542_1_kneaddata_paired	Bacteroidota	4587	P	73853	66	73919	0.04226
DRR121542_1_kneaddata_paired	Actinobacteriota	615	P	65547	227	65774	0.03761
DRR121542_1_kneaddata_paired	Firmicutes_A	14608	P	47896	51	47947	0.02741
DRR121542_1_kneaddata_paired	Proteobacteria	22518	P	10428	2	10430	0.00596
DRR121542_1_kneaddata_paired	Verrucomicrobiota	33333	P	6144	10	6154	0.00352
DRR121542_1_kneaddata_paired	Cyanobacteria	9876	P	578	0	578	0.00033
DRR121542_1_kneaddata_paired	Campylobacterota	8700	P	68	0	68	0.00004
DRR121542_1_kneaddata_paired	Desulfobacterota_A	11509	P	35	0	35	0.00002
DRR121542_1_kneaddata_paired	Spirochaetota	32587	P	19	0	19	0.00001
DRR121542_1_kneaddata_paired	Firmicutes_I	18140	P	10	0	10	0.00001
DRR121542_1_kneaddata_paired	Deferribacterota	10822	P	6	0	6	0.00000
DRR121542_1_kneaddata_paired	Firmicutes_B	17289	P	3	0	3	0.00000
DRR121542_1_kneaddata_paired	Thermotogota	33086	P	2	0	2	0.00000
DRR121543_1_kneaddata_paired	Firmicutes	12188	P	1661500	2567	1664067	0.87922
DRR121543_1_kneaddata_paired	Bacteroidota	4587	P	81993	73	82066	0.04336
DRR121543_1_kneaddata_paired	Actinobacteriota	615	P	75190	259	75449	0.03986
DRR121543_1_kneaddata_paired	Firmicutes_A	14608	P	51803	54	51857	0.02740
DRR121543_1_kneaddata_paired	Proteobacteria	22518	P	11436	2	11438	0.00604
DRR121543_1_kneaddata_paired	Verrucomicrobiota	33333	P	6957	11	6968	0.00368
DRR121543_1_kneaddata_paired	Cyanobacteria	9876	P	651	1	652	0.00034
DRR121543_1_kneaddata_paired	Campylobacterota	8700	P	90	0	90	0.00005
DRR121543_1_kneaddata_paired	Desulfobacterota_A	11509	P	36	0	36	0.00002
DRR121543_1_kneaddata_paired	Firmicutes_I	18140	P	12	0	12	0.00001
DRR121543_1_kneaddata_paired	Spirochaetota	32587	P	7	0	7	0.00000
DRR121543_1_kneaddata_paired	Deferribacterota	10822	P	6	0	6	0.00000
DRR121543_1_kneaddata_paired	Firmicutes_B	17289	P	2	0	2	0.00000
DRR121543_1_kneaddata_paired	Firmicutes_C	17613	P	2	0	2	0.00000
DRR121543_1_kneaddata_paired	Thermotogota	33086	P	1	0	1	0.00000
DRR121544_1_kneaddata_paired	Firmicutes	12188	P	1545992	2363	1548355	0.88768
DRR121544_1_kneaddata_paired	Bacteroidota	4587	P	73154	65	73219	0.04198
DRR121544_1_kneaddata_paired	Actinobacteriota	615	P	58444	204	58648	0.03362
DRR121544_1_kneaddata_paired	Firmicutes_A	14608	P	46767	49	46816	0.02684
DRR121544_1_kneaddata_paired	Proteobacteria	22518	P	10393	1	10394	0.00596
DRR121544_1_kneaddata_paired	Verrucomicrobiota	33333	P	6089	10	6099	0.00350
DRR121544_1_kneaddata_paired	Cyanobacteria	9876	P	581	0	581	0.00033
DRR121544_1_kneaddata_paired	Campylobacterota	8700	P	82	0	82	0.00005
DRR121544_1_kneaddata_paired	Desulfobacterota_A	11509	P	32	0	32	0.00002
DRR121544_1_kneaddata_paired	Spirochaetota	32587	P	14	0	14	0.00001
DRR121544_1_kneaddata_paired	Firmicutes_I	18140	P	9	0	9	0.00001
DRR121544_1_kneaddata_paired	Deferribacterota	10822	P	6	0	6	0.00000
DRR121544_1_kneaddata_paired	Firmicutes_B	17289	P	5	0	5	0.00000
DRR121544_1_kneaddata_paired	Firmicutes_C	17613	P	1	0	1	0.00000
E1_choline_B2_PL14_kneaddata	Bacteroidota	4587	P	4137386	41713	4179099	0.57512
E1_choline_B2_PL14_kneaddata	Firmicutes_A	14608	P	2666887	32683	2699570	0.37151
E1_choline_B2_PL14_kneaddata	Desulfobacterota_A	11509	P	122700	296	122996	0.01693
E1_choline_B2_PL14_kneaddata	Firmicutes	12188	P	115575	3665	119240	0.01641
E1_choline_B2_PL14_kneaddata	Campylobacterota	8700	P	88963	4	88967	0.01224
E1_choline_B2_PL14_kneaddata	Actinobacteriota	615	P	26716	447	27163	0.00374
E1_choline_B2_PL14_kneaddata	Proteobacteria	22518	P	19609	177	19786	0.00272
E1_choline_B2_PL14_kneaddata	Cyanobacteria	9876	P	8416	174	8590	0.00118
E1_choline_B2_PL14_kneaddata	Spirochaetota	32587	P	471	0	471	0.00006
E1_choline_B2_PL14_kneaddata	Verrucomicrobiota	33333	P	252	20	272	0.00004
E1_choline_B2_PL14_kneaddata	Firmicutes_B	17289	P	170	17	187	0.00003
E1_choline_B2_PL14_kneaddata	Firmicutes_I	18140	P	52	0	52	0.00001
E1_choline_B2_PL14_kneaddata	Firmicutes_C	17613	P	42	0	42	0.00001
E1_choline_B2_PL14_kneaddata	Deferribacterota	10822	P	17	0	17	0.00000
E1_choline_B2_PL14_kneaddata	Elusimicrobiota	11888	P	3	0	3	0.00000
E1_choline_B2_PL14_kneaddata	Thermotogota	33086	P	2	0	2	0.00000
E2_choline_B5_PL17_kneaddata	Bacteroidota	4587	P	2782698	32634	2815332	0.51042
E2_choline_B5_PL17_kneaddata	Firmicutes_A	14608	P	2216358	19555	2235913	0.40537
E2_choline_B5_PL17_kneaddata	Firmicutes	12188	P	141600	5507	147107	0.02667
E2_choline_B5_PL17_kneaddata	Campylobacterota	8700	P	137463	5	137468	0.02492
E2_choline_B5_PL17_kneaddata	Desulfobacterota_A	11509	P	96051	225	96276	0.01745
E2_choline_B5_PL17_kneaddata	Proteobacteria	22518	P	28663	111	28774	0.00522
E2_choline_B5_PL17_kneaddata	Actinobacteriota	615	P	21993	180	22173	0.00402
E2_choline_B5_PL17_kneaddata	Firmicutes_B	17289	P	16920	1363	18283	0.00331
E2_choline_B5_PL17_kneaddata	Cyanobacteria	9876	P	13610	125	13735	0.00249
E2_choline_B5_PL17_kneaddata	Spirochaetota	32587	P	302	0	302	0.00005
E2_choline_B5_PL17_kneaddata	Verrucomicrobiota	33333	P	198	10	208	0.00004
E2_choline_B5_PL17_kneaddata	Firmicutes_I	18140	P	66	0	66	0.00001
E2_choline_B5_PL17_kneaddata	Firmicutes_C	17613	P	19	0	19	0.00000
E2_choline_B5_PL17_kneaddata	Deferribacterota	10822	P	16	0	16	0.00000
E2_choline_B5_PL17_kneaddata	Elusimicrobiota	11888	P	5	0	5	0.00000
E3_choline_E7_PL55_kneaddata	Bacteroidota	4587	P	2920361	34925	2955286	0.61334
E3_choline_E7_PL55_kneaddata	Firmicutes_A	14608	P	1625297	9045	1634342	0.33919
E3_choline_E7_PL55_kneaddata	Verrucomicrobiota	33333	P	149445	1332	150777	0.03129
E3_choline_E7_PL55_kneaddata	Firmicutes	12188	P	61284	2417	63701	0.01322
E3_choline_E7_PL55_kneaddata	Actinobacteriota	615	P	11708	117	11825	0.00245
E3_choline_E7_PL55_kneaddata	Proteobacteria	22518	P	1334	25	1359	0.00028
E3_choline_E7_PL55_kneaddata	Cyanobacteria	9876	P	578	20	598	0.00012
E3_choline_E7_PL55_kneaddata	Desulfobacterota_A	11509	P	134	13	147	0.00003
E3_choline_E7_PL55_kneaddata	Campylobacterota	8700	P	132	0	132	0.00003
E3_choline_E7_PL55_kneaddata	Deferribacterota	10822	P	64	0	64	0.00001
E3_choline_E7_PL55_kneaddata	Firmicutes_B	17289	P	41	2	43	0.00001
E3_choline_E7_PL55_kneaddata	Spirochaetota	32587	P	34	0	34	0.00001
E3_choline_E7_PL55_kneaddata	Firmicutes_I	18140	P	28	0	28	0.00001
E3_choline_E7_PL55_kneaddata	Elusimicrobiota	11888	P	3	0	3	0.00000
E3_choline_E7_PL55_kneaddata	Firmicutes_C	17613	P	3	0	3	0.00000
E4_choline_E9_PL57_kneaddata	Firmicutes_A	14608	P	1818525	12174	1830699	0.45774
E4_choline_E9_PL57_kneaddata	Bacteroidota	4587	P	1588623	20141	1608764	0.40225
E4_choline_E9_PL57_kneaddata	Verrucomicrobiota	33333	P	342143	2720	344863	0.08623
E4_choline_E9_PL57_kneaddata	Desulfobacterota_A	11509	P	108258	119	108377	0.02710
E4_choline_E9_PL57_kneaddata	Firmicutes	12188	P	71073	5085	76158	0.01904
E4_choline_E9_PL57_kneaddata	Actinobacteriota	615	P	22556	251	22807	0.00570
E4_choline_E9_PL57_kneaddata	Proteobacteria	22518	P	4103	16	4119	0.00103
E4_choline_E9_PL57_kneaddata	Cyanobacteria	9876	P	1650	18	1668	0.00042
E4_choline_E9_PL57_kneaddata	Firmicutes_B	17289	P	1496	95	1591	0.00040
E4_choline_E9_PL57_kneaddata	Spirochaetota	32587	P	270	0	270	0.00007
E4_choline_E9_PL57_kneaddata	Campylobacterota	8700	P	89	0	89	0.00002
E4_choline_E9_PL57_kneaddata	Firmicutes_I	18140	P	24	0	24	0.00001
E4_choline_E9_PL57_kneaddata	Deferribacterota	10822	P	11	0	11	0.00000
E4_choline_E9_PL57_kneaddata	Firmicutes_C	17613	P	7	0	7	0.00000
E4_choline_E9_PL57_kneaddata	Elusimicrobiota	11888	P	3	0	3	0.00000
E5_choline_E10_PL58_kneaddata	Bacteroidota	4587	P	2497366	29671	2527037	0.45754
E5_choline_E10_PL58_kneaddata	Firmicutes_A	14608	P	2130563	13466	2144029	0.38820
E5_choline_E10_PL58_kneaddata	Verrucomicrobiota	33333	P	456176	3473	459649	0.08322
E5_choline_E10_PL58_kneaddata	Desulfobacterota_A	11509	P	220568	233	220801	0.03998
E5_choline_E10_PL58_kneaddata	Firmicutes	12188	P	112174	10174	122348	0.02215
E5_choline_E10_PL58_kneaddata	Actinobacteriota	615	P	32037	379	32416	0.00587
E5_choline_E10_PL58_kneaddata	Proteobacteria	22518	P	7573	29	7602	0.00138
E5_choline_E10_PL58_kneaddata	Firmicutes_B	17289	P	6538	397	6935	0.00126
E5_choline_E10_PL58_kneaddata	Cyanobacteria	9876	P	1446	31	1477	0.00027
E5_choline_E10_PL58_kneaddata	Spirochaetota	32587	P	550	0	550	0.00010
E5_choline_E10_PL58_kneaddata	Campylobacterota	8700	P	110	0	110	0.00002
E5_choline_E10_PL58_kneaddata	Firmicutes_I	18140	P	50	0	50	0.00001
E5_choline_E10_PL58_kneaddata	Deferribacterota	10822	P	26	0	26	0.00000
E5_choline_E10_PL58_kneaddata	Firmicutes_C	17613	P	13	0	13	0.00000
E5_choline_E10_PL58_kneaddata	Thermotogota	33086	P	2	0	2	0.00000
E5_choline_E10_PL58_kneaddata	Elusimicrobiota	11888	P	1	0	1	0.00000
ERR1145758_1_kneaddata_paired	Firmicutes_A	14608	P	17098734	43162	17141896	0.54212
ERR1145758_1_kneaddata_paired	Bacteroidota	4587	P	6982641	33797	7016438	0.22190
ERR1145758_1_kneaddata_paired	Firmicutes	12188	P	4355069	294146	4649215	0.14703
ERR1145758_1_kneaddata_paired	Desulfobacterota_A	11509	P	1235914	5467	1241381	0.03926
ERR1145758_1_kneaddata_paired	Actinobacteriota	615	P	889382	1013	890395	0.02816
ERR1145758_1_kneaddata_paired	Deferribacterota	10822	P	604104	1206	605310	0.01914
ERR1145758_1_kneaddata_paired	Verrucomicrobiota	33333	P	59155	661	59816	0.00189
ERR1145758_1_kneaddata_paired	Proteobacteria	22518	P	9853	12	9865	0.00031
ERR1145758_1_kneaddata_paired	Cyanobacteria	9876	P	2734	20	2754	0.00009
ERR1145758_1_kneaddata_paired	Spirochaetota	32587	P	1303	0	1303	0.00004
ERR1145758_1_kneaddata_paired	Firmicutes_B	17289	P	850	16	866	0.00003
ERR1145758_1_kneaddata_paired	Firmicutes_C	17613	P	290	0	290	0.00001
ERR1145758_1_kneaddata_paired	Campylobacterota	8700	P	252	0	252	0.00001
ERR1145758_1_kneaddata_paired	Firmicutes_I	18140	P	201	0	201	0.00001
ERR1145758_1_kneaddata_paired	Elusimicrobiota	11888	P	63	0	63	0.00000
ERR1145758_1_kneaddata_paired	Thermotogota	33086	P	17	0	17	0.00000
ERR1145759_1_kneaddata_paired	Firmicutes_A	14608	P	1327392	4673	1332065	0.69541
ERR1145759_1_kneaddata_paired	Bacteroidota	4587	P	193155	1324	194479	0.10153
ERR1145759_1_kneaddata_paired	Firmicutes	12188	P	177423	15805	193228	0.10088
ERR1145759_1_kneaddata_paired	Desulfobacterota_A	11509	P	77757	465	78222	0.04084
ERR1145759_1_kneaddata_paired	Deferribacterota	10822	P	66044	174	66218	0.03457
ERR1145759_1_kneaddata_paired	Actinobacteriota	615	P	33022	44	33066	0.01726
ERR1145759_1_kneaddata_paired	Firmicutes_I	18140	P	7346	2	7348	0.00384
ERR1145759_1_kneaddata_paired	Verrucomicrobiota	33333	P	3924	66	3990	0.00208
ERR1145759_1_kneaddata_paired	Proteobacteria	22518	P	3435	4	3439	0.00180
ERR1145759_1_kneaddata_paired	Cyanobacteria	9876	P	2796	6	2802	0.00146
ERR1145759_1_kneaddata_paired	Spirochaetota	32587	P	421	0	421	0.00022
ERR1145759_1_kneaddata_paired	Firmicutes_B	17289	P	149	3	152	0.00008
ERR1145759_1_kneaddata_paired	Campylobacterota	8700	P	46	0	46	0.00002
ERR1145759_1_kneaddata_paired	Firmicutes_C	17613	P	22	0	22	0.00001
ERR1145759_1_kneaddata_paired	Elusimicrobiota	11888	P	15	0	15	0.00001
ERR1145759_1_kneaddata_paired	Thermotogota	33086	P	2	0	2	0.00000
ERR1562569_1_kneaddata_paired	Firmicutes_A	14608	P	2634770	6510	2641280	0.90323
ERR1562569_1_kneaddata_paired	Bacteroidota	4587	P	224645	484	225129	0.07699
ERR1562569_1_kneaddata_paired	Firmicutes	12188	P	29583	153	29736	0.01017
ERR1562569_1_kneaddata_paired	Actinobacteriota	615	P	11396	12	11408	0.00390
ERR1562569_1_kneaddata_paired	Firmicutes_B	17289	P	9934	237	10171	0.00348
ERR1562569_1_kneaddata_paired	Deferribacterota	10822	P	2902	7	2909	0.00099
ERR1562569_1_kneaddata_paired	Verrucomicrobiota	33333	P	1923	70	1993	0.00068
ERR1562569_1_kneaddata_paired	Desulfobacterota_A	11509	P	572	23	595	0.00020
ERR1562569_1_kneaddata_paired	Proteobacteria	22518	P	526	3	529	0.00018
ERR1562569_1_kneaddata_paired	Cyanobacteria	9876	P	313	7	320	0.00011
ERR1562569_1_kneaddata_paired	Spirochaetota	32587	P	64	0	64	0.00002
ERR1562569_1_kneaddata_paired	Firmicutes_C	17613	P	50	0	50	0.00002
ERR1562569_1_kneaddata_paired	Campylobacterota	8700	P	41	0	41	0.00001
ERR1562569_1_kneaddata_paired	Firmicutes_I	18140	P	29	0	29	0.00001
ERR1562569_1_kneaddata_paired	Thermotogota	33086	P	6	0	6	0.00000
ERR1562569_1_kneaddata_paired	Elusimicrobiota	11888	P	4	0	4	0.00000
ERR1562570_1_kneaddata_paired	Firmicutes_A	14608	P	2634823	6351	2641174	0.92155
ERR1562570_1_kneaddata_paired	Bacteroidota	4587	P	176259	462	176721	0.06166
ERR1562570_1_kneaddata_paired	Firmicutes	12188	P	23505	110	23615	0.00824
ERR1562570_1_kneaddata_paired	Firmicutes_B	17289	P	9166	211	9377	0.00327
ERR1562570_1_kneaddata_paired	Actinobacteriota	615	P	8285	9	8294	0.00289
ERR1562570_1_kneaddata_paired	Deferribacterota	10822	P	3233	7	3240	0.00113
ERR1562570_1_kneaddata_paired	Verrucomicrobiota	33333	P	2164	76	2240	0.00078
ERR1562570_1_kneaddata_paired	Proteobacteria	22518	P	573	3	576	0.00020
ERR1562570_1_kneaddata_paired	Desulfobacterota_A	11509	P	345	14	359	0.00013
ERR1562570_1_kneaddata_paired	Cyanobacteria	9876	P	260	6	266	0.00009
ERR1562570_1_kneaddata_paired	Firmicutes_C	17613	P	54	0	54	0.00002
ERR1562570_1_kneaddata_paired	Spirochaetota	32587	P	34	0	34	0.00001
ERR1562570_1_kneaddata_paired	Firmicutes_I	18140	P	30	0	30	0.00001
ERR1562570_1_kneaddata_paired	Campylobacterota	8700	P	25	0	25	0.00001
ERR1562570_1_kneaddata_paired	Thermotogota	33086	P	7	0	7	0.00000
ERR1562570_1_kneaddata_paired	Elusimicrobiota	11888	P	5	0	5	0.00000
ERR1562571_1_kneaddata_paired	Firmicutes_A	14608	P	3108986	6779	3115765	0.91336
ERR1562571_1_kneaddata_paired	Bacteroidota	4587	P	246711	744	247455	0.07254
ERR1562571_1_kneaddata_paired	Verrucomicrobiota	33333	P	15904	713	16617	0.00487
ERR1562571_1_kneaddata_paired	Firmicutes_B	17289	P	13713	394	14107	0.00414
ERR1562571_1_kneaddata_paired	Firmicutes	12188	P	10986	181	11167	0.00327
ERR1562571_1_kneaddata_paired	Actinobacteriota	615	P	2509	5	2514	0.00074
ERR1562571_1_kneaddata_paired	Deferribacterota	10822	P	2372	6	2378	0.00070
ERR1562571_1_kneaddata_paired	Desulfobacterota_A	11509	P	525	19	544	0.00016
ERR1562571_1_kneaddata_paired	Proteobacteria	22518	P	309	1	310	0.00009
ERR1562571_1_kneaddata_paired	Cyanobacteria	9876	P	276	5	281	0.00008
ERR1562571_1_kneaddata_paired	Firmicutes_I	18140	P	53	0	53	0.00002
ERR1562571_1_kneaddata_paired	Firmicutes_C	17613	P	38	0	38	0.00001
ERR1562571_1_kneaddata_paired	Spirochaetota	32587	P	36	0	36	0.00001
ERR1562571_1_kneaddata_paired	Campylobacterota	8700	P	23	0	23	0.00001
ERR1562571_1_kneaddata_paired	Elusimicrobiota	11888	P	10	0	10	0.00000
ERR1562571_1_kneaddata_paired	Thermotogota	33086	P	2	0	2	0.00000
ERR1562572_1_kneaddata_paired	Firmicutes_A	14608	P	2954244	4296	2958540	0.69484
ERR1562572_1_kneaddata_paired	Bacteroidota	4587	P	1189148	6975	1196123	0.28092
ERR1562572_1_kneaddata_paired	Firmicutes	12188	P	48379	189	48568	0.01141
ERR1562572_1_kneaddata_paired	Actinobacteriota	615	P	29756	15	29771	0.00699
ERR1562572_1_kneaddata_paired	Firmicutes_B	17289	P	13641	261	13902	0.00327
ERR1562572_1_kneaddata_paired	Verrucomicrobiota	33333	P	6650	196	6846	0.00161
ERR1562572_1_kneaddata_paired	Proteobacteria	22518	P	1462	2	1464	0.00034
ERR1562572_1_kneaddata_paired	Deferribacterota	10822	P	1143	2	1145	0.00027
ERR1562572_1_kneaddata_paired	Cyanobacteria	9876	P	715	8	723	0.00017
ERR1562572_1_kneaddata_paired	Desulfobacterota_A	11509	P	515	15	530	0.00012
ERR1562572_1_kneaddata_paired	Campylobacterota	8700	P	73	0	73	0.00002
ERR1562572_1_kneaddata_paired	Firmicutes_I	18140	P	60	0	60	0.00001
ERR1562572_1_kneaddata_paired	Spirochaetota	32587	P	57	0	57	0.00001
ERR1562572_1_kneaddata_paired	Firmicutes_C	17613	P	51	0	51	0.00001
ERR1562572_1_kneaddata_paired	Elusimicrobiota	11888	P	10	0	10	0.00000
ERR1562572_1_kneaddata_paired	Thermotogota	33086	P	2	0	2	0.00000
ERR1562573_1_kneaddata_paired	Firmicutes_A	14608	P	4299335	10376	4309711	0.82386
ERR1562573_1_kneaddata_paired	Bacteroidota	4587	P	843071	4234	847305	0.16197
ERR1562573_1_kneaddata_paired	Firmicutes	12188	P	42191	203	42394	0.00810
ERR1562573_1_kneaddata_paired	Actinobacteriota	615	P	14497	7	14504	0.00277
ERR1562573_1_kneaddata_paired	Firmicutes_B	17289	P	10051	212	10263	0.00196
ERR1562573_1_kneaddata_paired	Deferribacterota	10822	P	1887	4	1891	0.00036
ERR1562573_1_kneaddata_paired	Verrucomicrobiota	33333	P	1760	56	1816	0.00035
ERR1562573_1_kneaddata_paired	Proteobacteria	22518	P	1361	10	1371	0.00026
ERR1562573_1_kneaddata_paired	Cyanobacteria	9876	P	851	18	869	0.00017
ERR1562573_1_kneaddata_paired	Desulfobacterota_A	11509	P	603	36	639	0.00012
ERR1562573_1_kneaddata_paired	Firmicutes_C	17613	P	104	0	104	0.00002
ERR1562573_1_kneaddata_paired	Campylobacterota	8700	P	83	0	83	0.00002
ERR1562573_1_kneaddata_paired	Spirochaetota	32587	P	77	0	77	0.00001
ERR1562573_1_kneaddata_paired	Firmicutes_I	18140	P	63	0	63	0.00001
ERR1562573_1_kneaddata_paired	Elusimicrobiota	11888	P	9	0	9	0.00000
ERR1562573_1_kneaddata_paired	Thermotogota	33086	P	3	0	3	0.00000
ERR1562574_1_kneaddata_paired	Firmicutes_A	14608	P	4015842	6203	4022045	0.76854
ERR1562574_1_kneaddata_paired	Bacteroidota	4587	P	1136659	7779	1144438	0.21868
ERR1562574_1_kneaddata_paired	Actinobacteriota	615	P	25083	14	25097	0.00480
ERR1562574_1_kneaddata_paired	Firmicutes_B	17289	P	15389	328	15717	0.00300
ERR1562574_1_kneaddata_paired	Firmicutes	12188	P	15011	128	15139	0.00289
ERR1562574_1_kneaddata_paired	Verrucomicrobiota	33333	P	6980	231	7211	0.00138
ERR1562574_1_kneaddata_paired	Deferribacterota	10822	P	1308	2	1310	0.00025
ERR1562574_1_kneaddata_paired	Proteobacteria	22518	P	812	1	813	0.00016
ERR1562574_1_kneaddata_paired	Desulfobacterota_A	11509	P	698	23	721	0.00014
ERR1562574_1_kneaddata_paired	Cyanobacteria	9876	P	639	7	646	0.00012
ERR1562574_1_kneaddata_paired	Firmicutes_I	18140	P	80	0	80	0.00002
ERR1562574_1_kneaddata_paired	Spirochaetota	32587	P	63	0	63	0.00001
ERR1562574_1_kneaddata_paired	Firmicutes_C	17613	P	48	0	48	0.00001
ERR1562574_1_kneaddata_paired	Campylobacterota	8700	P	45	0	45	0.00001
ERR1562574_1_kneaddata_paired	Elusimicrobiota	11888	P	11	0	11	0.00000
ERR1562574_1_kneaddata_paired	Thermotogota	33086	P	3	0	3	0.00000
ERR1562575_1_kneaddata_paired	Firmicutes_A	14608	P	3575239	12501	3587740	0.83147
ERR1562575_1_kneaddata_paired	Bacteroidota	4587	P	654815	2625	657440	0.15236
ERR1562575_1_kneaddata_paired	Verrucomicrobiota	33333	P	22180	1225	23405	0.00542
ERR1562575_1_kneaddata_paired	Firmicutes	12188	P	19836	246	20082	0.00465
ERR1562575_1_kneaddata_paired	Firmicutes_B	17289	P	15586	557	16143	0.00374
ERR1562575_1_kneaddata_paired	Deferribacterota	10822	P	4724	17	4741	0.00110
ERR1562575_1_kneaddata_paired	Actinobacteriota	615	P	3010	10	3020	0.00070
ERR1562575_1_kneaddata_paired	Proteobacteria	22518	P	751	2	753	0.00017
ERR1562575_1_kneaddata_paired	Cyanobacteria	9876	P	741	23	764	0.00018
ERR1562575_1_kneaddata_paired	Desulfobacterota_A	11509	P	551	43	594	0.00014
ERR1562575_1_kneaddata_paired	Spirochaetota	32587	P	69	0	69	0.00002
ERR1562575_1_kneaddata_paired	Firmicutes_C	17613	P	62	0	62	0.00001
ERR1562575_1_kneaddata_paired	Firmicutes_I	18140	P	53	0	53	0.00001
ERR1562575_1_kneaddata_paired	Campylobacterota	8700	P	41	0	41	0.00001
ERR1562575_1_kneaddata_paired	Elusimicrobiota	11888	P	4	0	4	0.00000
ERR1562575_1_kneaddata_paired	Thermotogota	33086	P	3	0	3	0.00000
ERR1562576_1_kneaddata_paired	Firmicutes_A	14608	P	3343160	8602	3351762	0.89265
ERR1562576_1_kneaddata_paired	Bacteroidota	4587	P	362232	1653	363885	0.09691
ERR1562576_1_kneaddata_paired	Firmicutes	12188	P	20623	110	20733	0.00552
ERR1562576_1_kneaddata_paired	Firmicutes_B	17289	P	6875	154	7029	0.00187
ERR1562576_1_kneaddata_paired	Verrucomicrobiota	33333	P	3709	127	3836	0.00102
ERR1562576_1_kneaddata_paired	Actinobacteriota	615	P	3306	7	3313	0.00088
ERR1562576_1_kneaddata_paired	Deferribacterota	10822	P	2634	6	2640	0.00070
ERR1562576_1_kneaddata_paired	Proteobacteria	22518	P	743	3	746	0.00020
ERR1562576_1_kneaddata_paired	Desulfobacterota_A	11509	P	402	17	419	0.00011
ERR1562576_1_kneaddata_paired	Cyanobacteria	9876	P	316	6	322	0.00009
ERR1562576_1_kneaddata_paired	Firmicutes_C	17613	P	49	0	49	0.00001
ERR1562576_1_kneaddata_paired	Campylobacterota	8700	P	39	0	39	0.00001
ERR1562576_1_kneaddata_paired	Firmicutes_I	18140	P	37	0	37	0.00001
ERR1562576_1_kneaddata_paired	Spirochaetota	32587	P	33	0	33	0.00001
ERR1562576_1_kneaddata_paired	Elusimicrobiota	11888	P	3	0	3	0.00000
ERR1562576_1_kneaddata_paired	Thermotogota	33086	P	1	0	1	0.00000
ERR1562577_1_kneaddata_paired	Firmicutes_A	14608	P	3831140	8590	3839730	0.89632
ERR1562577_1_kneaddata_paired	Bacteroidota	4587	P	354093	1847	355940	0.08309
ERR1562577_1_kneaddata_paired	Verrucomicrobiota	33333	P	45854	1511	47365	0.01106
ERR1562577_1_kneaddata_paired	Firmicutes	12188	P	23604	192	23796	0.00555
ERR1562577_1_kneaddata_paired	Firmicutes_B	17289	P	7967	169	8136	0.00190
ERR1562577_1_kneaddata_paired	Actinobacteriota	615	P	3638	9	3647	0.00085
ERR1562577_1_kneaddata_paired	Deferribacterota	10822	P	3164	6	3170	0.00074
ERR1562577_1_kneaddata_paired	Proteobacteria	22518	P	721	3	724	0.00017
ERR1562577_1_kneaddata_paired	Desulfobacterota_A	11509	P	649	26	675	0.00016
ERR1562577_1_kneaddata_paired	Cyanobacteria	9876	P	444	6	450	0.00011
ERR1562577_1_kneaddata_paired	Spirochaetota	32587	P	72	0	72	0.00002
ERR1562577_1_kneaddata_paired	Firmicutes_C	17613	P	59	0	59	0.00001
ERR1562577_1_kneaddata_paired	Firmicutes_I	18140	P	59	0	59	0.00001
ERR1562577_1_kneaddata_paired	Campylobacterota	8700	P	47	0	47	0.00001
ERR1562577_1_kneaddata_paired	Elusimicrobiota	11888	P	10	0	10	0.00000
ERR1562577_1_kneaddata_paired	Thermotogota	33086	P	8	0	8	0.00000
ERR1562578_1_kneaddata_paired	Firmicutes_A	14608	P	2111713	2932	2114645	0.69178
ERR1562578_1_kneaddata_paired	Bacteroidota	4587	P	886703	4363	891066	0.29150
ERR1562578_1_kneaddata_paired	Actinobacteriota	615	P	24239	8	24247	0.00793
ERR1562578_1_kneaddata_paired	Firmicutes	12188	P	16078	62	16140	0.00528
ERR1562578_1_kneaddata_paired	Firmicutes_B	17289	P	4264	61	4325	0.00141
ERR1562578_1_kneaddata_paired	Deferribacterota	10822	P	3936	5	3941	0.00129
ERR1562578_1_kneaddata_paired	Verrucomicrobiota	33333	P	1034	22	1056	0.00035
ERR1562578_1_kneaddata_paired	Proteobacteria	22518	P	500	0	500	0.00016
ERR1562578_1_kneaddata_paired	Cyanobacteria	9876	P	497	4	501	0.00016
ERR1562578_1_kneaddata_paired	Desulfobacterota_A	11509	P	235	5	240	0.00008
ERR1562578_1_kneaddata_paired	Spirochaetota	32587	P	44	0	44	0.00001
ERR1562578_1_kneaddata_paired	Firmicutes_C	17613	P	35	0	35	0.00001
ERR1562578_1_kneaddata_paired	Campylobacterota	8700	P	32	0	32	0.00001
ERR1562578_1_kneaddata_paired	Firmicutes_I	18140	P	31	0	31	0.00001
ERR1562578_1_kneaddata_paired	Elusimicrobiota	11888	P	6	0	6	0.00000
ERR1562578_1_kneaddata_paired	Thermotogota	33086	P	2	0	2	0.00000
ERR1562579_1_kneaddata_paired	Firmicutes_A	14608	P	2776233	5268	2781501	0.81270
ERR1562579_1_kneaddata_paired	Bacteroidota	4587	P	598030	3928	601958	0.17588
ERR1562579_1_kneaddata_paired	Actinobacteriota	615	P	19597	9	19606	0.00573
ERR1562579_1_kneaddata_paired	Firmicutes	12188	P	9142	64	9206	0.00269
ERR1562579_1_kneaddata_paired	Firmicutes_B	17289	P	7216	141	7357	0.00215
ERR1562579_1_kneaddata_paired	Deferribacterota	10822	P	852	1	853	0.00025
ERR1562579_1_kneaddata_paired	Verrucomicrobiota	33333	P	824	23	847	0.00025
ERR1562579_1_kneaddata_paired	Cyanobacteria	9876	P	368	3	371	0.00011
ERR1562579_1_kneaddata_paired	Proteobacteria	22518	P	368	0	368	0.00011
ERR1562579_1_kneaddata_paired	Desulfobacterota_A	11509	P	290	8	298	0.00009
ERR1562579_1_kneaddata_paired	Spirochaetota	32587	P	44	0	44	0.00001
ERR1562579_1_kneaddata_paired	Firmicutes_I	18140	P	42	0	42	0.00001
ERR1562579_1_kneaddata_paired	Firmicutes_C	17613	P	41	0	41	0.00001
ERR1562579_1_kneaddata_paired	Campylobacterota	8700	P	30	0	30	0.00001
ERR1562579_1_kneaddata_paired	Elusimicrobiota	11888	P	14	0	14	0.00000
ERR1562579_1_kneaddata_paired	Thermotogota	33086	P	2	0	2	0.00000
ERR1562580_1_kneaddata_paired	Firmicutes_A	14608	P	2280689	3449	2284138	0.72268
ERR1562580_1_kneaddata_paired	Bacteroidota	4587	P	832237	4374	836611	0.26470
ERR1562580_1_kneaddata_paired	Actinobacteriota	615	P	17793	6	17799	0.00563
ERR1562580_1_kneaddata_paired	Firmicutes	12188	P	9238	44	9282	0.00294
ERR1562580_1_kneaddata_paired	Firmicutes_B	17289	P	5614	90	5704	0.00180
ERR1562580_1_kneaddata_paired	Deferribacterota	10822	P	2510	4	2514	0.00080
ERR1562580_1_kneaddata_paired	Verrucomicrobiota	33333	P	2261	56	2317	0.00073
ERR1562580_1_kneaddata_paired	Proteobacteria	22518	P	1165	1	1166	0.00037
ERR1562580_1_kneaddata_paired	Cyanobacteria	9876	P	676	5	681	0.00022
ERR1562580_1_kneaddata_paired	Desulfobacterota_A	11509	P	265	6	271	0.00009
ERR1562580_1_kneaddata_paired	Spirochaetota	32587	P	42	0	42	0.00001
ERR1562580_1_kneaddata_paired	Firmicutes_I	18140	P	36	0	36	0.00001
ERR1562580_1_kneaddata_paired	Campylobacterota	8700	P	32	0	32	0.00001
ERR1562580_1_kneaddata_paired	Firmicutes_C	17613	P	31	0	31	0.00001
ERR1562580_1_kneaddata_paired	Elusimicrobiota	11888	P	15	0	15	0.00000
ERR1562580_1_kneaddata_paired	Thermotogota	33086	P	1	0	1	0.00000
ERR1562581_1_kneaddata_paired	Firmicutes_A	14608	P	4186432	8839	4195271	0.85857
ERR1562581_1_kneaddata_paired	Bacteroidota	4587	P	583794	1115	584909	0.11970
ERR1562581_1_kneaddata_paired	Verrucomicrobiota	33333	P	70606	2743	73349	0.01501
ERR1562581_1_kneaddata_paired	Deferribacterota	10822	P	13474	34	13508	0.00276
ERR1562581_1_kneaddata_paired	Firmicutes	12188	P	7582	140	7722	0.00158
ERR1562581_1_kneaddata_paired	Firmicutes_B	17289	P	4776	119	4895	0.00100
ERR1562581_1_kneaddata_paired	Proteobacteria	22518	P	2618	6	2624	0.00054
ERR1562581_1_kneaddata_paired	Actinobacteriota	615	P	1993	5	1998	0.00041
ERR1562581_1_kneaddata_paired	Cyanobacteria	9876	P	853	13	866	0.00018
ERR1562581_1_kneaddata_paired	Desulfobacterota_A	11509	P	790	45	835	0.00017
ERR1562581_1_kneaddata_paired	Firmicutes_C	17613	P	141	0	141	0.00003
ERR1562581_1_kneaddata_paired	Spirochaetota	32587	P	69	0	69	0.00001
ERR1562581_1_kneaddata_paired	Firmicutes_I	18140	P	64	0	64	0.00001
ERR1562581_1_kneaddata_paired	Campylobacterota	8700	P	59	0	59	0.00001
ERR1562581_1_kneaddata_paired	Elusimicrobiota	11888	P	9	0	9	0.00000
ERR1562581_1_kneaddata_paired	Thermotogota	33086	P	3	0	3	0.00000
ERR1562582_1_kneaddata_paired	Firmicutes_A	14608	P	2933311	8121	2941432	0.81495
ERR1562582_1_kneaddata_paired	Bacteroidota	4587	P	421528	946	422474	0.11705
ERR1562582_1_kneaddata_paired	Proteobacteria	22518	P	158499	474	158973	0.04404
ERR1562582_1_kneaddata_paired	Verrucomicrobiota	33333	P	33095	1385	34480	0.00955
ERR1562582_1_kneaddata_paired	Deferribacterota	10822	P	31314	86	31400	0.00870
ERR1562582_1_kneaddata_paired	Firmicutes	12188	P	10436	109	10545	0.00292
ERR1562582_1_kneaddata_paired	Firmicutes_B	17289	P	4158	112	4270	0.00118
ERR1562582_1_kneaddata_paired	Actinobacteriota	615	P	2798	5	2803	0.00078
ERR1562582_1_kneaddata_paired	Cyanobacteria	9876	P	1696	32	1728	0.00048
ERR1562582_1_kneaddata_paired	Desulfobacterota_A	11509	P	899	40	939	0.00026
ERR1562582_1_kneaddata_paired	Spirochaetota	32587	P	100	0	100	0.00003
ERR1562582_1_kneaddata_paired	Firmicutes_C	17613	P	69	0	69	0.00002
ERR1562582_1_kneaddata_paired	Campylobacterota	8700	P	60	0	60	0.00002
ERR1562582_1_kneaddata_paired	Firmicutes_I	18140	P	47	0	47	0.00001
ERR1562582_1_kneaddata_paired	Elusimicrobiota	11888	P	32	0	32	0.00001
ERR1562582_1_kneaddata_paired	Thermotogota	33086	P	3	0	3	0.00000
ERR1562583_1_kneaddata_paired	Firmicutes_A	14608	P	2699061	9043	2708104	0.86231
ERR1562583_1_kneaddata_paired	Bacteroidota	4587	P	336210	1054	337264	0.10739
ERR1562583_1_kneaddata_paired	Deferribacterota	10822	P	34471	105	34576	0.01101
ERR1562583_1_kneaddata_paired	Proteobacteria	22518	P	26724	88	26812	0.00854
ERR1562583_1_kneaddata_paired	Verrucomicrobiota	33333	P	13413	627	14040	0.00447
ERR1562583_1_kneaddata_paired	Firmicutes	12188	P	12341	292	12633	0.00402
ERR1562583_1_kneaddata_paired	Firmicutes_B	17289	P	2758	83	2841	0.00090
ERR1562583_1_kneaddata_paired	Actinobacteriota	615	P	2312	5	2317	0.00074
ERR1562583_1_kneaddata_paired	Cyanobacteria	9876	P	851	11	862	0.00027
ERR1562583_1_kneaddata_paired	Desulfobacterota_A	11509	P	776	49	825	0.00026
ERR1562583_1_kneaddata_paired	Firmicutes_C	17613	P	79	0	79	0.00003
ERR1562583_1_kneaddata_paired	Spirochaetota	32587	P	74	0	74	0.00002
ERR1562583_1_kneaddata_paired	Campylobacterota	8700	P	52	0	52	0.00002
ERR1562583_1_kneaddata_paired	Firmicutes_I	18140	P	40	0	40	0.00001
ERR1562583_1_kneaddata_paired	Elusimicrobiota	11888	P	10	0	10	0.00000
ERR1562583_1_kneaddata_paired	Thermotogota	33086	P	5	0	5	0.00000
ERR1562584_1_kneaddata_paired	Firmicutes_A	14608	P	1498415	3544	1501959	0.55637
ERR1562584_1_kneaddata_paired	Bacteroidota	4587	P	897814	1982	899796	0.33331
ERR1562584_1_kneaddata_paired	Verrucomicrobiota	33333	P	105424	3373	108797	0.04030
ERR1562584_1_kneaddata_paired	Proteobacteria	22518	P	93116	210	93326	0.03457
ERR1562584_1_kneaddata_paired	Deferribacterota	10822	P	68015	142	68157	0.02525
ERR1562584_1_kneaddata_paired	Firmicutes	12188	P	17059	118	17177	0.00636
ERR1562584_1_kneaddata_paired	Firmicutes_B	17289	P	6321	130	6451	0.00239
ERR1562584_1_kneaddata_paired	Cyanobacteria	9876	P	1647	22	1669	0.00062
ERR1562584_1_kneaddata_paired	Actinobacteriota	615	P	1450	1	1451	0.00054
ERR1562584_1_kneaddata_paired	Desulfobacterota_A	11509	P	457	19	476	0.00018
ERR1562584_1_kneaddata_paired	Spirochaetota	32587	P	135	0	135	0.00005
ERR1562584_1_kneaddata_paired	Campylobacterota	8700	P	67	0	67	0.00002
ERR1562584_1_kneaddata_paired	Firmicutes_C	17613	P	52	0	52	0.00002
ERR1562584_1_kneaddata_paired	Firmicutes_I	18140	P	40	0	40	0.00001
ERR1562584_1_kneaddata_paired	Elusimicrobiota	11888	P	12	0	12	0.00000
ERR1562584_1_kneaddata_paired	Thermotogota	33086	P	2	0	2	0.00000
ERR1562585_1_kneaddata_paired	Firmicutes_A	14608	P	2728613	4411	2733024	0.76606
ERR1562585_1_kneaddata_paired	Bacteroidota	4587	P	554669	1380	556049	0.15586
ERR1562585_1_kneaddata_paired	Verrucomicrobiota	33333	P	226856	4976	231832	0.06498
ERR1562585_1_kneaddata_paired	Deferribacterota	10822	P	20463	29	20492	0.00574
ERR1562585_1_kneaddata_paired	Firmicutes	12188	P	10578	146	10724	0.00301
ERR1562585_1_kneaddata_paired	Firmicutes_B	17289	P	7595	107	7702	0.00216
ERR1562585_1_kneaddata_paired	Actinobacteriota	615	P	4952	2	4954	0.00139
ERR1562585_1_kneaddata_paired	Cyanobacteria	9876	P	1507	16	1523	0.00043
ERR1562585_1_kneaddata_paired	Desulfobacterota_A	11509	P	570	17	587	0.00016
ERR1562585_1_kneaddata_paired	Proteobacteria	22518	P	501	1	502	0.00014
ERR1562585_1_kneaddata_paired	Spirochaetota	32587	P	61	0	61	0.00002
ERR1562585_1_kneaddata_paired	Firmicutes_C	17613	P	53	0	53	0.00001
ERR1562585_1_kneaddata_paired	Campylobacterota	8700	P	52	0	52	0.00001
ERR1562585_1_kneaddata_paired	Firmicutes_I	18140	P	49	0	49	0.00001
ERR1562585_1_kneaddata_paired	Elusimicrobiota	11888	P	7	0	7	0.00000
ERR1562585_1_kneaddata_paired	Thermotogota	33086	P	3	0	3	0.00000
ERR1562586_1_kneaddata_paired	Firmicutes_A	14608	P	3682201	13273	3695474	0.88209
ERR1562586_1_kneaddata_paired	Bacteroidota	4587	P	392428	2613	395041	0.09429
ERR1562586_1_kneaddata_paired	Deferribacterota	10822	P	37636	152	37788	0.00902
ERR1562586_1_kneaddata_paired	Proteobacteria	22518	P	23586	103	23689	0.00565
ERR1562586_1_kneaddata_paired	Firmicutes	12188	P	18327	598	18925	0.00452
ERR1562586_1_kneaddata_paired	Cyanobacteria	9876	P	5320	191	5511	0.00132
ERR1562586_1_kneaddata_paired	Firmicutes_B	17289	P	5040	200	5240	0.00125
ERR1562586_1_kneaddata_paired	Actinobacteriota	615	P	4403	8	4411	0.00105
ERR1562586_1_kneaddata_paired	Verrucomicrobiota	33333	P	1957	122	2079	0.00050
ERR1562586_1_kneaddata_paired	Desulfobacterota_A	11509	P	856	89	945	0.00023
ERR1562586_1_kneaddata_paired	Firmicutes_C	17613	P	114	0	114	0.00003
ERR1562586_1_kneaddata_paired	Spirochaetota	32587	P	107	0	107	0.00003
ERR1562586_1_kneaddata_paired	Campylobacterota	8700	P	71	0	71	0.00002
ERR1562586_1_kneaddata_paired	Firmicutes_I	18140	P	37	0	37	0.00001
ERR1562586_1_kneaddata_paired	Elusimicrobiota	11888	P	16	0	16	0.00000
ERR1562586_1_kneaddata_paired	Thermotogota	33086	P	8	0	8	0.00000
ERR1562587_1_kneaddata_paired	Firmicutes_A	14608	P	4840969	16351	4857320	0.84955
ERR1562587_1_kneaddata_paired	Bacteroidota	4587	P	702722	3109	705831	0.12345
ERR1562587_1_kneaddata_paired	Deferribacterota	10822	P	77716	229	77945	0.01363
ERR1562587_1_kneaddata_paired	Firmicutes	12188	P	27975	643	28618	0.00501
ERR1562587_1_kneaddata_paired	Verrucomicrobiota	33333	P	23109	1041	24150	0.00422
ERR1562587_1_kneaddata_paired	Proteobacteria	22518	P	11873	51	11924	0.00209
ERR1562587_1_kneaddata_paired	Firmicutes_B	17289	P	5216	151	5367	0.00094
ERR1562587_1_kneaddata_paired	Actinobacteriota	615	P	3497	3	3500	0.00061
ERR1562587_1_kneaddata_paired	Cyanobacteria	9876	P	1423	32	1455	0.00025
ERR1562587_1_kneaddata_paired	Desulfobacterota_A	11509	P	845	58	903	0.00016
ERR1562587_1_kneaddata_paired	Spirochaetota	32587	P	137	0	137	0.00002
ERR1562587_1_kneaddata_paired	Campylobacterota	8700	P	133	0	133	0.00002
ERR1562587_1_kneaddata_paired	Firmicutes_C	17613	P	130	0	130	0.00002
ERR1562587_1_kneaddata_paired	Firmicutes_I	18140	P	69	0	69	0.00001
ERR1562587_1_kneaddata_paired	Elusimicrobiota	11888	P	16	0	16	0.00000
ERR1562587_1_kneaddata_paired	Thermotogota	33086	P	9	0	9	0.00000
ERR1562588_1_kneaddata_paired	Firmicutes_A	14608	P	3423257	8841	3432098	0.87092
ERR1562588_1_kneaddata_paired	Bacteroidota	4587	P	428939	2265	431204	0.10942
ERR1562588_1_kneaddata_paired	Verrucomicrobiota	33333	P	44347	1827	46174	0.01172
ERR1562588_1_kneaddata_paired	Firmicutes	12188	P	12592	457	13049	0.00331
ERR1562588_1_kneaddata_paired	Actinobacteriota	615	P	5765	3	5768	0.00146
ERR1562588_1_kneaddata_paired	Firmicutes_B	17289	P	5480	145	5625	0.00143
ERR1562588_1_kneaddata_paired	Deferribacterota	10822	P	4192	11	4203	0.00107
ERR1562588_1_kneaddata_paired	Cyanobacteria	9876	P	1124	23	1147	0.00029
ERR1562588_1_kneaddata_paired	Proteobacteria	22518	P	669	1	670	0.00017
ERR1562588_1_kneaddata_paired	Desulfobacterota_A	11509	P	589	43	632	0.00016
ERR1562588_1_kneaddata_paired	Firmicutes_C	17613	P	57	0	57	0.00001
ERR1562588_1_kneaddata_paired	Campylobacterota	8700	P	56	0	56	0.00001
ERR1562588_1_kneaddata_paired	Spirochaetota	32587	P	37	0	37	0.00001
ERR1562588_1_kneaddata_paired	Firmicutes_I	18140	P	33	0	33	0.00001
ERR1562588_1_kneaddata_paired	Elusimicrobiota	11888	P	5	0	5	0.00000
ERR1562588_1_kneaddata_paired	Thermotogota	33086	P	3	0	3	0.00000
ERR1562589_1_kneaddata_paired	Firmicutes_A	14608	P	4021761	17018	4038779	0.83522
ERR1562589_1_kneaddata_paired	Bacteroidota	4587	P	738249	4456	742705	0.15359
ERR1562589_1_kneaddata_paired	Firmicutes	12188	P	15895	516	16411	0.00339
ERR1562589_1_kneaddata_paired	Verrucomicrobiota	33333	P	11585	676	12261	0.00254
ERR1562589_1_kneaddata_paired	Firmicutes_B	17289	P	8971	338	9309	0.00193
ERR1562589_1_kneaddata_paired	Deferribacterota	10822	P	8512	32	8544	0.00177
ERR1562589_1_kneaddata_paired	Actinobacteriota	615	P	4077	4	4081	0.00084
ERR1562589_1_kneaddata_paired	Cyanobacteria	9876	P	1372	39	1411	0.00029
ERR1562589_1_kneaddata_paired	Proteobacteria	22518	P	1070	7	1077	0.00022
ERR1562589_1_kneaddata_paired	Desulfobacterota_A	11509	P	648	79	727	0.00015
ERR1562589_1_kneaddata_paired	Firmicutes_C	17613	P	80	0	80	0.00002
ERR1562589_1_kneaddata_paired	Campylobacterota	8700	P	72	0	72	0.00001
ERR1562589_1_kneaddata_paired	Firmicutes_I	18140	P	53	0	53	0.00001
ERR1562589_1_kneaddata_paired	Spirochaetota	32587	P	51	0	51	0.00001
ERR1562589_1_kneaddata_paired	Thermotogota	33086	P	8	0	8	0.00000
ERR1562589_1_kneaddata_paired	Elusimicrobiota	11888	P	5	0	5	0.00000
ERR1562590_1_kneaddata_paired	Firmicutes_A	14608	P	4921623	18205	4939828	0.85338
ERR1562590_1_kneaddata_paired	Bacteroidota	4587	P	683871	3283	687154	0.11871
ERR1562590_1_kneaddata_paired	Deferribacterota	10822	P	86011	280	86291	0.01491
ERR1562590_1_kneaddata_paired	Firmicutes	12188	P	30055	782	30837	0.00533
ERR1562590_1_kneaddata_paired	Verrucomicrobiota	33333	P	21111	1053	22164	0.00383
ERR1562590_1_kneaddata_paired	Proteobacteria	22518	P	11108	51	11159	0.00193
ERR1562590_1_kneaddata_paired	Firmicutes_B	17289	P	4898	157	5055	0.00087
ERR1562590_1_kneaddata_paired	Actinobacteriota	615	P	3186	4	3190	0.00055
ERR1562590_1_kneaddata_paired	Cyanobacteria	9876	P	1353	36	1389	0.00024
ERR1562590_1_kneaddata_paired	Desulfobacterota_A	11509	P	870	66	936	0.00016
ERR1562590_1_kneaddata_paired	Spirochaetota	32587	P	162	0	162	0.00003
ERR1562590_1_kneaddata_paired	Campylobacterota	8700	P	146	0	146	0.00003
ERR1562590_1_kneaddata_paired	Firmicutes_C	17613	P	130	0	130	0.00002
ERR1562590_1_kneaddata_paired	Firmicutes_I	18140	P	81	0	81	0.00001
ERR1562590_1_kneaddata_paired	Thermotogota	33086	P	12	0	12	0.00000
ERR1562590_1_kneaddata_paired	Elusimicrobiota	11888	P	9	0	9	0.00000
ERR1562591_1_kneaddata_paired	Firmicutes_A	14608	P	4494383	13177	4507560	0.91410
ERR1562591_1_kneaddata_paired	Bacteroidota	4587	P	388158	2439	390597	0.07921
ERR1562591_1_kneaddata_paired	Verrucomicrobiota	33333	P	9598	438	10036	0.00204
ERR1562591_1_kneaddata_paired	Firmicutes	12188	P	7515	271	7786	0.00158
ERR1562591_1_kneaddata_paired	Actinobacteriota	615	P	5596	4	5600	0.00114
ERR1562591_1_kneaddata_paired	Firmicutes_B	17289	P	3767	111	3878	0.00079
ERR1562591_1_kneaddata_paired	Proteobacteria	22518	P	2006	7	2013	0.00041
ERR1562591_1_kneaddata_paired	Deferribacterota	10822	P	1941	5	1946	0.00039
ERR1562591_1_kneaddata_paired	Cyanobacteria	9876	P	773	14	787	0.00016
ERR1562591_1_kneaddata_paired	Desulfobacterota_A	11509	P	655	52	707	0.00014
ERR1562591_1_kneaddata_paired	Firmicutes_C	17613	P	58	0	58	0.00001
ERR1562591_1_kneaddata_paired	Spirochaetota	32587	P	56	0	56	0.00001
ERR1562591_1_kneaddata_paired	Firmicutes_I	18140	P	48	0	48	0.00001
ERR1562591_1_kneaddata_paired	Campylobacterota	8700	P	39	0	39	0.00001
ERR1562591_1_kneaddata_paired	Thermotogota	33086	P	10	0	10	0.00000
ERR1562591_1_kneaddata_paired	Elusimicrobiota	11888	P	8	0	8	0.00000
ERR1562592_1_kneaddata_paired	Firmicutes_A	14608	P	4788961	16246	4805207	0.93289
ERR1562592_1_kneaddata_paired	Bacteroidota	4587	P	316176	739	316915	0.06153
ERR1562592_1_kneaddata_paired	Firmicutes	12188	P	8560	345	8905	0.00173
ERR1562592_1_kneaddata_paired	Verrucomicrobiota	33333	P	6186	301	6487	0.00126
ERR1562592_1_kneaddata_paired	Actinobacteriota	615	P	5161	5	5166	0.00100
ERR1562592_1_kneaddata_paired	Firmicutes_B	17289	P	4346	137	4483	0.00087
ERR1562592_1_kneaddata_paired	Proteobacteria	22518	P	1243	4	1247	0.00024
ERR1562592_1_kneaddata_paired	Deferribacterota	10822	P	769	2	771	0.00015
ERR1562592_1_kneaddata_paired	Cyanobacteria	9876	P	732	15	747	0.00015
ERR1562592_1_kneaddata_paired	Desulfobacterota_A	11509	P	654	58	712	0.00014
ERR1562592_1_kneaddata_paired	Firmicutes_C	17613	P	69	0	69	0.00001
ERR1562592_1_kneaddata_paired	Firmicutes_I	18140	P	48	0	48	0.00001
ERR1562592_1_kneaddata_paired	Spirochaetota	32587	P	43	0	43	0.00001
ERR1562592_1_kneaddata_paired	Campylobacterota	8700	P	38	0	38	0.00001
ERR1562592_1_kneaddata_paired	Elusimicrobiota	11888	P	27	0	27	0.00001
ERR1562592_1_kneaddata_paired	Thermotogota	33086	P	8	0	8	0.00000
ERR1614693_1_kneaddata_paired	Bacteroidota	4587	P	2102113	70234	2172347	0.67351
ERR1614693_1_kneaddata_paired	Firmicutes_A	14608	P	948507	7518	956025	0.29641
ERR1614693_1_kneaddata_paired	Firmicutes	12188	P	79833	875	80708	0.02502
ERR1614693_1_kneaddata_paired	Actinobacteriota	615	P	15598	18	15616	0.00484
ERR1614693_1_kneaddata_paired	Cyanobacteria	9876	P	232	7	239	0.00007
ERR1614693_1_kneaddata_paired	Proteobacteria	22518	P	123	0	123	0.00004
ERR1614693_1_kneaddata_paired	Desulfobacterota_A	11509	P	81	9	90	0.00003
ERR1614693_1_kneaddata_paired	Firmicutes_B	17289	P	48	2	50	0.00002
ERR1614693_1_kneaddata_paired	Verrucomicrobiota	33333	P	43	1	44	0.00001
ERR1614693_1_kneaddata_paired	Campylobacterota	8700	P	42	0	42	0.00001
ERR1614693_1_kneaddata_paired	Deferribacterota	10822	P	38	0	38	0.00001
ERR1614693_1_kneaddata_paired	Spirochaetota	32587	P	35	0	35	0.00001
ERR1614693_1_kneaddata_paired	Firmicutes_I	18140	P	31	0	31	0.00001
ERR1614693_1_kneaddata_paired	Firmicutes_C	17613	P	3	0	3	0.00000
ERR1614693_1_kneaddata_paired	Elusimicrobiota	11888	P	1	0	1	0.00000
ERR1614693_1_kneaddata_paired	Thermotogota	33086	P	1	0	1	0.00000
ERR1614694_1_kneaddata_paired	Bacteroidota	4587	P	2033647	68925	2102572	0.67029
ERR1614694_1_kneaddata_paired	Firmicutes_A	14608	P	931990	7396	939386	0.29947
ERR1614694_1_kneaddata_paired	Firmicutes	12188	P	78404	875	79279	0.02527
ERR1614694_1_kneaddata_paired	Actinobacteriota	615	P	14845	17	14862	0.00474
ERR1614694_1_kneaddata_paired	Cyanobacteria	9876	P	255	8	263	0.00008
ERR1614694_1_kneaddata_paired	Proteobacteria	22518	P	122	0	122	0.00004
ERR1614694_1_kneaddata_paired	Desulfobacterota_A	11509	P	77	8	85	0.00003
ERR1614694_1_kneaddata_paired	Firmicutes_B	17289	P	58	2	60	0.00002
ERR1614694_1_kneaddata_paired	Verrucomicrobiota	33333	P	52	1	53	0.00002
ERR1614694_1_kneaddata_paired	Spirochaetota	32587	P	36	0	36	0.00001
ERR1614694_1_kneaddata_paired	Campylobacterota	8700	P	35	0	35	0.00001
ERR1614694_1_kneaddata_paired	Deferribacterota	10822	P	30	0	30	0.00001
ERR1614694_1_kneaddata_paired	Firmicutes_I	18140	P	29	0	29	0.00001
ERR1614694_1_kneaddata_paired	Firmicutes_C	17613	P	5	0	5	0.00000
ERR1614694_1_kneaddata_paired	Elusimicrobiota	11888	P	3	0	3	0.00000
ERR1614695_1_kneaddata_paired	Bacteroidota	4587	P	2016258	68778	2085036	0.67234
ERR1614695_1_kneaddata_paired	Firmicutes_A	14608	P	914776	7289	922065	0.29733
ERR1614695_1_kneaddata_paired	Firmicutes	12188	P	78255	883	79138	0.02552
ERR1614695_1_kneaddata_paired	Actinobacteriota	615	P	14186	16	14202	0.00458
ERR1614695_1_kneaddata_paired	Cyanobacteria	9876	P	245	8	253	0.00008
ERR1614695_1_kneaddata_paired	Proteobacteria	22518	P	139	0	139	0.00004
ERR1614695_1_kneaddata_paired	Desulfobacterota_A	11509	P	60	7	67	0.00002
ERR1614695_1_kneaddata_paired	Verrucomicrobiota	33333	P	58	2	60	0.00002
ERR1614695_1_kneaddata_paired	Firmicutes_B	17289	P	43	1	44	0.00001
ERR1614695_1_kneaddata_paired	Campylobacterota	8700	P	41	0	41	0.00001
ERR1614695_1_kneaddata_paired	Spirochaetota	32587	P	33	0	33	0.00001
ERR1614695_1_kneaddata_paired	Deferribacterota	10822	P	30	0	30	0.00001
ERR1614695_1_kneaddata_paired	Firmicutes_I	18140	P	30	0	30	0.00001
ERR1614695_1_kneaddata_paired	Firmicutes_C	17613	P	4	0	4	0.00000
ERR1614695_1_kneaddata_paired	Thermotogota	33086	P	2	0	2	0.00000
ERR1614696_1_kneaddata_paired	Bacteroidota	4587	P	2075319	70216	2145535	0.67140
ERR1614696_1_kneaddata_paired	Firmicutes_A	14608	P	946964	7558	954522	0.29870
ERR1614696_1_kneaddata_paired	Firmicutes	12188	P	78845	880	79725	0.02495
ERR1614696_1_kneaddata_paired	Actinobacteriota	615	P	15125	17	15142	0.00474
ERR1614696_1_kneaddata_paired	Cyanobacteria	9876	P	256	10	266	0.00008
ERR1614696_1_kneaddata_paired	Proteobacteria	22518	P	131	0	131	0.00004
ERR1614696_1_kneaddata_paired	Desulfobacterota_A	11509	P	60	7	67	0.00002
ERR1614696_1_kneaddata_paired	Firmicutes_B	17289	P	57	2	59	0.00002
ERR1614696_1_kneaddata_paired	Verrucomicrobiota	33333	P	48	1	49	0.00002
ERR1614696_1_kneaddata_paired	Campylobacterota	8700	P	40	0	40	0.00001
ERR1614696_1_kneaddata_paired	Spirochaetota	32587	P	34	0	34	0.00001
ERR1614696_1_kneaddata_paired	Deferribacterota	10822	P	27	0	27	0.00001
ERR1614696_1_kneaddata_paired	Firmicutes_I	18140	P	15	0	15	0.00000
ERR1614696_1_kneaddata_paired	Firmicutes_C	17613	P	7	0	7	0.00000
ERR1614697_1_kneaddata_paired	Bacteroidota	4587	P	1979446	67777	2047223	0.66950
ERR1614697_1_kneaddata_paired	Firmicutes_A	14608	P	910067	7267	917334	0.30000
ERR1614697_1_kneaddata_paired	Firmicutes	12188	P	77280	866	78146	0.02556
ERR1614697_1_kneaddata_paired	Actinobacteriota	615	P	14391	16	14407	0.00471
ERR1614697_1_kneaddata_paired	Cyanobacteria	9876	P	234	8	242	0.00008
ERR1614697_1_kneaddata_paired	Proteobacteria	22518	P	142	0	142	0.00005
ERR1614697_1_kneaddata_paired	Desulfobacterota_A	11509	P	59	8	67	0.00002
ERR1614697_1_kneaddata_paired	Campylobacterota	8700	P	58	0	58	0.00002
ERR1614697_1_kneaddata_paired	Verrucomicrobiota	33333	P	58	2	60	0.00002
ERR1614697_1_kneaddata_paired	Firmicutes_B	17289	P	51	2	53	0.00002
ERR1614697_1_kneaddata_paired	Deferribacterota	10822	P	35	0	35	0.00001
ERR1614697_1_kneaddata_paired	Spirochaetota	32587	P	34	0	34	0.00001
ERR1614697_1_kneaddata_paired	Firmicutes_I	18140	P	20	0	20	0.00001
ERR1614697_1_kneaddata_paired	Firmicutes_C	17613	P	4	0	4	0.00000
ERR1614697_1_kneaddata_paired	Elusimicrobiota	11888	P	1	0	1	0.00000
ERR1614697_1_kneaddata_paired	Thermotogota	33086	P	1	0	1	0.00000
ERR1614698_1_kneaddata_paired	Bacteroidota	4587	P	2091460	70365	2161825	0.67294
ERR1614698_1_kneaddata_paired	Firmicutes_A	14608	P	947112	7485	954597	0.29715
ERR1614698_1_kneaddata_paired	Firmicutes	12188	P	79224	869	80093	0.02493
ERR1614698_1_kneaddata_paired	Actinobacteriota	615	P	15185	17	15202	0.00473
ERR1614698_1_kneaddata_paired	Cyanobacteria	9876	P	248	8	256	0.00008
ERR1614698_1_kneaddata_paired	Proteobacteria	22518	P	150	0	150	0.00005
ERR1614698_1_kneaddata_paired	Desulfobacterota_A	11509	P	85	10	95	0.00003
ERR1614698_1_kneaddata_paired	Verrucomicrobiota	33333	P	63	2	65	0.00002
ERR1614698_1_kneaddata_paired	Campylobacterota	8700	P	53	0	53	0.00002
ERR1614698_1_kneaddata_paired	Firmicutes_B	17289	P	50	2	52	0.00002
ERR1614698_1_kneaddata_paired	Spirochaetota	32587	P	39	0	39	0.00001
ERR1614698_1_kneaddata_paired	Deferribacterota	10822	P	35	0	35	0.00001
ERR1614698_1_kneaddata_paired	Firmicutes_I	18140	P	28	0	28	0.00001
ERR1614698_1_kneaddata_paired	Firmicutes_C	17613	P	9	0	9	0.00000
ERR1614698_1_kneaddata_paired	Thermotogota	33086	P	2	0	2	0.00000
ERR1614698_1_kneaddata_paired	Elusimicrobiota	11888	P	1	0	1	0.00000
ERR1614699_1_kneaddata_paired	Bacteroidota	4587	P	2029579	69167	2098746	0.66928
ERR1614699_1_kneaddata_paired	Firmicutes_A	14608	P	935080	7466	942546	0.30057
ERR1614699_1_kneaddata_paired	Firmicutes	12188	P	78021	875	78896	0.02516
ERR1614699_1_kneaddata_paired	Actinobacteriota	615	P	14896	17	14913	0.00476
ERR1614699_1_kneaddata_paired	Cyanobacteria	9876	P	246	8	254	0.00008
ERR1614699_1_kneaddata_paired	Proteobacteria	22518	P	151	0	151	0.00005
ERR1614699_1_kneaddata_paired	Verrucomicrobiota	33333	P	64	1	65	0.00002
ERR1614699_1_kneaddata_paired	Desulfobacterota_A	11509	P	63	8	71	0.00002
ERR1614699_1_kneaddata_paired	Campylobacterota	8700	P	48	0	48	0.00002
ERR1614699_1_kneaddata_paired	Firmicutes_B	17289	P	45	1	46	0.00001
ERR1614699_1_kneaddata_paired	Deferribacterota	10822	P	29	0	29	0.00001
ERR1614699_1_kneaddata_paired	Firmicutes_I	18140	P	23	0	23	0.00001
ERR1614699_1_kneaddata_paired	Spirochaetota	32587	P	19	0	19	0.00001
ERR1614699_1_kneaddata_paired	Firmicutes_C	17613	P	4	0	4	0.00000
ERR1614699_1_kneaddata_paired	Thermotogota	33086	P	2	0	2	0.00000
ERR1614700_1_kneaddata_paired	Bacteroidota	4587	P	941512	32701	974213	0.66875
ERR1614700_1_kneaddata_paired	Firmicutes_A	14608	P	434728	3529	438257	0.30084
ERR1614700_1_kneaddata_paired	Firmicutes	12188	P	36777	425	37202	0.02554
ERR1614700_1_kneaddata_paired	Actinobacteriota	615	P	6721	7	6728	0.00462
ERR1614700_1_kneaddata_paired	Cyanobacteria	9876	P	126	4	130	0.00009
ERR1614700_1_kneaddata_paired	Proteobacteria	22518	P	89	0	89	0.00006
ERR1614700_1_kneaddata_paired	Desulfobacterota_A	11509	P	38	4	42	0.00003
ERR1614700_1_kneaddata_paired	Firmicutes_B	17289	P	31	1	32	0.00002
ERR1614700_1_kneaddata_paired	Campylobacterota	8700	P	20	0	20	0.00001
ERR1614700_1_kneaddata_paired	Verrucomicrobiota	33333	P	19	0	19	0.00001
ERR1614700_1_kneaddata_paired	Deferribacterota	10822	P	14	0	14	0.00001
ERR1614700_1_kneaddata_paired	Spirochaetota	32587	P	14	0	14	0.00001
ERR1614700_1_kneaddata_paired	Firmicutes_I	18140	P	8	0	8	0.00001
ERR1614700_1_kneaddata_paired	Firmicutes_C	17613	P	3	0	3	0.00000
ERR1614700_1_kneaddata_paired	Elusimicrobiota	11888	P	1	0	1	0.00000
ERR1614700_1_kneaddata_paired	Thermotogota	33086	P	1	0	1	0.00000
ERR1614701_1_kneaddata_paired	Bacteroidota	4587	P	2004436	60674	2065110	0.75869
ERR1614701_1_kneaddata_paired	Firmicutes_A	14608	P	399187	4154	403341	0.14818
ERR1614701_1_kneaddata_paired	Firmicutes	12188	P	141998	1488	143486	0.05271
ERR1614701_1_kneaddata_paired	Actinobacteriota	615	P	108404	113	108517	0.03987
ERR1614701_1_kneaddata_paired	Cyanobacteria	9876	P	694	16	710	0.00026
ERR1614701_1_kneaddata_paired	Proteobacteria	22518	P	230	0	230	0.00008
ERR1614701_1_kneaddata_paired	Deferribacterota	10822	P	126	0	126	0.00005
ERR1614701_1_kneaddata_paired	Spirochaetota	32587	P	119	0	119	0.00004
ERR1614701_1_kneaddata_paired	Campylobacterota	8700	P	118	0	118	0.00004
ERR1614701_1_kneaddata_paired	Desulfobacterota_A	11509	P	62	4	66	0.00002
ERR1614701_1_kneaddata_paired	Firmicutes_B	17289	P	56	2	58	0.00002
ERR1614701_1_kneaddata_paired	Firmicutes_I	18140	P	22	0	22	0.00001
ERR1614701_1_kneaddata_paired	Verrucomicrobiota	33333	P	22	0	22	0.00001
ERR1614701_1_kneaddata_paired	Firmicutes_C	17613	P	10	0	10	0.00000
ERR1614701_1_kneaddata_paired	Elusimicrobiota	11888	P	7	0	7	0.00000
ERR1614701_1_kneaddata_paired	Thermotogota	33086	P	6	0	6	0.00000
ERR1614702_1_kneaddata_paired	Bacteroidota	4587	P	1860035	57884	1917919	0.75354
ERR1614702_1_kneaddata_paired	Firmicutes_A	14608	P	381537	3984	385521	0.15147
ERR1614702_1_kneaddata_paired	Firmicutes	12188	P	138958	1495	140453	0.05518
ERR1614702_1_kneaddata_paired	Actinobacteriota	615	P	99722	107	99829	0.03922
ERR1614702_1_kneaddata_paired	Cyanobacteria	9876	P	695	17	712	0.00028
ERR1614702_1_kneaddata_paired	Proteobacteria	22518	P	215	1	216	0.00008
ERR1614702_1_kneaddata_paired	Spirochaetota	32587	P	145	0	145	0.00006
ERR1614702_1_kneaddata_paired	Deferribacterota	10822	P	103	0	103	0.00004
ERR1614702_1_kneaddata_paired	Campylobacterota	8700	P	99	0	99	0.00004
ERR1614702_1_kneaddata_paired	Firmicutes_B	17289	P	69	2	71	0.00003
ERR1614702_1_kneaddata_paired	Desulfobacterota_A	11509	P	67	5	72	0.00003
ERR1614702_1_kneaddata_paired	Firmicutes_I	18140	P	42	0	42	0.00002
ERR1614702_1_kneaddata_paired	Verrucomicrobiota	33333	P	18	0	18	0.00001
ERR1614702_1_kneaddata_paired	Thermotogota	33086	P	5	0	5	0.00000
ERR1614702_1_kneaddata_paired	Elusimicrobiota	11888	P	4	0	4	0.00000
ERR1614702_1_kneaddata_paired	Firmicutes_C	17613	P	4	0	4	0.00000
ERR1614703_1_kneaddata_paired	Bacteroidota	4587	P	1986661	60480	2047141	0.75840
ERR1614703_1_kneaddata_paired	Firmicutes_A	14608	P	397029	4093	401122	0.14860
ERR1614703_1_kneaddata_paired	Firmicutes	12188	P	141933	1500	143433	0.05314
ERR1614703_1_kneaddata_paired	Actinobacteriota	615	P	105966	111	106077	0.03930
ERR1614703_1_kneaddata_paired	Cyanobacteria	9876	P	713	18	731	0.00027
ERR1614703_1_kneaddata_paired	Proteobacteria	22518	P	243	1	244	0.00009
ERR1614703_1_kneaddata_paired	Spirochaetota	32587	P	153	0	153	0.00006
ERR1614703_1_kneaddata_paired	Deferribacterota	10822	P	108	0	108	0.00004
ERR1614703_1_kneaddata_paired	Campylobacterota	8700	P	102	0	102	0.00004
ERR1614703_1_kneaddata_paired	Desulfobacterota_A	11509	P	54	3	57	0.00002
ERR1614703_1_kneaddata_paired	Firmicutes_B	17289	P	45	1	46	0.00002
ERR1614703_1_kneaddata_paired	Firmicutes_I	18140	P	34	0	34	0.00001
ERR1614703_1_kneaddata_paired	Verrucomicrobiota	33333	P	24	0	24	0.00001
ERR1614703_1_kneaddata_paired	Firmicutes_C	17613	P	10	0	10	0.00000
ERR1614703_1_kneaddata_paired	Elusimicrobiota	11888	P	5	0	5	0.00000
ERR1614703_1_kneaddata_paired	Thermotogota	33086	P	5	0	5	0.00000
ERR1614704_1_kneaddata_paired	Bacteroidota	4587	P	1890567	58496	1949063	0.75354
ERR1614704_1_kneaddata_paired	Firmicutes_A	14608	P	388253	4024	392277	0.15166
ERR1614704_1_kneaddata_paired	Firmicutes	12188	P	139584	1486	141070	0.05454
ERR1614704_1_kneaddata_paired	Actinobacteriota	615	P	102559	109	102668	0.03969
ERR1614704_1_kneaddata_paired	Cyanobacteria	9876	P	688	14	702	0.00027
ERR1614704_1_kneaddata_paired	Proteobacteria	22518	P	226	1	227	0.00009
ERR1614704_1_kneaddata_paired	Spirochaetota	32587	P	140	0	140	0.00005
ERR1614704_1_kneaddata_paired	Deferribacterota	10822	P	119	0	119	0.00005
ERR1614704_1_kneaddata_paired	Campylobacterota	8700	P	83	0	83	0.00003
ERR1614704_1_kneaddata_paired	Firmicutes_B	17289	P	68	2	70	0.00003
ERR1614704_1_kneaddata_paired	Desulfobacterota_A	11509	P	54	3	57	0.00002
ERR1614704_1_kneaddata_paired	Firmicutes_I	18140	P	37	0	37	0.00001
ERR1614704_1_kneaddata_paired	Verrucomicrobiota	33333	P	25	0	25	0.00001
ERR1614704_1_kneaddata_paired	Elusimicrobiota	11888	P	2	0	2	0.00000
ERR1614704_1_kneaddata_paired	Firmicutes_C	17613	P	2	0	2	0.00000
ERR1614704_1_kneaddata_paired	Thermotogota	33086	P	2	0	2	0.00000
ERR1614705_1_kneaddata_paired	Bacteroidota	4587	P	1956631	60449	2017080	0.75680
ERR1614705_1_kneaddata_paired	Firmicutes_A	14608	P	394583	4140	398723	0.14960
ERR1614705_1_kneaddata_paired	Firmicutes	12188	P	141287	1514	142801	0.05358
ERR1614705_1_kneaddata_paired	Actinobacteriota	615	P	105141	113	105254	0.03949
ERR1614705_1_kneaddata_paired	Cyanobacteria	9876	P	672	17	689	0.00026
ERR1614705_1_kneaddata_paired	Proteobacteria	22518	P	224	1	225	0.00008
ERR1614705_1_kneaddata_paired	Spirochaetota	32587	P	128	0	128	0.00005
ERR1614705_1_kneaddata_paired	Deferribacterota	10822	P	122	0	122	0.00005
ERR1614705_1_kneaddata_paired	Campylobacterota	8700	P	89	0	89	0.00003
ERR1614705_1_kneaddata_paired	Firmicutes_B	17289	P	51	2	53	0.00002
ERR1614705_1_kneaddata_paired	Desulfobacterota_A	11509	P	39	2	41	0.00002
ERR1614705_1_kneaddata_paired	Firmicutes_I	18140	P	35	0	35	0.00001
ERR1614705_1_kneaddata_paired	Verrucomicrobiota	33333	P	19	0	19	0.00001
ERR1614705_1_kneaddata_paired	Firmicutes_C	17613	P	7	0	7	0.00000
ERR1614705_1_kneaddata_paired	Thermotogota	33086	P	7	0	7	0.00000
ERR1614705_1_kneaddata_paired	Elusimicrobiota	11888	P	1	0	1	0.00000
ERR1614706_1_kneaddata_paired	Bacteroidota	4587	P	1940293	60295	2000588	0.75329
ERR1614706_1_kneaddata_paired	Firmicutes_A	14608	P	398503	4170	402673	0.15162
ERR1614706_1_kneaddata_paired	Firmicutes	12188	P	142006	1529	143535	0.05405
ERR1614706_1_kneaddata_paired	Actinobacteriota	615	P	107405	114	107519	0.04048
ERR1614706_1_kneaddata_paired	Cyanobacteria	9876	P	649	17	666	0.00025
ERR1614706_1_kneaddata_paired	Proteobacteria	22518	P	221	1	222	0.00008
ERR1614706_1_kneaddata_paired	Spirochaetota	32587	P	148	0	148	0.00006
ERR1614706_1_kneaddata_paired	Deferribacterota	10822	P	121	0	121	0.00005
ERR1614706_1_kneaddata_paired	Campylobacterota	8700	P	102	0	102	0.00004
ERR1614706_1_kneaddata_paired	Firmicutes_B	17289	P	69	2	71	0.00003
ERR1614706_1_kneaddata_paired	Desulfobacterota_A	11509	P	67	5	72	0.00003
ERR1614706_1_kneaddata_paired	Firmicutes_I	18140	P	43	0	43	0.00002
ERR1614706_1_kneaddata_paired	Verrucomicrobiota	33333	P	28	1	29	0.00001
ERR1614706_1_kneaddata_paired	Thermotogota	33086	P	6	0	6	0.00000
ERR1614706_1_kneaddata_paired	Firmicutes_C	17613	P	5	0	5	0.00000
ERR1614706_1_kneaddata_paired	Elusimicrobiota	11888	P	2	0	2	0.00000
ERR1614707_1_kneaddata_paired	Bacteroidota	4587	P	576242	17939	594181	0.74975
ERR1614707_1_kneaddata_paired	Firmicutes_A	14608	P	120677	1253	121930	0.15385
ERR1614707_1_kneaddata_paired	Firmicutes	12188	P	44580	480	45060	0.05686
ERR1614707_1_kneaddata_paired	Actinobacteriota	615	P	30778	32	30810	0.03888
ERR1614707_1_kneaddata_paired	Cyanobacteria	9876	P	241	5	246	0.00031
ERR1614707_1_kneaddata_paired	Proteobacteria	22518	P	96	0	96	0.00012
ERR1614707_1_kneaddata_paired	Deferribacterota	10822	P	42	0	42	0.00005
ERR1614707_1_kneaddata_paired	Spirochaetota	32587	P	37	0	37	0.00005
ERR1614707_1_kneaddata_paired	Campylobacterota	8700	P	32	0	32	0.00004
ERR1614707_1_kneaddata_paired	Desulfobacterota_A	11509	P	30	1	31	0.00004
ERR1614707_1_kneaddata_paired	Firmicutes_B	17289	P	21	0	21	0.00003
ERR1614707_1_kneaddata_paired	Firmicutes_I	18140	P	12	0	12	0.00002
ERR1614707_1_kneaddata_paired	Verrucomicrobiota	33333	P	5	0	5	0.00001
ERR1614707_1_kneaddata_paired	Thermotogota	33086	P	2	0	2	0.00000
ERR1614707_1_kneaddata_paired	Firmicutes_C	17613	P	1	0	1	0.00000
ERR1614708_1_kneaddata_paired	Firmicutes_A	14608	P	1374488	7592	1382080	0.68177
ERR1614708_1_kneaddata_paired	Bacteroidota	4587	P	631546	5348	636894	0.31418
ERR1614708_1_kneaddata_paired	Firmicutes	12188	P	6724	291	7015	0.00346
ERR1614708_1_kneaddata_paired	Actinobacteriota	615	P	492	0	492	0.00024
ERR1614708_1_kneaddata_paired	Desulfobacterota_A	11509	P	186	24	210	0.00010
ERR1614708_1_kneaddata_paired	Cyanobacteria	9876	P	169	4	173	0.00009
ERR1614708_1_kneaddata_paired	Firmicutes_B	17289	P	146	5	151	0.00007
ERR1614708_1_kneaddata_paired	Proteobacteria	22518	P	63	0	63	0.00003
ERR1614708_1_kneaddata_paired	Verrucomicrobiota	33333	P	29	1	30	0.00002
ERR1614708_1_kneaddata_paired	Firmicutes_C	17613	P	28	0	28	0.00001
ERR1614708_1_kneaddata_paired	Campylobacterota	8700	P	15	0	15	0.00001
ERR1614708_1_kneaddata_paired	Deferribacterota	10822	P	14	0	14	0.00001
ERR1614708_1_kneaddata_paired	Firmicutes_I	18140	P	13	0	13	0.00001
ERR1614708_1_kneaddata_paired	Spirochaetota	32587	P	6	0	6	0.00000
ERR1614708_1_kneaddata_paired	Thermotogota	33086	P	1	0	1	0.00000
ERR1614709_1_kneaddata_paired	Firmicutes_A	14608	P	1519698	8123	1527821	0.68225
ERR1614709_1_kneaddata_paired	Bacteroidota	4587	P	697140	5636	702776	0.31383
ERR1614709_1_kneaddata_paired	Firmicutes	12188	P	7005	291	7296	0.00326
ERR1614709_1_kneaddata_paired	Actinobacteriota	615	P	700	0	700	0.00031
ERR1614709_1_kneaddata_paired	Desulfobacterota_A	11509	P	209	27	236	0.00011
ERR1614709_1_kneaddata_paired	Cyanobacteria	9876	P	192	4	196	0.00009
ERR1614709_1_kneaddata_paired	Firmicutes_B	17289	P	150	5	155	0.00007
ERR1614709_1_kneaddata_paired	Proteobacteria	22518	P	82	0	82	0.00004
ERR1614709_1_kneaddata_paired	Verrucomicrobiota	33333	P	37	2	39	0.00002
ERR1614709_1_kneaddata_paired	Deferribacterota	10822	P	22	0	22	0.00001
ERR1614709_1_kneaddata_paired	Firmicutes_C	17613	P	20	0	20	0.00001
ERR1614709_1_kneaddata_paired	Firmicutes_I	18140	P	14	0	14	0.00001
ERR1614709_1_kneaddata_paired	Spirochaetota	32587	P	6	0	6	0.00000
ERR1614709_1_kneaddata_paired	Campylobacterota	8700	P	4	0	4	0.00000
ERR1614709_1_kneaddata_paired	Thermotogota	33086	P	4	0	4	0.00000
ERR1614710_1_kneaddata_paired	Firmicutes_A	14608	P	1445848	8014	1453862	0.68182
ERR1614710_1_kneaddata_paired	Bacteroidota	4587	P	664197	5585	669782	0.31411
ERR1614710_1_kneaddata_paired	Firmicutes	12188	P	7038	296	7334	0.00344
ERR1614710_1_kneaddata_paired	Actinobacteriota	615	P	623	0	623	0.00029
ERR1614710_1_kneaddata_paired	Desulfobacterota_A	11509	P	196	27	223	0.00010
ERR1614710_1_kneaddata_paired	Cyanobacteria	9876	P	176	5	181	0.00008
ERR1614710_1_kneaddata_paired	Firmicutes_B	17289	P	143	5	148	0.00007
ERR1614710_1_kneaddata_paired	Proteobacteria	22518	P	72	1	73	0.00003
ERR1614710_1_kneaddata_paired	Verrucomicrobiota	33333	P	35	1	36	0.00002
ERR1614710_1_kneaddata_paired	Firmicutes_C	17613	P	15	0	15	0.00001
ERR1614710_1_kneaddata_paired	Deferribacterota	10822	P	14	0	14	0.00001
ERR1614710_1_kneaddata_paired	Firmicutes_I	18140	P	9	0	9	0.00000
ERR1614710_1_kneaddata_paired	Spirochaetota	32587	P	8	0	8	0.00000
ERR1614710_1_kneaddata_paired	Campylobacterota	8700	P	5	0	5	0.00000
ERR1614712_1_kneaddata_paired	Firmicutes_A	14608	P	1538948	8308	1547256	0.68043
ERR1614712_1_kneaddata_paired	Bacteroidota	4587	P	711901	5841	717742	0.31564
ERR1614712_1_kneaddata_paired	Firmicutes	12188	P	7201	299	7500	0.00330
ERR1614712_1_kneaddata_paired	Actinobacteriota	615	P	617	0	617	0.00027
ERR1614712_1_kneaddata_paired	Desulfobacterota_A	11509	P	214	28	242	0.00011
ERR1614712_1_kneaddata_paired	Cyanobacteria	9876	P	198	5	203	0.00009
ERR1614712_1_kneaddata_paired	Firmicutes_B	17289	P	153	5	158	0.00007
ERR1614712_1_kneaddata_paired	Proteobacteria	22518	P	90	1	91	0.00004
ERR1614712_1_kneaddata_paired	Verrucomicrobiota	33333	P	34	1	35	0.00002
ERR1614712_1_kneaddata_paired	Firmicutes_C	17613	P	30	0	30	0.00001
ERR1614712_1_kneaddata_paired	Deferribacterota	10822	P	22	0	22	0.00001
ERR1614712_1_kneaddata_paired	Firmicutes_I	18140	P	14	0	14	0.00001
ERR1614712_1_kneaddata_paired	Campylobacterota	8700	P	11	0	11	0.00000
ERR1614712_1_kneaddata_paired	Spirochaetota	32587	P	6	0	6	0.00000
ERR1614712_1_kneaddata_paired	Thermotogota	33086	P	3	0	3	0.00000
ERR1614713_1_kneaddata_paired	Firmicutes_A	14608	P	1739500	9328	1748828	0.68062
ERR1614713_1_kneaddata_paired	Bacteroidota	4587	P	804249	6467	810716	0.31552
ERR1614713_1_kneaddata_paired	Firmicutes	12188	P	7894	316	8210	0.00320
ERR1614713_1_kneaddata_paired	Actinobacteriota	615	P	844	1	845	0.00033
ERR1614713_1_kneaddata_paired	Desulfobacterota_A	11509	P	221	28	249	0.00010
ERR1614713_1_kneaddata_paired	Cyanobacteria	9876	P	207	4	211	0.00008
ERR1614713_1_kneaddata_paired	Firmicutes_B	17289	P	162	6	168	0.00007
ERR1614713_1_kneaddata_paired	Proteobacteria	22518	P	92	1	93	0.00004
ERR1614713_1_kneaddata_paired	Verrucomicrobiota	33333	P	48	2	50	0.00002
ERR1614713_1_kneaddata_paired	Firmicutes_C	17613	P	23	0	23	0.00001
ERR1614713_1_kneaddata_paired	Firmicutes_I	18140	P	17	0	17	0.00001
ERR1614713_1_kneaddata_paired	Deferribacterota	10822	P	12	0	12	0.00000
ERR1614713_1_kneaddata_paired	Spirochaetota	32587	P	11	0	11	0.00000
ERR1614713_1_kneaddata_paired	Campylobacterota	8700	P	7	0	7	0.00000
ERR1614713_1_kneaddata_paired	Elusimicrobiota	11888	P	1	0	1	0.00000
ERR1614713_1_kneaddata_paired	Thermotogota	33086	P	1	0	1	0.00000
ERR1614715_1_kneaddata_paired	Firmicutes_A	14608	P	342322	1874	344196	0.68144
ERR1614715_1_kneaddata_paired	Bacteroidota	4587	P	157666	1294	158960	0.31471
ERR1614715_1_kneaddata_paired	Firmicutes	12188	P	1530	62	1592	0.00315
ERR1614715_1_kneaddata_paired	Actinobacteriota	615	P	195	0	195	0.00039
ERR1614715_1_kneaddata_paired	Desulfobacterota_A	11509	P	42	5	47	0.00009
ERR1614715_1_kneaddata_paired	Cyanobacteria	9876	P	33	0	33	0.00007
ERR1614715_1_kneaddata_paired	Firmicutes_B	17289	P	28	1	29	0.00006
ERR1614715_1_kneaddata_paired	Proteobacteria	22518	P	15	0	15	0.00003
ERR1614715_1_kneaddata_paired	Verrucomicrobiota	33333	P	13	0	13	0.00003
ERR1614715_1_kneaddata_paired	Firmicutes_C	17613	P	7	0	7	0.00001
ERR1614715_1_kneaddata_paired	Deferribacterota	10822	P	6	0	6	0.00001
ERR1614715_1_kneaddata_paired	Firmicutes_I	18140	P	2	0	2	0.00000
ERR1614715_1_kneaddata_paired	Campylobacterota	8700	P	1	0	1	0.00000
ERR1614716_1_kneaddata_paired	Bacteroidota	4587	P	1609209	8077	1617286	0.71073
ERR1614716_1_kneaddata_paired	Firmicutes_A	14608	P	647876	3220	651096	0.28613
ERR1614716_1_kneaddata_paired	Firmicutes	12188	P	6019	61	6080	0.00267
ERR1614716_1_kneaddata_paired	Actinobacteriota	615	P	659	0	659	0.00029
ERR1614716_1_kneaddata_paired	Cyanobacteria	9876	P	177	4	181	0.00008
ERR1614716_1_kneaddata_paired	Desulfobacterota_A	11509	P	67	7	74	0.00003
ERR1614716_1_kneaddata_paired	Proteobacteria	22518	P	58	0	58	0.00003
ERR1614716_1_kneaddata_paired	Firmicutes_B	17289	P	51	1	52	0.00002
ERR1614716_1_kneaddata_paired	Firmicutes_I	18140	P	13	0	13	0.00001
ERR1614716_1_kneaddata_paired	Verrucomicrobiota	33333	P	11	0	11	0.00001
ERR1614716_1_kneaddata_paired	Firmicutes_C	17613	P	6	0	6	0.00000
ERR1614716_1_kneaddata_paired	Spirochaetota	32587	P	5	0	5	0.00000
ERR1614716_1_kneaddata_paired	Deferribacterota	10822	P	3	0	3	0.00000
ERR1614716_1_kneaddata_paired	Campylobacterota	8700	P	1	0	1	0.00000
ERR1614716_1_kneaddata_paired	Thermotogota	33086	P	1	0	1	0.00000
ERR1614718_1_kneaddata_paired	Bacteroidota	4587	P	1518445	7534	1525979	0.70930
ERR1614718_1_kneaddata_paired	Firmicutes_A	14608	P	615350	3024	618374	0.28743
ERR1614718_1_kneaddata_paired	Firmicutes	12188	P	5972	63	6035	0.00281
ERR1614718_1_kneaddata_paired	Actinobacteriota	615	P	602	0	602	0.00028
ERR1614718_1_kneaddata_paired	Cyanobacteria	9876	P	166	3	169	0.00008
ERR1614718_1_kneaddata_paired	Desulfobacterota_A	11509	P	79	9	88	0.00004
ERR1614718_1_kneaddata_paired	Firmicutes_B	17289	P	52	1	53	0.00002
ERR1614718_1_kneaddata_paired	Proteobacteria	22518	P	51	0	51	0.00002
ERR1614718_1_kneaddata_paired	Verrucomicrobiota	33333	P	16	0	16	0.00001
ERR1614718_1_kneaddata_paired	Firmicutes_I	18140	P	15	0	15	0.00001
ERR1614718_1_kneaddata_paired	Deferribacterota	10822	P	12	0	12	0.00001
ERR1614718_1_kneaddata_paired	Campylobacterota	8700	P	2	0	2	0.00000
ERR1614718_1_kneaddata_paired	Firmicutes_C	17613	P	1	0	1	0.00000
ERR1614718_1_kneaddata_paired	Spirochaetota	32587	P	1	0	1	0.00000
ERR1614719_1_kneaddata_paired	Bacteroidota	4587	P	1707657	8493	1716150	0.71317
ERR1614719_1_kneaddata_paired	Firmicutes_A	14608	P	679212	3388	682600	0.28366
ERR1614719_1_kneaddata_paired	Firmicutes	12188	P	6374	63	6437	0.00268
ERR1614719_1_kneaddata_paired	Actinobacteriota	615	P	745	1	746	0.00031
ERR1614719_1_kneaddata_paired	Cyanobacteria	9876	P	169	3	172	0.00007
ERR1614719_1_kneaddata_paired	Desulfobacterota_A	11509	P	70	8	78	0.00003
ERR1614719_1_kneaddata_paired	Proteobacteria	22518	P	56	0	56	0.00002
ERR1614719_1_kneaddata_paired	Firmicutes_B	17289	P	55	1	56	0.00002
ERR1614719_1_kneaddata_paired	Firmicutes_I	18140	P	22	0	22	0.00001
ERR1614719_1_kneaddata_paired	Verrucomicrobiota	33333	P	19	0	19	0.00001
ERR1614719_1_kneaddata_paired	Deferribacterota	10822	P	15	0	15	0.00001
ERR1614719_1_kneaddata_paired	Campylobacterota	8700	P	4	0	4	0.00000
ERR1614719_1_kneaddata_paired	Firmicutes_C	17613	P	2	0	2	0.00000
ERR1614719_1_kneaddata_paired	Spirochaetota	32587	P	1	0	1	0.00000
ERR1614719_1_kneaddata_paired	Thermotogota	33086	P	1	0	1	0.00000
ERR1614721_1_kneaddata_paired	Bacteroidota	4587	P	1865999	9030	1875029	0.71580
ERR1614721_1_kneaddata_paired	Firmicutes_A	14608	P	732711	3583	736294	0.28108
ERR1614721_1_kneaddata_paired	Firmicutes	12188	P	6727	67	6794	0.00259
ERR1614721_1_kneaddata_paired	Actinobacteriota	615	P	895	1	896	0.00034
ERR1614721_1_kneaddata_paired	Cyanobacteria	9876	P	165	3	168	0.00006
ERR1614721_1_kneaddata_paired	Desulfobacterota_A	11509	P	91	10	101	0.00004
ERR1614721_1_kneaddata_paired	Proteobacteria	22518	P	78	0	78	0.00003
ERR1614721_1_kneaddata_paired	Firmicutes_B	17289	P	51	1	52	0.00002
ERR1614721_1_kneaddata_paired	Verrucomicrobiota	33333	P	20	0	20	0.00001
ERR1614721_1_kneaddata_paired	Firmicutes_I	18140	P	16	0	16	0.00001
ERR1614721_1_kneaddata_paired	Deferribacterota	10822	P	12	0	12	0.00000
ERR1614721_1_kneaddata_paired	Firmicutes_C	17613	P	5	0	5	0.00000
ERR1614721_1_kneaddata_paired	Spirochaetota	32587	P	3	0	3	0.00000
ERR1614721_1_kneaddata_paired	Campylobacterota	8700	P	2	0	2	0.00000
ERR1614721_1_kneaddata_paired	Thermotogota	33086	P	1	0	1	0.00000
ERR1614722_1_kneaddata_paired	Bacteroidota	4587	P	589269	2652	591921	0.71516
ERR1614722_1_kneaddata_paired	Firmicutes_A	14608	P	232043	1070	233113	0.28165
ERR1614722_1_kneaddata_paired	Firmicutes	12188	P	2137	20	2157	0.00261
ERR1614722_1_kneaddata_paired	Actinobacteriota	615	P	336	0	336	0.00041
ERR1614722_1_kneaddata_paired	Cyanobacteria	9876	P	56	1	57	0.00007
ERR1614722_1_kneaddata_paired	Desulfobacterota_A	11509	P	32	3	35	0.00004
ERR1614722_1_kneaddata_paired	Proteobacteria	22518	P	20	0	20	0.00002
ERR1614722_1_kneaddata_paired	Firmicutes_B	17289	P	17	0	17	0.00002
ERR1614722_1_kneaddata_paired	Verrucomicrobiota	33333	P	8	0	8	0.00001
ERR1614722_1_kneaddata_paired	Firmicutes_C	17613	P	6	0	6	0.00001
ERR1614722_1_kneaddata_paired	Spirochaetota	32587	P	1	0	1	0.00000
ERR1614724_1_kneaddata_paired	Firmicutes_A	14608	P	1487790	6880	1494670	0.61204
ERR1614724_1_kneaddata_paired	Bacteroidota	4587	P	934225	5905	940130	0.38497
ERR1614724_1_kneaddata_paired	Firmicutes	12188	P	6338	104	6442	0.00264
ERR1614724_1_kneaddata_paired	Cyanobacteria	9876	P	223	6	229	0.00009
ERR1614724_1_kneaddata_paired	Actinobacteriota	615	P	217	0	217	0.00009
ERR1614724_1_kneaddata_paired	Desulfobacterota_A	11509	P	128	16	144	0.00006
ERR1614724_1_kneaddata_paired	Firmicutes_B	17289	P	95	3	98	0.00004
ERR1614724_1_kneaddata_paired	Proteobacteria	22518	P	72	0	72	0.00003
ERR1614724_1_kneaddata_paired	Verrucomicrobiota	33333	P	31	1	32	0.00001
ERR1614724_1_kneaddata_paired	Firmicutes_C	17613	P	27	0	27	0.00001
ERR1614724_1_kneaddata_paired	Firmicutes_I	18140	P	12	0	12	0.00000
ERR1614724_1_kneaddata_paired	Deferribacterota	10822	P	11	0	11	0.00000
ERR1614724_1_kneaddata_paired	Spirochaetota	32587	P	5	0	5	0.00000
ERR1614724_1_kneaddata_paired	Campylobacterota	8700	P	4	0	4	0.00000
ERR1614724_1_kneaddata_paired	Thermotogota	33086	P	1	0	1	0.00000
ERR1614725_1_kneaddata_paired	Firmicutes_A	14608	P	1451908	6730	1458638	0.61187
ERR1614725_1_kneaddata_paired	Bacteroidota	4587	P	912434	5780	918214	0.38518
ERR1614725_1_kneaddata_paired	Firmicutes	12188	P	6106	100	6206	0.00260
ERR1614725_1_kneaddata_paired	Cyanobacteria	9876	P	218	6	224	0.00009
ERR1614725_1_kneaddata_paired	Actinobacteriota	615	P	182	0	182	0.00008
ERR1614725_1_kneaddata_paired	Desulfobacterota_A	11509	P	140	18	158	0.00007
ERR1614725_1_kneaddata_paired	Firmicutes_B	17289	P	103	3	106	0.00004
ERR1614725_1_kneaddata_paired	Proteobacteria	22518	P	51	0	51	0.00002
ERR1614725_1_kneaddata_paired	Verrucomicrobiota	33333	P	29	1	30	0.00001
ERR1614725_1_kneaddata_paired	Firmicutes_C	17613	P	26	0	26	0.00001
ERR1614725_1_kneaddata_paired	Deferribacterota	10822	P	18	0	18	0.00001
ERR1614725_1_kneaddata_paired	Firmicutes_I	18140	P	17	0	17	0.00001
ERR1614725_1_kneaddata_paired	Spirochaetota	32587	P	7	0	7	0.00000
ERR1614725_1_kneaddata_paired	Campylobacterota	8700	P	3	0	3	0.00000
ERR1614725_1_kneaddata_paired	Elusimicrobiota	11888	P	1	0	1	0.00000
ERR1614727_1_kneaddata_paired	Firmicutes_A	14608	P	1402103	6330	1408433	0.60920
ERR1614727_1_kneaddata_paired	Bacteroidota	4587	P	891361	5394	896755	0.38788
ERR1614727_1_kneaddata_paired	Firmicutes	12188	P	5867	88	5955	0.00258
ERR1614727_1_kneaddata_paired	Actinobacteriota	615	P	203	0	203	0.00009
ERR1614727_1_kneaddata_paired	Cyanobacteria	9876	P	190	5	195	0.00008
ERR1614727_1_kneaddata_paired	Firmicutes_B	17289	P	112	3	115	0.00005
ERR1614727_1_kneaddata_paired	Desulfobacterota_A	11509	P	105	13	118	0.00005
ERR1614727_1_kneaddata_paired	Proteobacteria	22518	P	66	0	66	0.00003
ERR1614727_1_kneaddata_paired	Verrucomicrobiota	33333	P	25	1	26	0.00001
ERR1614727_1_kneaddata_paired	Firmicutes_I	18140	P	18	0	18	0.00001
ERR1614727_1_kneaddata_paired	Deferribacterota	10822	P	15	0	15	0.00001
ERR1614727_1_kneaddata_paired	Firmicutes_C	17613	P	12	0	12	0.00001
ERR1614727_1_kneaddata_paired	Campylobacterota	8700	P	5	0	5	0.00000
ERR1614727_1_kneaddata_paired	Thermotogota	33086	P	2	0	2	0.00000
ERR1614727_1_kneaddata_paired	Spirochaetota	32587	P	1	0	1	0.00000
ERR1614728_1_kneaddata_paired	Bacteroidota	4587	P	1704450	9551	1714001	0.78798
ERR1614728_1_kneaddata_paired	Firmicutes_A	14608	P	444760	2297	447057	0.20553
ERR1614728_1_kneaddata_paired	Firmicutes	12188	P	13505	67	13572	0.00624
ERR1614728_1_kneaddata_paired	Actinobacteriota	615	P	251	0	251	0.00012
ERR1614728_1_kneaddata_paired	Cyanobacteria	9876	P	122	5	127	0.00006
ERR1614728_1_kneaddata_paired	Proteobacteria	22518	P	59	0	59	0.00003
ERR1614728_1_kneaddata_paired	Desulfobacterota_A	11509	P	26	1	27	0.00001
ERR1614728_1_kneaddata_paired	Firmicutes_I	18140	P	20	0	20	0.00001
ERR1614728_1_kneaddata_paired	Firmicutes_B	17289	P	17	0	17	0.00001
ERR1614728_1_kneaddata_paired	Verrucomicrobiota	33333	P	15	0	15	0.00001
ERR1614728_1_kneaddata_paired	Deferribacterota	10822	P	8	0	8	0.00000
ERR1614728_1_kneaddata_paired	Firmicutes_C	17613	P	5	0	5	0.00000
ERR1614728_1_kneaddata_paired	Campylobacterota	8700	P	4	0	4	0.00000
ERR1614728_1_kneaddata_paired	Spirochaetota	32587	P	3	0	3	0.00000
ERR1614728_1_kneaddata_paired	Elusimicrobiota	11888	P	2	0	2	0.00000
ERR1614730_1_kneaddata_paired	Bacteroidota	4587	P	1766336	9676	1776012	0.78725
ERR1614730_1_kneaddata_paired	Firmicutes_A	14608	P	462708	2342	465050	0.20614
ERR1614730_1_kneaddata_paired	Firmicutes	12188	P	14292	71	14363	0.00637
ERR1614730_1_kneaddata_paired	Actinobacteriota	615	P	234	0	234	0.00010
ERR1614730_1_kneaddata_paired	Cyanobacteria	9876	P	109	3	112	0.00005
ERR1614730_1_kneaddata_paired	Proteobacteria	22518	P	67	0	67	0.00003
ERR1614730_1_kneaddata_paired	Firmicutes_B	17289	P	32	1	33	0.00001
ERR1614730_1_kneaddata_paired	Desulfobacterota_A	11509	P	29	1	30	0.00001
ERR1614730_1_kneaddata_paired	Verrucomicrobiota	33333	P	25	1	26	0.00001
ERR1614730_1_kneaddata_paired	Firmicutes_I	18140	P	13	0	13	0.00001
ERR1614730_1_kneaddata_paired	Deferribacterota	10822	P	9	0	9	0.00000
ERR1614730_1_kneaddata_paired	Firmicutes_C	17613	P	4	0	4	0.00000
ERR1614730_1_kneaddata_paired	Campylobacterota	8700	P	3	0	3	0.00000
ERR1614730_1_kneaddata_paired	Spirochaetota	32587	P	2	0	2	0.00000
ERR1614730_1_kneaddata_paired	Elusimicrobiota	11888	P	1	0	1	0.00000
ERR1614731_1_kneaddata_paired	Bacteroidota	4587	P	1141596	5951	1147547	0.77719
ERR1614731_1_kneaddata_paired	Firmicutes_A	14608	P	317742	1574	319316	0.21626
ERR1614731_1_kneaddata_paired	Firmicutes	12188	P	9242	41	9283	0.00629
ERR1614731_1_kneaddata_paired	Actinobacteriota	615	P	212	0	212	0.00014
ERR1614731_1_kneaddata_paired	Cyanobacteria	9876	P	62	2	64	0.00004
ERR1614731_1_kneaddata_paired	Proteobacteria	22518	P	36	0	36	0.00002
ERR1614731_1_kneaddata_paired	Desulfobacterota_A	11509	P	17	1	18	0.00001
ERR1614731_1_kneaddata_paired	Firmicutes_I	18140	P	15	0	15	0.00001
ERR1614731_1_kneaddata_paired	Verrucomicrobiota	33333	P	13	0	13	0.00001
ERR1614731_1_kneaddata_paired	Firmicutes_B	17289	P	12	0	12	0.00001
ERR1614731_1_kneaddata_paired	Campylobacterota	8700	P	6	0	6	0.00000
ERR1614731_1_kneaddata_paired	Deferribacterota	10822	P	6	0	6	0.00000
ERR1614731_1_kneaddata_paired	Firmicutes_C	17613	P	3	0	3	0.00000
ERR1614731_1_kneaddata_paired	Spirochaetota	32587	P	1	0	1	0.00000
ERR1725799_1_kneaddata_paired	Bacteroidota	4587	P	1383360	11189	1394549	0.46447
ERR1725799_1_kneaddata_paired	Firmicutes_A	14608	P	1025377	12201	1037578	0.34558
ERR1725799_1_kneaddata_paired	Firmicutes	12188	P	469537	3773	473310	0.15764
ERR1725799_1_kneaddata_paired	Verrucomicrobiota	33333	P	52772	4969	57741	0.01923
ERR1725799_1_kneaddata_paired	Cyanobacteria	9876	P	12728	203	12931	0.00431
ERR1725799_1_kneaddata_paired	Desulfobacterota_A	11509	P	8414	64	8478	0.00282
ERR1725799_1_kneaddata_paired	Proteobacteria	22518	P	7513	106	7619	0.00254
ERR1725799_1_kneaddata_paired	Deferribacterota	10822	P	5568	33	5601	0.00187
ERR1725799_1_kneaddata_paired	Actinobacteriota	615	P	3697	28	3725	0.00124
ERR1725799_1_kneaddata_paired	Firmicutes_B	17289	P	340	21	361	0.00012
ERR1725799_1_kneaddata_paired	Spirochaetota	32587	P	305	0	305	0.00010
ERR1725799_1_kneaddata_paired	Campylobacterota	8700	P	154	0	154	0.00005
ERR1725799_1_kneaddata_paired	Firmicutes_I	18140	P	31	0	31	0.00001
ERR1725799_1_kneaddata_paired	Firmicutes_C	17613	P	22	0	22	0.00001
ERR1725799_1_kneaddata_paired	Thermotogota	33086	P	7	0	7	0.00000
ERR1725799_1_kneaddata_paired	Elusimicrobiota	11888	P	3	0	3	0.00000
ERR1725800_1_kneaddata_paired	Bacteroidota	4587	P	1156572	10338	1166910	0.45490
ERR1725800_1_kneaddata_paired	Firmicutes_A	14608	P	730687	8170	738857	0.28803
ERR1725800_1_kneaddata_paired	Firmicutes	12188	P	548886	4511	553397	0.21573
ERR1725800_1_kneaddata_paired	Verrucomicrobiota	33333	P	36762	3682	40444	0.01577
ERR1725800_1_kneaddata_paired	Cyanobacteria	9876	P	32067	404	32471	0.01266
ERR1725800_1_kneaddata_paired	Proteobacteria	22518	P	19374	224	19598	0.00764
ERR1725800_1_kneaddata_paired	Desulfobacterota_A	11509	P	5956	49	6005	0.00234
ERR1725800_1_kneaddata_paired	Deferribacterota	10822	P	4928	32	4960	0.00193
ERR1725800_1_kneaddata_paired	Actinobacteriota	615	P	1459	15	1474	0.00057
ERR1725800_1_kneaddata_paired	Firmicutes_B	17289	P	468	31	499	0.00019
ERR1725800_1_kneaddata_paired	Spirochaetota	32587	P	314	1	315	0.00012
ERR1725800_1_kneaddata_paired	Campylobacterota	8700	P	190	0	190	0.00007
ERR1725800_1_kneaddata_paired	Firmicutes_I	18140	P	33	0	33	0.00001
ERR1725800_1_kneaddata_paired	Firmicutes_C	17613	P	28	0	28	0.00001
ERR1725800_1_kneaddata_paired	Thermotogota	33086	P	7	0	7	0.00000
ERR1725800_1_kneaddata_paired	Elusimicrobiota	11888	P	5	0	5	0.00000
ERR1725801_1_kneaddata_paired	Bacteroidota	4587	P	2128356	18698	2147054	0.44408
ERR1725801_1_kneaddata_paired	Firmicutes_A	14608	P	1941136	18996	1960132	0.40542
ERR1725801_1_kneaddata_paired	Firmicutes	12188	P	581525	4198	585723	0.12115
ERR1725801_1_kneaddata_paired	Cyanobacteria	9876	P	52683	728	53411	0.01105
ERR1725801_1_kneaddata_paired	Verrucomicrobiota	33333	P	39212	3767	42979	0.00889
ERR1725801_1_kneaddata_paired	Proteobacteria	22518	P	31225	476	31701	0.00656
ERR1725801_1_kneaddata_paired	Desulfobacterota_A	11509	P	5500	114	5614	0.00116
ERR1725801_1_kneaddata_paired	Deferribacterota	10822	P	5047	32	5079	0.00105
ERR1725801_1_kneaddata_paired	Firmicutes_B	17289	P	1330	85	1415	0.00029
ERR1725801_1_kneaddata_paired	Actinobacteriota	615	P	1114	21	1135	0.00023
ERR1725801_1_kneaddata_paired	Spirochaetota	32587	P	341	1	342	0.00007
ERR1725801_1_kneaddata_paired	Campylobacterota	8700	P	189	0	189	0.00004
ERR1725801_1_kneaddata_paired	Firmicutes_I	18140	P	43	0	43	0.00001
ERR1725801_1_kneaddata_paired	Firmicutes_C	17613	P	37	0	37	0.00001
ERR1725801_1_kneaddata_paired	Thermotogota	33086	P	8	0	8	0.00000
ERR1725801_1_kneaddata_paired	Elusimicrobiota	11888	P	3	0	3	0.00000
ERR1725802_1_kneaddata_paired	Bacteroidota	4587	P	1643093	12391	1655484	0.45942
ERR1725802_1_kneaddata_paired	Firmicutes_A	14608	P	1457900	16078	1473978	0.40905
ERR1725802_1_kneaddata_paired	Firmicutes	12188	P	382969	2696	385665	0.10703
ERR1725802_1_kneaddata_paired	Verrucomicrobiota	33333	P	36001	3502	39503	0.01096
ERR1725802_1_kneaddata_paired	Cyanobacteria	9876	P	21022	183	21205	0.00588
ERR1725802_1_kneaddata_paired	Proteobacteria	22518	P	12680	242	12922	0.00359
ERR1725802_1_kneaddata_paired	Desulfobacterota_A	11509	P	8471	87	8558	0.00238
ERR1725802_1_kneaddata_paired	Deferribacterota	10822	P	3138	19	3157	0.00088
ERR1725802_1_kneaddata_paired	Actinobacteriota	615	P	1826	28	1854	0.00051
ERR1725802_1_kneaddata_paired	Firmicutes_B	17289	P	485	31	516	0.00014
ERR1725802_1_kneaddata_paired	Spirochaetota	32587	P	321	1	322	0.00009
ERR1725802_1_kneaddata_paired	Campylobacterota	8700	P	157	0	157	0.00004
ERR1725802_1_kneaddata_paired	Firmicutes_I	18140	P	45	0	45	0.00001
ERR1725802_1_kneaddata_paired	Firmicutes_C	17613	P	32	0	32	0.00001
ERR1725802_1_kneaddata_paired	Thermotogota	33086	P	12	0	12	0.00000
ERR1725802_1_kneaddata_paired	Elusimicrobiota	11888	P	1	0	1	0.00000
ERR1725803_1_kneaddata_paired	Bacteroidota	4587	P	4097651	29556	4127207	0.54794
ERR1725803_1_kneaddata_paired	Firmicutes_A	14608	P	2183979	22810	2206789	0.29298
ERR1725803_1_kneaddata_paired	Firmicutes	12188	P	840718	6353	847071	0.11246
ERR1725803_1_kneaddata_paired	Verrucomicrobiota	33333	P	178374	16469	194843	0.02587
ERR1725803_1_kneaddata_paired	Proteobacteria	22518	P	71604	826	72430	0.00962
ERR1725803_1_kneaddata_paired	Cyanobacteria	9876	P	48024	661	48685	0.00646
ERR1725803_1_kneaddata_paired	Desulfobacterota_A	11509	P	12928	154	13082	0.00174
ERR1725803_1_kneaddata_paired	Deferribacterota	10822	P	12844	77	12921	0.00172
ERR1725803_1_kneaddata_paired	Actinobacteriota	615	P	6365	63	6428	0.00085
ERR1725803_1_kneaddata_paired	Firmicutes_B	17289	P	1793	109	1902	0.00025
ERR1725803_1_kneaddata_paired	Spirochaetota	32587	P	465	1	466	0.00006
ERR1725803_1_kneaddata_paired	Campylobacterota	8700	P	296	0	296	0.00004
ERR1725803_1_kneaddata_paired	Firmicutes_I	18140	P	52	0	52	0.00001
ERR1725803_1_kneaddata_paired	Firmicutes_C	17613	P	48	0	48	0.00001
ERR1725803_1_kneaddata_paired	Thermotogota	33086	P	10	0	10	0.00000
ERR1725803_1_kneaddata_paired	Elusimicrobiota	11888	P	6	0	6	0.00000
ERR1725804_1_kneaddata_paired	Bacteroidota	4587	P	4553772	33814	4587586	0.60768
ERR1725804_1_kneaddata_paired	Firmicutes_A	14608	P	1767622	16282	1783904	0.23630
ERR1725804_1_kneaddata_paired	Firmicutes	12188	P	863543	10982	874525	0.11584
ERR1725804_1_kneaddata_paired	Verrucomicrobiota	33333	P	164689	11591	176280	0.02335
ERR1725804_1_kneaddata_paired	Proteobacteria	22518	P	68719	380	69099	0.00915
ERR1725804_1_kneaddata_paired	Deferribacterota	10822	P	44453	205	44658	0.00592
ERR1725804_1_kneaddata_paired	Desulfobacterota_A	11509	P	6414	109	6523	0.00086
ERR1725804_1_kneaddata_paired	Cyanobacteria	9876	P	3253	172	3425	0.00045
ERR1725804_1_kneaddata_paired	Actinobacteriota	615	P	1926	13	1939	0.00026
ERR1725804_1_kneaddata_paired	Spirochaetota	32587	P	578	2	580	0.00008
ERR1725804_1_kneaddata_paired	Firmicutes_B	17289	P	358	16	374	0.00005
ERR1725804_1_kneaddata_paired	Campylobacterota	8700	P	316	0	316	0.00004
ERR1725804_1_kneaddata_paired	Firmicutes_I	18140	P	75	0	75	0.00001
ERR1725804_1_kneaddata_paired	Firmicutes_C	17613	P	49	0	49	0.00001
ERR1725804_1_kneaddata_paired	Thermotogota	33086	P	11	0	11	0.00000
ERR1725804_1_kneaddata_paired	Elusimicrobiota	11888	P	5	0	5	0.00000
ERR1725805_1_kneaddata_paired	Firmicutes_A	14608	P	4355008	38404	4393412	0.43620
ERR1725805_1_kneaddata_paired	Bacteroidota	4587	P	3782069	16912	3798981	0.37718
ERR1725805_1_kneaddata_paired	Firmicutes	12188	P	1318184	14802	1332986	0.13234
ERR1725805_1_kneaddata_paired	Verrucomicrobiota	33333	P	362050	25213	387263	0.03845
ERR1725805_1_kneaddata_paired	Deferribacterota	10822	P	69613	318	69931	0.00694
ERR1725805_1_kneaddata_paired	Proteobacteria	22518	P	52532	263	52795	0.00524
ERR1725805_1_kneaddata_paired	Desulfobacterota_A	11509	P	28076	390	28466	0.00283
ERR1725805_1_kneaddata_paired	Cyanobacteria	9876	P	3936	148	4084	0.00041
ERR1725805_1_kneaddata_paired	Actinobacteriota	615	P	1852	16	1868	0.00019
ERR1725805_1_kneaddata_paired	Firmicutes_B	17289	P	1029	46	1075	0.00011
ERR1725805_1_kneaddata_paired	Spirochaetota	32587	P	441	1	442	0.00004
ERR1725805_1_kneaddata_paired	Campylobacterota	8700	P	417	0	417	0.00004
ERR1725805_1_kneaddata_paired	Firmicutes_C	17613	P	212	0	212	0.00002
ERR1725805_1_kneaddata_paired	Firmicutes_I	18140	P	160	0	160	0.00002
ERR1725805_1_kneaddata_paired	Thermotogota	33086	P	10	0	10	0.00000
ERR1725805_1_kneaddata_paired	Elusimicrobiota	11888	P	8	0	8	0.00000
ERR1725806_1_kneaddata_paired	Bacteroidota	4587	P	1857567	9185	1866752	0.40176
ERR1725806_1_kneaddata_paired	Firmicutes_A	14608	P	1607199	15102	1622301	0.34915
ERR1725806_1_kneaddata_paired	Firmicutes	12188	P	941938	10159	952097	0.20491
ERR1725806_1_kneaddata_paired	Verrucomicrobiota	33333	P	138769	10349	149118	0.03209
ERR1725806_1_kneaddata_paired	Proteobacteria	22518	P	25849	131	25980	0.00559
ERR1725806_1_kneaddata_paired	Deferribacterota	10822	P	19670	96	19766	0.00425
ERR1725806_1_kneaddata_paired	Desulfobacterota_A	11509	P	6605	188	6793	0.00146
ERR1725806_1_kneaddata_paired	Cyanobacteria	9876	P	1765	60	1825	0.00039
ERR1725806_1_kneaddata_paired	Actinobacteriota	615	P	778	7	785	0.00017
ERR1725806_1_kneaddata_paired	Firmicutes_B	17289	P	350	17	367	0.00008
ERR1725806_1_kneaddata_paired	Campylobacterota	8700	P	249	0	249	0.00005
ERR1725806_1_kneaddata_paired	Spirochaetota	32587	P	195	0	195	0.00004
ERR1725806_1_kneaddata_paired	Firmicutes_C	17613	P	84	0	84	0.00002
ERR1725806_1_kneaddata_paired	Firmicutes_I	18140	P	59	0	59	0.00001
ERR1725806_1_kneaddata_paired	Elusimicrobiota	11888	P	4	0	4	0.00000
ERR1725806_1_kneaddata_paired	Thermotogota	33086	P	4	0	4	0.00000
ERR1725807_1_kneaddata_paired	Bacteroidota	4587	P	3674035	28302	3702337	0.37100
ERR1725807_1_kneaddata_paired	Firmicutes_A	14608	P	3554744	47046	3601790	0.36092
ERR1725807_1_kneaddata_paired	Firmicutes	12188	P	2429557	35558	2465115	0.24702
ERR1725807_1_kneaddata_paired	Verrucomicrobiota	33333	P	76524	6732	83256	0.00834
ERR1725807_1_kneaddata_paired	Proteobacteria	22518	P	60000	428	60428	0.00606
ERR1725807_1_kneaddata_paired	Deferribacterota	10822	P	30981	178	31159	0.00312
ERR1725807_1_kneaddata_paired	Desulfobacterota_A	11509	P	12944	247	13191	0.00132
ERR1725807_1_kneaddata_paired	Cyanobacteria	9876	P	10638	176	10814	0.00108
ERR1725807_1_kneaddata_paired	Actinobacteriota	615	P	8137	63	8200	0.00082
ERR1725807_1_kneaddata_paired	Firmicutes_B	17289	P	1068	61	1129	0.00011
ERR1725807_1_kneaddata_paired	Spirochaetota	32587	P	1014	7	1021	0.00010
ERR1725807_1_kneaddata_paired	Campylobacterota	8700	P	668	1	669	0.00007
ERR1725807_1_kneaddata_paired	Firmicutes_C	17613	P	112	0	112	0.00001
ERR1725807_1_kneaddata_paired	Firmicutes_I	18140	P	110	0	110	0.00001
ERR1725807_1_kneaddata_paired	Elusimicrobiota	11888	P	10	0	10	0.00000
ERR1725807_1_kneaddata_paired	Thermotogota	33086	P	8	0	8	0.00000
ERR1725808_1_kneaddata_paired	Firmicutes_A	14608	P	1507473	14914	1522387	0.53605
ERR1725808_1_kneaddata_paired	Firmicutes	12188	P	764619	7401	772020	0.27184
ERR1725808_1_kneaddata_paired	Bacteroidota	4587	P	521816	4266	526082	0.18524
ERR1725808_1_kneaddata_paired	Desulfobacterota_A	11509	P	4429	84	4513	0.00159
ERR1725808_1_kneaddata_paired	Verrucomicrobiota	33333	P	4182	266	4448	0.00157
ERR1725808_1_kneaddata_paired	Cyanobacteria	9876	P	3890	305	4195	0.00148
ERR1725808_1_kneaddata_paired	Deferribacterota	10822	P	2637	10	2647	0.00093
ERR1725808_1_kneaddata_paired	Proteobacteria	22518	P	2489	21	2510	0.00088
ERR1725808_1_kneaddata_paired	Actinobacteriota	615	P	495	3	498	0.00018
ERR1725808_1_kneaddata_paired	Firmicutes_B	17289	P	350	14	364	0.00013
ERR1725808_1_kneaddata_paired	Campylobacterota	8700	P	147	0	147	0.00005
ERR1725808_1_kneaddata_paired	Spirochaetota	32587	P	124	0	124	0.00004
ERR1725808_1_kneaddata_paired	Firmicutes_C	17613	P	27	0	27	0.00001
ERR1725808_1_kneaddata_paired	Firmicutes_I	18140	P	19	0	19	0.00001
ERR1725808_1_kneaddata_paired	Thermotogota	33086	P	7	0	7	0.00000
ERR1725808_1_kneaddata_paired	Elusimicrobiota	11888	P	1	0	1	0.00000
ERR1725809_1_kneaddata_paired	Firmicutes_A	14608	P	91387	814	92201	0.61821
ERR1725809_1_kneaddata_paired	Bacteroidota	4587	P	42479	230	42709	0.28636
ERR1725809_1_kneaddata_paired	Firmicutes	12188	P	7252	61	7313	0.04904
ERR1725809_1_kneaddata_paired	Deferribacterota	10822	P	5285	17	5302	0.03555
ERR1725809_1_kneaddata_paired	Proteobacteria	22518	P	499	2	501	0.00336
ERR1725809_1_kneaddata_paired	Desulfobacterota_A	11509	P	496	3	499	0.00335
ERR1725809_1_kneaddata_paired	Cyanobacteria	9876	P	429	4	433	0.00291
ERR1725809_1_kneaddata_paired	Verrucomicrobiota	33333	P	118	5	123	0.00083
ERR1725809_1_kneaddata_paired	Actinobacteriota	615	P	26	0	26	0.00017
ERR1725809_1_kneaddata_paired	Firmicutes_B	17289	P	16	0	16	0.00011
ERR1725809_1_kneaddata_paired	Spirochaetota	32587	P	13	0	13	0.00009
ERR1725809_1_kneaddata_paired	Campylobacterota	8700	P	2	0	2	0.00001
ERR1725810_1_kneaddata_paired	Bacteroidota	4587	P	501409	4816	506225	0.49999
ERR1725810_1_kneaddata_paired	Firmicutes_A	14608	P	351688	4094	355782	0.35140
ERR1725810_1_kneaddata_paired	Firmicutes	12188	P	116764	1148	117912	0.11646
ERR1725810_1_kneaddata_paired	Proteobacteria	22518	P	20565	184	20749	0.02049
ERR1725810_1_kneaddata_paired	Cyanobacteria	9876	P	4763	64	4827	0.00477
ERR1725810_1_kneaddata_paired	Deferribacterota	10822	P	2638	15	2653	0.00262
ERR1725810_1_kneaddata_paired	Verrucomicrobiota	33333	P	2386	224	2610	0.00258
ERR1725810_1_kneaddata_paired	Desulfobacterota_A	11509	P	1042	20	1062	0.00105
ERR1725810_1_kneaddata_paired	Actinobacteriota	615	P	434	2	436	0.00043
ERR1725810_1_kneaddata_paired	Firmicutes_B	17289	P	66	4	70	0.00007
ERR1725810_1_kneaddata_paired	Campylobacterota	8700	P	61	0	61	0.00006
ERR1725810_1_kneaddata_paired	Spirochaetota	32587	P	51	0	51	0.00005
ERR1725810_1_kneaddata_paired	Firmicutes_I	18140	P	14	0	14	0.00001
ERR1725810_1_kneaddata_paired	Firmicutes_C	17613	P	7	0	7	0.00001
ERR1725810_1_kneaddata_paired	Thermotogota	33086	P	3	0	3	0.00000
ERR1725810_1_kneaddata_paired	Elusimicrobiota	11888	P	1	0	1	0.00000
ERR1725811_1_kneaddata_paired	Firmicutes_A	14608	P	618643	5154	623797	0.60533
ERR1725811_1_kneaddata_paired	Bacteroidota	4587	P	330245	3421	333666	0.32379
ERR1725811_1_kneaddata_paired	Deferribacterota	10822	P	32350	150	32500	0.03154
ERR1725811_1_kneaddata_paired	Firmicutes	12188	P	20363	267	20630	0.02002
ERR1725811_1_kneaddata_paired	Desulfobacterota_A	11509	P	12047	45	12092	0.01173
ERR1725811_1_kneaddata_paired	Cyanobacteria	9876	P	5955	53	6008	0.00583
ERR1725811_1_kneaddata_paired	Proteobacteria	22518	P	828	8	836	0.00081
ERR1725811_1_kneaddata_paired	Actinobacteriota	615	P	478	1	479	0.00047
ERR1725811_1_kneaddata_paired	Spirochaetota	32587	P	189	0	189	0.00018
ERR1725811_1_kneaddata_paired	Firmicutes_B	17289	P	145	6	151	0.00015
ERR1725811_1_kneaddata_paired	Verrucomicrobiota	33333	P	111	7	118	0.00012
ERR1725811_1_kneaddata_paired	Campylobacterota	8700	P	14	0	14	0.00001
ERR1725811_1_kneaddata_paired	Firmicutes_C	17613	P	10	0	10	0.00001
ERR1725811_1_kneaddata_paired	Firmicutes_I	18140	P	7	0	7	0.00001
ERR1725811_1_kneaddata_paired	Thermotogota	33086	P	6	0	6	0.00001
ERR1725811_1_kneaddata_paired	Elusimicrobiota	11888	P	2	0	2	0.00000
ERR1725812_1_kneaddata_paired	Bacteroidota	4587	P	373438	3002	376440	0.63517
ERR1725812_1_kneaddata_paired	Firmicutes_A	14608	P	173559	2095	175654	0.29638
ERR1725812_1_kneaddata_paired	Firmicutes	12188	P	29332	221	29553	0.04987
ERR1725812_1_kneaddata_paired	Desulfobacterota_A	11509	P	3175	7	3182	0.00537
ERR1725812_1_kneaddata_paired	Cyanobacteria	9876	P	3167	42	3209	0.00542
ERR1725812_1_kneaddata_paired	Proteobacteria	22518	P	2174	21	2195	0.00371
ERR1725812_1_kneaddata_paired	Deferribacterota	10822	P	1515	7	1522	0.00257
ERR1725812_1_kneaddata_paired	Verrucomicrobiota	33333	P	460	36	496	0.00084
ERR1725812_1_kneaddata_paired	Actinobacteriota	615	P	288	1	289	0.00049
ERR1725812_1_kneaddata_paired	Spirochaetota	32587	P	71	0	71	0.00012
ERR1725812_1_kneaddata_paired	Firmicutes_B	17289	P	23	1	24	0.00004
ERR1725812_1_kneaddata_paired	Campylobacterota	8700	P	14	0	14	0.00002
ERR1725812_1_kneaddata_paired	Firmicutes_I	18140	P	6	0	6	0.00001
ERR1725812_1_kneaddata_paired	Firmicutes_C	17613	P	2	0	2	0.00000
ERR1725813_1_kneaddata_paired	Bacteroidota	4587	P	832076	5969	838045	0.55769
ERR1725813_1_kneaddata_paired	Firmicutes_A	14608	P	571768	6659	578427	0.38492
ERR1725813_1_kneaddata_paired	Firmicutes	12188	P	61464	467	61931	0.04121
ERR1725813_1_kneaddata_paired	Cyanobacteria	9876	P	7997	74	8071	0.00537
ERR1725813_1_kneaddata_paired	Proteobacteria	22518	P	6227	51	6278	0.00418
ERR1725813_1_kneaddata_paired	Desulfobacterota_A	11509	P	4739	22	4761	0.00317
ERR1725813_1_kneaddata_paired	Deferribacterota	10822	P	3637	17	3654	0.00243
ERR1725813_1_kneaddata_paired	Actinobacteriota	615	P	909	2	911	0.00061
ERR1725813_1_kneaddata_paired	Verrucomicrobiota	33333	P	324	23	347	0.00023
ERR1725813_1_kneaddata_paired	Firmicutes_B	17289	P	115	5	120	0.00008
ERR1725813_1_kneaddata_paired	Spirochaetota	32587	P	96	0	96	0.00006
ERR1725813_1_kneaddata_paired	Campylobacterota	8700	P	28	0	28	0.00002
ERR1725813_1_kneaddata_paired	Firmicutes_I	18140	P	14	0	14	0.00001
ERR1725813_1_kneaddata_paired	Firmicutes_C	17613	P	10	0	10	0.00001
ERR1725813_1_kneaddata_paired	Thermotogota	33086	P	5	0	5	0.00000
ERR1725814_1_kneaddata_paired	Bacteroidota	4587	P	929971	7720	937691	0.47339
ERR1725814_1_kneaddata_paired	Firmicutes_A	14608	P	631862	6131	637993	0.32209
ERR1725814_1_kneaddata_paired	Firmicutes	12188	P	334319	2705	337024	0.17015
ERR1725814_1_kneaddata_paired	Verrucomicrobiota	33333	P	29356	2787	32143	0.01623
ERR1725814_1_kneaddata_paired	Cyanobacteria	9876	P	19888	118	20006	0.01010
ERR1725814_1_kneaddata_paired	Proteobacteria	22518	P	6384	77	6461	0.00326
ERR1725814_1_kneaddata_paired	Deferribacterota	10822	P	4102	25	4127	0.00208
ERR1725814_1_kneaddata_paired	Desulfobacterota_A	11509	P	4064	49	4113	0.00208
ERR1725814_1_kneaddata_paired	Actinobacteriota	615	P	740	4	744	0.00038
ERR1725814_1_kneaddata_paired	Firmicutes_B	17289	P	205	12	217	0.00011
ERR1725814_1_kneaddata_paired	Spirochaetota	32587	P	143	0	143	0.00007
ERR1725814_1_kneaddata_paired	Campylobacterota	8700	P	71	0	71	0.00004
ERR1725814_1_kneaddata_paired	Firmicutes_I	18140	P	19	0	19	0.00001
ERR1725814_1_kneaddata_paired	Firmicutes_C	17613	P	15	0	15	0.00001
ERR1725814_1_kneaddata_paired	Thermotogota	33086	P	9	0	9	0.00000
ERR1725814_1_kneaddata_paired	Elusimicrobiota	11888	P	3	0	3	0.00000
ERR1725815_1_kneaddata_paired	Bacteroidota	4587	P	974388	9655	984043	0.53752
ERR1725815_1_kneaddata_paired	Firmicutes_A	14608	P	575929	6345	582274	0.31806
ERR1725815_1_kneaddata_paired	Firmicutes	12188	P	227542	1851	229393	0.12530
ERR1725815_1_kneaddata_paired	Verrucomicrobiota	33333	P	11369	1269	12638	0.00690
ERR1725815_1_kneaddata_paired	Cyanobacteria	9876	P	9408	163	9571	0.00523
ERR1725815_1_kneaddata_paired	Desulfobacterota_A	11509	P	4211	54	4265	0.00233
ERR1725815_1_kneaddata_paired	Proteobacteria	22518	P	4139	66	4205	0.00230
ERR1725815_1_kneaddata_paired	Deferribacterota	10822	P	2873	21	2894	0.00158
ERR1725815_1_kneaddata_paired	Actinobacteriota	615	P	809	5	814	0.00044
ERR1725815_1_kneaddata_paired	Firmicutes_B	17289	P	347	25	372	0.00020
ERR1725815_1_kneaddata_paired	Spirochaetota	32587	P	124	0	124	0.00007
ERR1725815_1_kneaddata_paired	Campylobacterota	8700	P	67	0	67	0.00004
ERR1725815_1_kneaddata_paired	Firmicutes_C	17613	P	16	0	16	0.00001
ERR1725815_1_kneaddata_paired	Firmicutes_I	18140	P	15	0	15	0.00001
ERR1725815_1_kneaddata_paired	Elusimicrobiota	11888	P	3	0	3	0.00000
ERR1725815_1_kneaddata_paired	Thermotogota	33086	P	1	0	1	0.00000
ERR1725816_1_kneaddata_paired	Bacteroidota	4587	P	1508646	12667	1521313	0.54129
ERR1725816_1_kneaddata_paired	Firmicutes_A	14608	P	1045401	10744	1056145	0.37578
ERR1725816_1_kneaddata_paired	Firmicutes	12188	P	159902	1290	161192	0.05735
ERR1725816_1_kneaddata_paired	Verrucomicrobiota	33333	P	24874	2363	27237	0.00969
ERR1725816_1_kneaddata_paired	Cyanobacteria	9876	P	24482	370	24852	0.00884
ERR1725816_1_kneaddata_paired	Deferribacterota	10822	P	10715	67	10782	0.00384
ERR1725816_1_kneaddata_paired	Proteobacteria	22518	P	5309	69	5378	0.00191
ERR1725816_1_kneaddata_paired	Desulfobacterota_A	11509	P	2228	38	2266	0.00081
ERR1725816_1_kneaddata_paired	Actinobacteriota	615	P	614	3	617	0.00022
ERR1725816_1_kneaddata_paired	Firmicutes_B	17289	P	435	27	462	0.00016
ERR1725816_1_kneaddata_paired	Spirochaetota	32587	P	127	0	127	0.00005
ERR1725816_1_kneaddata_paired	Campylobacterota	8700	P	93	0	93	0.00003
ERR1725816_1_kneaddata_paired	Firmicutes_I	18140	P	29	0	29	0.00001
ERR1725816_1_kneaddata_paired	Firmicutes_C	17613	P	25	0	25	0.00001
ERR1725816_1_kneaddata_paired	Thermotogota	33086	P	10	0	10	0.00000
ERR1725816_1_kneaddata_paired	Elusimicrobiota	11888	P	5	0	5	0.00000
ERR1725817_1_kneaddata_paired	Bacteroidota	4587	P	1342230	10805	1353035	0.47125
ERR1725817_1_kneaddata_paired	Firmicutes_A	14608	P	987799	9390	997189	0.34731
ERR1725817_1_kneaddata_paired	Firmicutes	12188	P	434753	2904	437657	0.15243
ERR1725817_1_kneaddata_paired	Verrucomicrobiota	33333	P	49393	4737	54130	0.01885
ERR1725817_1_kneaddata_paired	Cyanobacteria	9876	P	9801	199	10000	0.00348
ERR1725817_1_kneaddata_paired	Desulfobacterota_A	11509	P	6910	73	6983	0.00243
ERR1725817_1_kneaddata_paired	Proteobacteria	22518	P	6667	87	6754	0.00235
ERR1725817_1_kneaddata_paired	Deferribacterota	10822	P	3592	22	3614	0.00126
ERR1725817_1_kneaddata_paired	Actinobacteriota	615	P	970	5	975	0.00034
ERR1725817_1_kneaddata_paired	Firmicutes_B	17289	P	407	25	432	0.00015
ERR1725817_1_kneaddata_paired	Spirochaetota	32587	P	234	0	234	0.00008
ERR1725817_1_kneaddata_paired	Campylobacterota	8700	P	101	0	101	0.00004
ERR1725817_1_kneaddata_paired	Firmicutes_C	17613	P	25	0	25	0.00001
ERR1725817_1_kneaddata_paired	Firmicutes_I	18140	P	23	0	23	0.00001
ERR1725817_1_kneaddata_paired	Thermotogota	33086	P	4	0	4	0.00000
ERR1725818_1_kneaddata_paired	Firmicutes_A	14608	P	3066231	23733	3089964	0.48780
ERR1725818_1_kneaddata_paired	Bacteroidota	4587	P	2925417	27093	2952510	0.46610
ERR1725818_1_kneaddata_paired	Firmicutes	12188	P	222363	2334	224697	0.03547
ERR1725818_1_kneaddata_paired	Cyanobacteria	9876	P	30696	410	31106	0.00491
ERR1725818_1_kneaddata_paired	Proteobacteria	22518	P	18689	193	18882	0.00298
ERR1725818_1_kneaddata_paired	Desulfobacterota_A	11509	P	6408	170	6578	0.00104
ERR1725818_1_kneaddata_paired	Deferribacterota	10822	P	5205	28	5233	0.00083
ERR1725818_1_kneaddata_paired	Verrucomicrobiota	33333	P	2586	213	2799	0.00044
ERR1725818_1_kneaddata_paired	Actinobacteriota	615	P	1318	6	1324	0.00021
ERR1725818_1_kneaddata_paired	Firmicutes_B	17289	P	751	41	792	0.00013
ERR1725818_1_kneaddata_paired	Spirochaetota	32587	P	278	0	278	0.00004
ERR1725818_1_kneaddata_paired	Campylobacterota	8700	P	170	0	170	0.00003
ERR1725818_1_kneaddata_paired	Firmicutes_I	18140	P	67	0	67	0.00001
ERR1725818_1_kneaddata_paired	Firmicutes_C	17613	P	37	0	37	0.00001
ERR1725818_1_kneaddata_paired	Thermotogota	33086	P	7	0	7	0.00000
ERR1725818_1_kneaddata_paired	Elusimicrobiota	11888	P	5	0	5	0.00000
ERR1725819_1_kneaddata_paired	Bacteroidota	4587	P	696599	6057	702656	0.40449
ERR1725819_1_kneaddata_paired	Firmicutes	12188	P	591227	7216	598443	0.34450
ERR1725819_1_kneaddata_paired	Firmicutes_A	14608	P	420096	4547	424643	0.24445
ERR1725819_1_kneaddata_paired	Verrucomicrobiota	33333	P	3320	254	3574	0.00206
ERR1725819_1_kneaddata_paired	Deferribacterota	10822	P	2751	13	2764	0.00159
ERR1725819_1_kneaddata_paired	Proteobacteria	22518	P	1896	10	1906	0.00110
ERR1725819_1_kneaddata_paired	Desulfobacterota_A	11509	P	1410	47	1457	0.00084
ERR1725819_1_kneaddata_paired	Cyanobacteria	9876	P	828	54	882	0.00051
ERR1725819_1_kneaddata_paired	Actinobacteriota	615	P	518	4	522	0.00030
ERR1725819_1_kneaddata_paired	Campylobacterota	8700	P	94	0	94	0.00005
ERR1725819_1_kneaddata_paired	Spirochaetota	32587	P	91	0	91	0.00005
ERR1725819_1_kneaddata_paired	Firmicutes_B	17289	P	66	3	69	0.00004
ERR1725819_1_kneaddata_paired	Firmicutes_I	18140	P	20	0	20	0.00001
ERR1725819_1_kneaddata_paired	Firmicutes_C	17613	P	14	0	14	0.00001
ERR1725819_1_kneaddata_paired	Thermotogota	33086	P	3	0	3	0.00000
ERR1725820_1_kneaddata_paired	Firmicutes_A	14608	P	655441	5548	660989	0.36194
ERR1725820_1_kneaddata_paired	Firmicutes	12188	P	602826	6898	609724	0.33387
ERR1725820_1_kneaddata_paired	Bacteroidota	4587	P	521218	4965	526183	0.28812
ERR1725820_1_kneaddata_paired	Verrucomicrobiota	33333	P	16543	1226	17769	0.00973
ERR1725820_1_kneaddata_paired	Deferribacterota	10822	P	4226	20	4246	0.00233
ERR1725820_1_kneaddata_paired	Desulfobacterota_A	11509	P	3257	59	3316	0.00182
ERR1725820_1_kneaddata_paired	Cyanobacteria	9876	P	1609	120	1729	0.00095
ERR1725820_1_kneaddata_paired	Proteobacteria	22518	P	1197	11	1208	0.00066
ERR1725820_1_kneaddata_paired	Actinobacteriota	615	P	594	3	597	0.00033
ERR1725820_1_kneaddata_paired	Firmicutes_B	17289	P	210	10	220	0.00012
ERR1725820_1_kneaddata_paired	Campylobacterota	8700	P	128	0	128	0.00007
ERR1725820_1_kneaddata_paired	Spirochaetota	32587	P	54	0	54	0.00003
ERR1725820_1_kneaddata_paired	Firmicutes_C	17613	P	44	0	44	0.00002
ERR1725820_1_kneaddata_paired	Firmicutes_I	18140	P	34	0	34	0.00002
ERR1725820_1_kneaddata_paired	Elusimicrobiota	11888	P	4	0	4	0.00000
ERR1725820_1_kneaddata_paired	Thermotogota	33086	P	3	0	3	0.00000
ERR1725821_1_kneaddata_paired	Bacteroidota	4587	P	857431	5679	863110	0.47472
ERR1725821_1_kneaddata_paired	Firmicutes_A	14608	P	480746	4175	484921	0.26671
ERR1725821_1_kneaddata_paired	Firmicutes	12188	P	395428	3513	398941	0.21942
ERR1725821_1_kneaddata_paired	Verrucomicrobiota	33333	P	40555	2233	42788	0.02353
ERR1725821_1_kneaddata_paired	Deferribacterota	10822	P	15124	55	15179	0.00835
ERR1725821_1_kneaddata_paired	Proteobacteria	22518	P	10324	43	10367	0.00570
ERR1725821_1_kneaddata_paired	Desulfobacterota_A	11509	P	1419	36	1455	0.00080
ERR1725821_1_kneaddata_paired	Cyanobacteria	9876	P	716	28	744	0.00041
ERR1725821_1_kneaddata_paired	Actinobacteriota	615	P	341	1	342	0.00019
ERR1725821_1_kneaddata_paired	Firmicutes_B	17289	P	130	4	134	0.00007
ERR1725821_1_kneaddata_paired	Campylobacterota	8700	P	69	0	69	0.00004
ERR1725821_1_kneaddata_paired	Spirochaetota	32587	P	42	0	42	0.00002
ERR1725821_1_kneaddata_paired	Firmicutes_C	17613	P	18	0	18	0.00001
ERR1725821_1_kneaddata_paired	Firmicutes_I	18140	P	12	0	12	0.00001
ERR1725821_1_kneaddata_paired	Elusimicrobiota	11888	P	1	0	1	0.00000
ERR1725822_1_kneaddata_paired	Firmicutes_A	14608	P	1183061	10280	1193341	0.38004
ERR1725822_1_kneaddata_paired	Bacteroidota	4587	P	1019617	6658	1026275	0.32684
ERR1725822_1_kneaddata_paired	Firmicutes	12188	P	804429	7812	812241	0.25867
ERR1725822_1_kneaddata_paired	Verrucomicrobiota	33333	P	78699	4531	83230	0.02651
ERR1725822_1_kneaddata_paired	Deferribacterota	10822	P	9771	37	9808	0.00312
ERR1725822_1_kneaddata_paired	Proteobacteria	22518	P	7938	37	7975	0.00254
ERR1725822_1_kneaddata_paired	Desulfobacterota_A	11509	P	4412	90	4502	0.00143
ERR1725822_1_kneaddata_paired	Cyanobacteria	9876	P	1237	45	1282	0.00041
ERR1725822_1_kneaddata_paired	Actinobacteriota	615	P	800	4	804	0.00026
ERR1725822_1_kneaddata_paired	Firmicutes_B	17289	P	278	10	288	0.00009
ERR1725822_1_kneaddata_paired	Campylobacterota	8700	P	105	0	105	0.00003
ERR1725822_1_kneaddata_paired	Spirochaetota	32587	P	78	0	78	0.00002
ERR1725822_1_kneaddata_paired	Firmicutes_I	18140	P	50	0	50	0.00002
ERR1725822_1_kneaddata_paired	Firmicutes_C	17613	P	48	0	48	0.00002
ERR1725822_1_kneaddata_paired	Thermotogota	33086	P	5	0	5	0.00000
ERR1725823_1_kneaddata_paired	Firmicutes_A	14608	P	970246	8016	978262	0.47910
ERR1725823_1_kneaddata_paired	Bacteroidota	4587	P	687619	5336	692955	0.33937
ERR1725823_1_kneaddata_paired	Firmicutes	12188	P	331203	3990	335193	0.16416
ERR1725823_1_kneaddata_paired	Verrucomicrobiota	33333	P	19314	1189	20503	0.01004
ERR1725823_1_kneaddata_paired	Deferribacterota	10822	P	7537	30	7567	0.00371
ERR1725823_1_kneaddata_paired	Proteobacteria	22518	P	3061	23	3084	0.00151
ERR1725823_1_kneaddata_paired	Desulfobacterota_A	11509	P	2020	62	2082	0.00102
ERR1725823_1_kneaddata_paired	Cyanobacteria	9876	P	1133	61	1194	0.00058
ERR1725823_1_kneaddata_paired	Actinobacteriota	615	P	531	5	536	0.00026
ERR1725823_1_kneaddata_paired	Firmicutes_B	17289	P	256	10	266	0.00013
ERR1725823_1_kneaddata_paired	Spirochaetota	32587	P	78	0	78	0.00004
ERR1725823_1_kneaddata_paired	Campylobacterota	8700	P	70	0	70	0.00003
ERR1725823_1_kneaddata_paired	Firmicutes_C	17613	P	52	0	52	0.00003
ERR1725823_1_kneaddata_paired	Firmicutes_I	18140	P	34	0	34	0.00002
ERR1725823_1_kneaddata_paired	Thermotogota	33086	P	3	0	3	0.00000
ERR1725824_1_kneaddata_paired	Bacteroidota	4587	P	109508	1133	110641	0.49603
ERR1725824_1_kneaddata_paired	Firmicutes_A	14608	P	91562	703	92265	0.41365
ERR1725824_1_kneaddata_paired	Firmicutes	12188	P	15429	130	15559	0.06976
ERR1725824_1_kneaddata_paired	Desulfobacterota_A	11509	P	1651	15	1666	0.00747
ERR1725824_1_kneaddata_paired	Deferribacterota	10822	P	1484	7	1491	0.00668
ERR1725824_1_kneaddata_paired	Verrucomicrobiota	33333	P	633	44	677	0.00304
ERR1725824_1_kneaddata_paired	Proteobacteria	22518	P	500	2	502	0.00225
ERR1725824_1_kneaddata_paired	Cyanobacteria	9876	P	162	10	172	0.00077
ERR1725824_1_kneaddata_paired	Firmicutes_B	17289	P	30	1	31	0.00014
ERR1725824_1_kneaddata_paired	Actinobacteriota	615	P	16	0	16	0.00007
ERR1725824_1_kneaddata_paired	Spirochaetota	32587	P	12	0	12	0.00005
ERR1725824_1_kneaddata_paired	Campylobacterota	8700	P	11	0	11	0.00005
ERR1725824_1_kneaddata_paired	Firmicutes_C	17613	P	7	0	7	0.00003
ERR1725825_1_kneaddata_paired	Firmicutes_A	14608	P	154138	1289	155427	0.60042
ERR1725825_1_kneaddata_paired	Bacteroidota	4587	P	81426	704	82130	0.31727
ERR1725825_1_kneaddata_paired	Firmicutes	12188	P	16454	207	16661	0.06436
ERR1725825_1_kneaddata_paired	Desulfobacterota_A	11509	P	1387	25	1412	0.00546
ERR1725825_1_kneaddata_paired	Verrucomicrobiota	33333	P	1321	110	1431	0.00553
ERR1725825_1_kneaddata_paired	Cyanobacteria	9876	P	726	45	771	0.00298
ERR1725825_1_kneaddata_paired	Deferribacterota	10822	P	606	3	609	0.00235
ERR1725825_1_kneaddata_paired	Proteobacteria	22518	P	284	2	286	0.00111
ERR1725825_1_kneaddata_paired	Firmicutes_B	17289	P	50	2	52	0.00020
ERR1725825_1_kneaddata_paired	Actinobacteriota	615	P	35	0	35	0.00014
ERR1725825_1_kneaddata_paired	Spirochaetota	32587	P	18	0	18	0.00007
ERR1725825_1_kneaddata_paired	Firmicutes_C	17613	P	11	0	11	0.00004
ERR1725825_1_kneaddata_paired	Campylobacterota	8700	P	10	0	10	0.00004
ERR1725825_1_kneaddata_paired	Firmicutes_I	18140	P	5	0	5	0.00002
ERR1725825_1_kneaddata_paired	Thermotogota	33086	P	1	0	1	0.00000
ERR1725826_1_kneaddata_paired	Firmicutes_A	14608	P	223903	1939	225842	0.68893
ERR1725826_1_kneaddata_paired	Bacteroidota	4587	P	70264	569	70833	0.21608
ERR1725826_1_kneaddata_paired	Firmicutes	12188	P	21795	234	22029	0.06720
ERR1725826_1_kneaddata_paired	Cyanobacteria	9876	P	4127	30	4157	0.01268
ERR1725826_1_kneaddata_paired	Desulfobacterota_A	11509	P	2117	28	2145	0.00654
ERR1725826_1_kneaddata_paired	Deferribacterota	10822	P	1422	6	1428	0.00436
ERR1725826_1_kneaddata_paired	Proteobacteria	22518	P	1089	5	1094	0.00334
ERR1725826_1_kneaddata_paired	Actinobacteriota	615	P	117	0	117	0.00036
ERR1725826_1_kneaddata_paired	Verrucomicrobiota	33333	P	77	5	82	0.00025
ERR1725826_1_kneaddata_paired	Firmicutes_B	17289	P	38	1	39	0.00012
ERR1725826_1_kneaddata_paired	Spirochaetota	32587	P	21	0	21	0.00006
ERR1725826_1_kneaddata_paired	Campylobacterota	8700	P	8	0	8	0.00002
ERR1725826_1_kneaddata_paired	Firmicutes_C	17613	P	8	0	8	0.00002
ERR1725826_1_kneaddata_paired	Firmicutes_I	18140	P	5	0	5	0.00002
ERR1725826_1_kneaddata_paired	Elusimicrobiota	11888	P	1	0	1	0.00000
ERR1725827_1_kneaddata_paired	Firmicutes_A	14608	P	22241	203	22444	0.52164
ERR1725827_1_kneaddata_paired	Bacteroidota	4587	P	14331	114	14445	0.33573
ERR1725827_1_kneaddata_paired	Firmicutes	12188	P	5341	45	5386	0.12518
ERR1725827_1_kneaddata_paired	Verrucomicrobiota	33333	P	244	17	261	0.00608
ERR1725827_1_kneaddata_paired	Desulfobacterota_A	11509	P	192	1	193	0.00449
ERR1725827_1_kneaddata_paired	Proteobacteria	22518	P	153	1	154	0.00359
ERR1725827_1_kneaddata_paired	Cyanobacteria	9876	P	85	3	88	0.00205
ERR1725827_1_kneaddata_paired	Deferribacterota	10822	P	21	0	21	0.00049
ERR1725827_1_kneaddata_paired	Firmicutes_B	17289	P	14	0	14	0.00034
ERR1725827_1_kneaddata_paired	Actinobacteriota	615	P	11	0	11	0.00026
ERR1725827_1_kneaddata_paired	Campylobacterota	8700	P	2	0	2	0.00005
ERR1725827_1_kneaddata_paired	Firmicutes_C	17613	P	2	0	2	0.00005
ERR1725827_1_kneaddata_paired	Spirochaetota	32587	P	2	0	2	0.00005
ERR1725828_1_kneaddata_paired	Firmicutes_A	14608	P	333068	2471	335539	0.62678
ERR1725828_1_kneaddata_paired	Bacteroidota	4587	P	124226	773	124999	0.23349
ERR1725828_1_kneaddata_paired	Firmicutes	12188	P	51931	579	52510	0.09809
ERR1725828_1_kneaddata_paired	Verrucomicrobiota	33333	P	11848	954	12802	0.02391
ERR1725828_1_kneaddata_paired	Deferribacterota	10822	P	3776	19	3795	0.00709
ERR1725828_1_kneaddata_paired	Desulfobacterota_A	11509	P	3008	46	3054	0.00571
ERR1725828_1_kneaddata_paired	Cyanobacteria	9876	P	1399	27	1426	0.00267
ERR1725828_1_kneaddata_paired	Proteobacteria	22518	P	924	8	932	0.00174
ERR1725828_1_kneaddata_paired	Actinobacteriota	615	P	88	0	88	0.00017
ERR1725828_1_kneaddata_paired	Firmicutes_B	17289	P	85	4	89	0.00017
ERR1725828_1_kneaddata_paired	Spirochaetota	32587	P	44	0	44	0.00008
ERR1725828_1_kneaddata_paired	Campylobacterota	8700	P	33	0	33	0.00006
ERR1725828_1_kneaddata_paired	Firmicutes_C	17613	P	16	0	16	0.00003
ERR1725828_1_kneaddata_paired	Firmicutes_I	18140	P	6	0	6	0.00001
ERR1725828_1_kneaddata_paired	Thermotogota	33086	P	3	0	3	0.00001
ERR1725829_1_kneaddata_paired	Firmicutes_A	14608	P	1801564	14888	1816452	0.48146
ERR1725829_1_kneaddata_paired	Bacteroidota	4587	P	1502298	13558	1515856	0.40179
ERR1725829_1_kneaddata_paired	Firmicutes	12188	P	380283	3305	383588	0.10167
ERR1725829_1_kneaddata_paired	Cyanobacteria	9876	P	19068	267	19335	0.00513
ERR1725829_1_kneaddata_paired	Verrucomicrobiota	33333	P	10951	1034	11985	0.00318
ERR1725829_1_kneaddata_paired	Proteobacteria	22518	P	10095	129	10224	0.00271
ERR1725829_1_kneaddata_paired	Deferribacterota	10822	P	8452	52	8504	0.00225
ERR1725829_1_kneaddata_paired	Desulfobacterota_A	11509	P	4949	105	5054	0.00134
ERR1725829_1_kneaddata_paired	Actinobacteriota	615	P	741	3	744	0.00020
ERR1725829_1_kneaddata_paired	Firmicutes_B	17289	P	619	38	657	0.00017
ERR1725829_1_kneaddata_paired	Spirochaetota	32587	P	196	0	196	0.00005
ERR1725829_1_kneaddata_paired	Campylobacterota	8700	P	104	0	104	0.00003
ERR1725829_1_kneaddata_paired	Firmicutes_C	17613	P	32	0	32	0.00001
ERR1725829_1_kneaddata_paired	Firmicutes_I	18140	P	32	0	32	0.00001
ERR1725829_1_kneaddata_paired	Thermotogota	33086	P	9	0	9	0.00000
ERR1725829_1_kneaddata_paired	Elusimicrobiota	11888	P	4	0	4	0.00000
ERR1725830_1_kneaddata_paired	Bacteroidota	4587	P	1585538	12802	1598340	0.45582
ERR1725830_1_kneaddata_paired	Firmicutes_A	14608	P	1436320	12195	1448515	0.41309
ERR1725830_1_kneaddata_paired	Firmicutes	12188	P	323617	2607	326224	0.09303
ERR1725830_1_kneaddata_paired	Verrucomicrobiota	33333	P	74107	6437	80544	0.02297
ERR1725830_1_kneaddata_paired	Cyanobacteria	9876	P	20920	239	21159	0.00603
ERR1725830_1_kneaddata_paired	Proteobacteria	22518	P	15014	170	15184	0.00433
ERR1725830_1_kneaddata_paired	Desulfobacterota_A	11509	P	8959	105	9064	0.00258
ERR1725830_1_kneaddata_paired	Deferribacterota	10822	P	4649	26	4675	0.00133
ERR1725830_1_kneaddata_paired	Actinobacteriota	615	P	1829	12	1841	0.00053
ERR1725830_1_kneaddata_paired	Firmicutes_B	17289	P	472	27	499	0.00014
ERR1725830_1_kneaddata_paired	Spirochaetota	32587	P	300	0	300	0.00009
ERR1725830_1_kneaddata_paired	Campylobacterota	8700	P	139	0	139	0.00004
ERR1725830_1_kneaddata_paired	Firmicutes_C	17613	P	26	0	26	0.00001
ERR1725830_1_kneaddata_paired	Firmicutes_I	18140	P	21	0	21	0.00001
ERR1725830_1_kneaddata_paired	Thermotogota	33086	P	12	0	12	0.00000
ERR1725830_1_kneaddata_paired	Elusimicrobiota	11888	P	2	0	2	0.00000
ERR1725831_1_kneaddata_paired	Bacteroidota	4587	P	1848402	16446	1864848	0.57381
ERR1725831_1_kneaddata_paired	Firmicutes_A	14608	P	965154	10416	975570	0.30018
ERR1725831_1_kneaddata_paired	Firmicutes	12188	P	298062	2276	300338	0.09241
ERR1725831_1_kneaddata_paired	Verrucomicrobiota	33333	P	64864	6228	71092	0.02188
ERR1725831_1_kneaddata_paired	Proteobacteria	22518	P	12428	196	12624	0.00388
ERR1725831_1_kneaddata_paired	Cyanobacteria	9876	P	10602	214	10816	0.00333
ERR1725831_1_kneaddata_paired	Desulfobacterota_A	11509	P	9082	70	9152	0.00282
ERR1725831_1_kneaddata_paired	Deferribacterota	10822	P	2334	14	2348	0.00072
ERR1725831_1_kneaddata_paired	Actinobacteriota	615	P	2220	15	2235	0.00069
ERR1725831_1_kneaddata_paired	Firmicutes_B	17289	P	440	27	467	0.00014
ERR1725831_1_kneaddata_paired	Spirochaetota	32587	P	271	0	271	0.00008
ERR1725831_1_kneaddata_paired	Campylobacterota	8700	P	129	0	129	0.00004
ERR1725831_1_kneaddata_paired	Firmicutes_C	17613	P	19	0	19	0.00001
ERR1725831_1_kneaddata_paired	Firmicutes_I	18140	P	19	0	19	0.00001
ERR1725831_1_kneaddata_paired	Thermotogota	33086	P	8	0	8	0.00000
ERR1725831_1_kneaddata_paired	Elusimicrobiota	11888	P	4	0	4	0.00000
ERR1725832_1_kneaddata_paired	Bacteroidota	4587	P	2124553	18922	2143475	0.51458
ERR1725832_1_kneaddata_paired	Firmicutes_A	14608	P	1382346	14984	1397330	0.33545
ERR1725832_1_kneaddata_paired	Firmicutes	12188	P	507244	3440	510684	0.12260
ERR1725832_1_kneaddata_paired	Verrucomicrobiota	33333	P	33048	3447	36495	0.00876
ERR1725832_1_kneaddata_paired	Proteobacteria	22518	P	32621	422	33043	0.00793
ERR1725832_1_kneaddata_paired	Cyanobacteria	9876	P	25505	307	25812	0.00620
ERR1725832_1_kneaddata_paired	Deferribacterota	10822	P	10012	69	10081	0.00242
ERR1725832_1_kneaddata_paired	Desulfobacterota_A	11509	P	5742	89	5831	0.00140
ERR1725832_1_kneaddata_paired	Firmicutes_B	17289	P	1262	86	1348	0.00032
ERR1725832_1_kneaddata_paired	Actinobacteriota	615	P	782	4	786	0.00019
ERR1725832_1_kneaddata_paired	Spirochaetota	32587	P	279	1	280	0.00007
ERR1725832_1_kneaddata_paired	Campylobacterota	8700	P	224	0	224	0.00005
ERR1725832_1_kneaddata_paired	Firmicutes_I	18140	P	63	0	63	0.00002
ERR1725832_1_kneaddata_paired	Firmicutes_C	17613	P	35	0	35	0.00001
ERR1725832_1_kneaddata_paired	Thermotogota	33086	P	11	0	11	0.00000
ERR1725832_1_kneaddata_paired	Elusimicrobiota	11888	P	5	0	5	0.00000
ERR1725833_1_kneaddata_paired	Bacteroidota	4587	P	2452439	16979	2469418	0.44606
ERR1725833_1_kneaddata_paired	Firmicutes_A	14608	P	1809421	17646	1827067	0.33003
ERR1725833_1_kneaddata_paired	Firmicutes	12188	P	955275	6402	961677	0.17371
ERR1725833_1_kneaddata_paired	Verrucomicrobiota	33333	P	176044	14901	190945	0.03449
ERR1725833_1_kneaddata_paired	Proteobacteria	22518	P	36960	371	37331	0.00674
ERR1725833_1_kneaddata_paired	Cyanobacteria	9876	P	25742	359	26101	0.00471
ERR1725833_1_kneaddata_paired	Desulfobacterota_A	11509	P	10777	79	10856	0.00196
ERR1725833_1_kneaddata_paired	Actinobacteriota	615	P	6030	32	6062	0.00110
ERR1725833_1_kneaddata_paired	Deferribacterota	10822	P	4915	27	4942	0.00089
ERR1725833_1_kneaddata_paired	Firmicutes_B	17289	P	903	50	953	0.00017
ERR1725833_1_kneaddata_paired	Spirochaetota	32587	P	395	1	396	0.00007
ERR1725833_1_kneaddata_paired	Campylobacterota	8700	P	249	0	249	0.00005
ERR1725833_1_kneaddata_paired	Firmicutes_I	18140	P	56	0	56	0.00001
ERR1725833_1_kneaddata_paired	Firmicutes_C	17613	P	30	0	30	0.00001
ERR1725833_1_kneaddata_paired	Thermotogota	33086	P	9	0	9	0.00000
ERR1725833_1_kneaddata_paired	Elusimicrobiota	11888	P	8	0	8	0.00000
ERR1725834_1_kneaddata_paired	Bacteroidota	4587	P	3621594	22536	3644130	0.65061
ERR1725834_1_kneaddata_paired	Firmicutes_A	14608	P	1184551	12922	1197473	0.21379
ERR1725834_1_kneaddata_paired	Firmicutes	12188	P	448390	2709	451099	0.08054
ERR1725834_1_kneaddata_paired	Verrucomicrobiota	33333	P	222684	16157	238841	0.04264
ERR1725834_1_kneaddata_paired	Proteobacteria	22518	P	29387	223	29610	0.00529
ERR1725834_1_kneaddata_paired	Desulfobacterota_A	11509	P	21829	46	21875	0.00391
ERR1725834_1_kneaddata_paired	Actinobacteriota	615	P	7119	93	7212	0.00129
ERR1725834_1_kneaddata_paired	Cyanobacteria	9876	P	7004	124	7128	0.00127
ERR1725834_1_kneaddata_paired	Deferribacterota	10822	P	2804	13	2817	0.00050
ERR1725834_1_kneaddata_paired	Firmicutes_B	17289	P	363	17	380	0.00007
ERR1725834_1_kneaddata_paired	Spirochaetota	32587	P	349	0	349	0.00006
ERR1725834_1_kneaddata_paired	Campylobacterota	8700	P	118	0	118	0.00002
ERR1725834_1_kneaddata_paired	Firmicutes_I	18140	P	32	0	32	0.00001
ERR1725834_1_kneaddata_paired	Firmicutes_C	17613	P	28	0	28	0.00001
ERR1725834_1_kneaddata_paired	Thermotogota	33086	P	7	0	7	0.00000
ERR1725834_1_kneaddata_paired	Elusimicrobiota	11888	P	4	0	4	0.00000
ERR1725835_1_kneaddata_paired	Bacteroidota	4587	P	954632	6898	961530	0.59102
ERR1725835_1_kneaddata_paired	Firmicutes_A	14608	P	368766	3563	372329	0.22886
ERR1725835_1_kneaddata_paired	Firmicutes	12188	P	225447	1784	227231	0.13967
ERR1725835_1_kneaddata_paired	Verrucomicrobiota	33333	P	46332	4083	50415	0.03099
ERR1725835_1_kneaddata_paired	Proteobacteria	22518	P	6828	63	6891	0.00424
ERR1725835_1_kneaddata_paired	Desulfobacterota_A	11509	P	3323	22	3345	0.00206
ERR1725835_1_kneaddata_paired	Cyanobacteria	9876	P	2186	52	2238	0.00138
ERR1725835_1_kneaddata_paired	Deferribacterota	10822	P	1371	7	1378	0.00085
ERR1725835_1_kneaddata_paired	Actinobacteriota	615	P	1131	16	1147	0.00071
ERR1725835_1_kneaddata_paired	Firmicutes_B	17289	P	239	13	252	0.00016
ERR1725835_1_kneaddata_paired	Spirochaetota	32587	P	76	0	76	0.00005
ERR1725835_1_kneaddata_paired	Campylobacterota	8700	P	51	0	51	0.00003
ERR1725835_1_kneaddata_paired	Firmicutes_C	17613	P	12	0	12	0.00001
ERR1725835_1_kneaddata_paired	Firmicutes_I	18140	P	8	0	8	0.00000
ERR1725835_1_kneaddata_paired	Thermotogota	33086	P	3	0	3	0.00000
ERR1725836_1_kneaddata_paired	Bacteroidota	4587	P	3869887	30308	3900195	0.59794
ERR1725836_1_kneaddata_paired	Firmicutes_A	14608	P	1510895	17831	1528726	0.23437
ERR1725836_1_kneaddata_paired	Firmicutes	12188	P	835482	8217	843699	0.12935
ERR1725836_1_kneaddata_paired	Verrucomicrobiota	33333	P	108301	10311	118612	0.01818
ERR1725836_1_kneaddata_paired	Proteobacteria	22518	P	75440	886	76326	0.01170
ERR1725836_1_kneaddata_paired	Cyanobacteria	9876	P	31608	608	32216	0.00494
ERR1725836_1_kneaddata_paired	Deferribacterota	10822	P	8572	53	8625	0.00132
ERR1725836_1_kneaddata_paired	Desulfobacterota_A	11509	P	5987	82	6069	0.00093
ERR1725836_1_kneaddata_paired	Actinobacteriota	615	P	4651	29	4680	0.00072
ERR1725836_1_kneaddata_paired	Firmicutes_B	17289	P	2315	144	2459	0.00038
ERR1725836_1_kneaddata_paired	Campylobacterota	8700	P	741	0	741	0.00011
ERR1725836_1_kneaddata_paired	Spirochaetota	32587	P	228	0	228	0.00004
ERR1725836_1_kneaddata_paired	Firmicutes_I	18140	P	126	0	126	0.00002
ERR1725836_1_kneaddata_paired	Firmicutes_C	17613	P	32	0	32	0.00000
ERR1725836_1_kneaddata_paired	Thermotogota	33086	P	8	0	8	0.00000
ERR1725836_1_kneaddata_paired	Elusimicrobiota	11888	P	2	0	2	0.00000
ERR1725837_1_kneaddata_paired	Bacteroidota	4587	P	4844353	38257	4882610	0.56367
ERR1725837_1_kneaddata_paired	Firmicutes_A	14608	P	2277550	29682	2307232	0.26636
ERR1725837_1_kneaddata_paired	Firmicutes	12188	P	1298656	9369	1308025	0.15100
ERR1725837_1_kneaddata_paired	Verrucomicrobiota	33333	P	66735	6462	73197	0.00845
ERR1725837_1_kneaddata_paired	Cyanobacteria	9876	P	41300	558	41858	0.00483
ERR1725837_1_kneaddata_paired	Proteobacteria	22518	P	17057	202	17259	0.00199
ERR1725837_1_kneaddata_paired	Deferribacterota	10822	P	16305	103	16408	0.00189
ERR1725837_1_kneaddata_paired	Desulfobacterota_A	11509	P	10517	167	10684	0.00123
ERR1725837_1_kneaddata_paired	Actinobacteriota	615	P	2763	23	2786	0.00032
ERR1725837_1_kneaddata_paired	Firmicutes_B	17289	P	1406	89	1495	0.00017
ERR1725837_1_kneaddata_paired	Spirochaetota	32587	P	302	0	302	0.00003
ERR1725837_1_kneaddata_paired	Campylobacterota	8700	P	261	0	261	0.00003
ERR1725837_1_kneaddata_paired	Firmicutes_I	18140	P	58	0	58	0.00001
ERR1725837_1_kneaddata_paired	Firmicutes_C	17613	P	47	0	47	0.00001
ERR1725837_1_kneaddata_paired	Elusimicrobiota	11888	P	8	0	8	0.00000
ERR1725837_1_kneaddata_paired	Thermotogota	33086	P	7	0	7	0.00000
ERR1725838_1_kneaddata_paired	Bacteroidota	4587	P	3681325	29336	3710661	0.60907
ERR1725838_1_kneaddata_paired	Firmicutes_A	14608	P	1202219	14515	1216734	0.19972
ERR1725838_1_kneaddata_paired	Firmicutes	12188	P	909908	7480	917388	0.15058
ERR1725838_1_kneaddata_paired	Verrucomicrobiota	33333	P	92712	9447	102159	0.01677
ERR1725838_1_kneaddata_paired	Proteobacteria	22518	P	86993	974	87967	0.01444
ERR1725838_1_kneaddata_paired	Cyanobacteria	9876	P	26442	551	26993	0.00443
ERR1725838_1_kneaddata_paired	Desulfobacterota_A	11509	P	12338	85	12423	0.00204
ERR1725838_1_kneaddata_paired	Deferribacterota	10822	P	8439	56	8495	0.00139
ERR1725838_1_kneaddata_paired	Actinobacteriota	615	P	5560	56	5616	0.00092
ERR1725838_1_kneaddata_paired	Firmicutes_B	17289	P	2712	181	2893	0.00047
ERR1725838_1_kneaddata_paired	Campylobacterota	8700	P	494	0	494	0.00008
ERR1725838_1_kneaddata_paired	Spirochaetota	32587	P	384	1	385	0.00006
ERR1725838_1_kneaddata_paired	Firmicutes_I	18140	P	85	0	85	0.00001
ERR1725838_1_kneaddata_paired	Firmicutes_C	17613	P	39	0	39	0.00001
ERR1725838_1_kneaddata_paired	Elusimicrobiota	11888	P	9	0	9	0.00000
ERR1725838_1_kneaddata_paired	Thermotogota	33086	P	7	0	7	0.00000
ERR1725839_1_kneaddata_paired	Bacteroidota	4587	P	39791	371	40162	0.55076
ERR1725839_1_kneaddata_paired	Firmicutes_A	14608	P	23479	232	23711	0.32515
ERR1725839_1_kneaddata_paired	Firmicutes	12188	P	7404	67	7471	0.10246
ERR1725839_1_kneaddata_paired	Verrucomicrobiota	33333	P	758	76	834	0.01144
ERR1725839_1_kneaddata_paired	Desulfobacterota_A	11509	P	253	1	254	0.00348
ERR1725839_1_kneaddata_paired	Deferribacterota	10822	P	223	1	224	0.00308
ERR1725839_1_kneaddata_paired	Proteobacteria	22518	P	131	3	134	0.00184
ERR1725839_1_kneaddata_paired	Cyanobacteria	9876	P	99	2	101	0.00139
ERR1725839_1_kneaddata_paired	Actinobacteriota	615	P	21	0	21	0.00029
ERR1725839_1_kneaddata_paired	Firmicutes_B	17289	P	3	0	3	0.00004
ERR1725839_1_kneaddata_paired	Spirochaetota	32587	P	3	0	3	0.00004
ERR1725839_1_kneaddata_paired	Campylobacterota	8700	P	1	0	1	0.00001
ERR1725839_1_kneaddata_paired	Firmicutes_I	18140	P	1	0	1	0.00001
ERR1725840_1_kneaddata_paired	Bacteroidota	4587	P	115868	944	116812	0.60101
ERR1725840_1_kneaddata_paired	Firmicutes_A	14608	P	41939	512	42451	0.21842
ERR1725840_1_kneaddata_paired	Firmicutes	12188	P	29036	267	29303	0.15077
ERR1725840_1_kneaddata_paired	Verrucomicrobiota	33333	P	3872	356	4228	0.02176
ERR1725840_1_kneaddata_paired	Proteobacteria	22518	P	649	11	660	0.00340
ERR1725840_1_kneaddata_paired	Cyanobacteria	9876	P	285	4	289	0.00149
ERR1725840_1_kneaddata_paired	Deferribacterota	10822	P	263	1	264	0.00136
ERR1725840_1_kneaddata_paired	Desulfobacterota_A	11509	P	191	2	193	0.00099
ERR1725840_1_kneaddata_paired	Actinobacteriota	615	P	98	0	98	0.00051
ERR1725840_1_kneaddata_paired	Firmicutes_B	17289	P	37	2	39	0.00020
ERR1725840_1_kneaddata_paired	Campylobacterota	8700	P	11	0	11	0.00006
ERR1725840_1_kneaddata_paired	Spirochaetota	32587	P	3	0	3	0.00002
ERR1725840_1_kneaddata_paired	Elusimicrobiota	11888	P	1	0	1	0.00001
ERR1725840_1_kneaddata_paired	Firmicutes_C	17613	P	1	0	1	0.00001
ERR1725840_1_kneaddata_paired	Firmicutes_I	18140	P	1	0	1	0.00001
ERR1725841_1_kneaddata_paired	Bacteroidota	4587	P	388615	3635	392250	0.69757
ERR1725841_1_kneaddata_paired	Firmicutes_A	14608	P	93423	1430	94853	0.16869
ERR1725841_1_kneaddata_paired	Firmicutes	12188	P	64226	507	64733	0.11512
ERR1725841_1_kneaddata_paired	Verrucomicrobiota	33333	P	3282	327	3609	0.00642
ERR1725841_1_kneaddata_paired	Cyanobacteria	9876	P	2404	34	2438	0.00434
ERR1725841_1_kneaddata_paired	Proteobacteria	22518	P	2194	38	2232	0.00397
ERR1725841_1_kneaddata_paired	Deferribacterota	10822	P	1116	7	1123	0.00200
ERR1725841_1_kneaddata_paired	Desulfobacterota_A	11509	P	825	4	829	0.00148
ERR1725841_1_kneaddata_paired	Firmicutes_B	17289	P	86	5	91	0.00016
ERR1725841_1_kneaddata_paired	Actinobacteriota	615	P	83	1	84	0.00015
ERR1725841_1_kneaddata_paired	Spirochaetota	32587	P	37	0	37	0.00007
ERR1725841_1_kneaddata_paired	Campylobacterota	8700	P	18	0	18	0.00003
ERR1725841_1_kneaddata_paired	Firmicutes_I	18140	P	3	0	3	0.00001
ERR1725841_1_kneaddata_paired	Firmicutes_C	17613	P	2	0	2	0.00000
ERR1725842_1_kneaddata_paired	Firmicutes_A	14608	P	712710	5490	718200	0.51909
ERR1725842_1_kneaddata_paired	Bacteroidota	4587	P	458550	3673	462223	0.33408
ERR1725842_1_kneaddata_paired	Firmicutes	12188	P	126322	1013	127335	0.09203
ERR1725842_1_kneaddata_paired	Deferribacterota	10822	P	41710	243	41953	0.03032
ERR1725842_1_kneaddata_paired	Cyanobacteria	9876	P	16437	159	16596	0.01200
ERR1725842_1_kneaddata_paired	Desulfobacterota_A	11509	P	6650	54	6704	0.00485
ERR1725842_1_kneaddata_paired	Verrucomicrobiota	33333	P	5608	491	6099	0.00441
ERR1725842_1_kneaddata_paired	Proteobacteria	22518	P	3767	43	3810	0.00275
ERR1725842_1_kneaddata_paired	Spirochaetota	32587	P	214	0	214	0.00015
ERR1725842_1_kneaddata_paired	Firmicutes_B	17289	P	203	11	214	0.00016
ERR1725842_1_kneaddata_paired	Actinobacteriota	615	P	150	1	151	0.00011
ERR1725842_1_kneaddata_paired	Campylobacterota	8700	P	42	0	42	0.00003
ERR1725842_1_kneaddata_paired	Firmicutes_C	17613	P	15	0	15	0.00001
ERR1725842_1_kneaddata_paired	Firmicutes_I	18140	P	11	0	11	0.00001
ERR1725842_1_kneaddata_paired	Thermotogota	33086	P	6	0	6	0.00000
ERR1725842_1_kneaddata_paired	Elusimicrobiota	11888	P	1	0	1	0.00000
ERR1725843_1_kneaddata_paired	Firmicutes_A	14608	P	140316	981	141297	0.46335
ERR1725843_1_kneaddata_paired	Bacteroidota	4587	P	131842	994	132836	0.43561
ERR1725843_1_kneaddata_paired	Deferribacterota	10822	P	13599	76	13675	0.04485
ERR1725843_1_kneaddata_paired	Firmicutes	12188	P	11608	118	11726	0.03846
ERR1725843_1_kneaddata_paired	Cyanobacteria	9876	P	1924	18	1942	0.00637
ERR1725843_1_kneaddata_paired	Proteobacteria	22518	P	1314	13	1327	0.00435
ERR1725843_1_kneaddata_paired	Verrucomicrobiota	33333	P	1307	110	1417	0.00465
ERR1725843_1_kneaddata_paired	Desulfobacterota_A	11509	P	575	12	587	0.00193
ERR1725843_1_kneaddata_paired	Firmicutes_B	17289	P	76	4	80	0.00026
ERR1725843_1_kneaddata_paired	Actinobacteriota	615	P	23	0	23	0.00008
ERR1725843_1_kneaddata_paired	Spirochaetota	32587	P	18	0	18	0.00006
ERR1725843_1_kneaddata_paired	Campylobacterota	8700	P	5	0	5	0.00002
ERR1725843_1_kneaddata_paired	Firmicutes_C	17613	P	4	0	4	0.00001
ERR1725843_1_kneaddata_paired	Elusimicrobiota	11888	P	1	0	1	0.00000
ERR1725843_1_kneaddata_paired	Firmicutes_I	18140	P	1	0	1	0.00000
ERR1762083_1_kneaddata_paired	Firmicutes_A	14608	P	4255712	162126	4417838	0.60393
ERR1762083_1_kneaddata_paired	Bacteroidota	4587	P	2237787	65376	2303163	0.31485
ERR1762083_1_kneaddata_paired	Firmicutes	12188	P	284268	16960	301228	0.04118
ERR1762083_1_kneaddata_paired	Desulfobacterota_A	11509	P	127201	2477	129678	0.01773
ERR1762083_1_kneaddata_paired	Actinobacteriota	615	P	84173	1293	85466	0.01168
ERR1762083_1_kneaddata_paired	Cyanobacteria	9876	P	24628	706	25334	0.00346
ERR1762083_1_kneaddata_paired	Verrucomicrobiota	33333	P	23285	11583	34868	0.00477
ERR1762083_1_kneaddata_paired	Proteobacteria	22518	P	10020	869	10889	0.00149
ERR1762083_1_kneaddata_paired	Spirochaetota	32587	P	4536	31	4567	0.00062
ERR1762083_1_kneaddata_paired	Firmicutes_B	17289	P	1392	434	1826	0.00025
ERR1762083_1_kneaddata_paired	Firmicutes_C	17613	P	95	1	96	0.00001
ERR1762083_1_kneaddata_paired	Campylobacterota	8700	P	93	0	93	0.00001
ERR1762083_1_kneaddata_paired	Firmicutes_I	18140	P	54	0	54	0.00001
ERR1762083_1_kneaddata_paired	Deferribacterota	10822	P	21	0	21	0.00000
ERR1762083_1_kneaddata_paired	Elusimicrobiota	11888	P	5	0	5	0.00000
ERR1762083_1_kneaddata_paired	Thermotogota	33086	P	4	0	4	0.00000
ERR1762084_1_kneaddata_paired	Firmicutes_A	14608	P	4244682	161154	4405836	0.60403
ERR1762084_1_kneaddata_paired	Bacteroidota	4587	P	2230622	65077	2295699	0.31473
ERR1762084_1_kneaddata_paired	Firmicutes	12188	P	283718	16998	300716	0.04123
ERR1762084_1_kneaddata_paired	Desulfobacterota_A	11509	P	127139	2457	129596	0.01777
ERR1762084_1_kneaddata_paired	Actinobacteriota	615	P	84713	1290	86003	0.01179
ERR1762084_1_kneaddata_paired	Cyanobacteria	9876	P	24090	690	24780	0.00340
ERR1762084_1_kneaddata_paired	Verrucomicrobiota	33333	P	23016	11398	34414	0.00472
ERR1762084_1_kneaddata_paired	Proteobacteria	22518	P	9683	849	10532	0.00144
ERR1762084_1_kneaddata_paired	Spirochaetota	32587	P	4406	30	4436	0.00061
ERR1762084_1_kneaddata_paired	Firmicutes_B	17289	P	1368	426	1794	0.00025
ERR1762084_1_kneaddata_paired	Campylobacterota	8700	P	92	0	92	0.00001
ERR1762084_1_kneaddata_paired	Firmicutes_C	17613	P	83	1	84	0.00001
ERR1762084_1_kneaddata_paired	Firmicutes_I	18140	P	51	0	51	0.00001
ERR1762084_1_kneaddata_paired	Deferribacterota	10822	P	24	0	24	0.00000
ERR1762084_1_kneaddata_paired	Elusimicrobiota	11888	P	18	0	18	0.00000
ERR1762084_1_kneaddata_paired	Thermotogota	33086	P	7	0	7	0.00000
ERR1762085_1_kneaddata_paired	Firmicutes_A	14608	P	4257459	162535	4419994	0.60390
ERR1762085_1_kneaddata_paired	Bacteroidota	4587	P	2239158	65734	2304892	0.31491
ERR1762085_1_kneaddata_paired	Firmicutes	12188	P	283844	17082	300926	0.04111
ERR1762085_1_kneaddata_paired	Desulfobacterota_A	11509	P	127593	2492	130085	0.01777
ERR1762085_1_kneaddata_paired	Actinobacteriota	615	P	84420	1280	85700	0.01171
ERR1762085_1_kneaddata_paired	Cyanobacteria	9876	P	24338	696	25034	0.00342
ERR1762085_1_kneaddata_paired	Verrucomicrobiota	33333	P	23273	11626	34899	0.00477
ERR1762085_1_kneaddata_paired	Proteobacteria	22518	P	10045	899	10944	0.00150
ERR1762085_1_kneaddata_paired	Spirochaetota	32587	P	4417	31	4448	0.00061
ERR1762085_1_kneaddata_paired	Firmicutes_B	17289	P	1445	453	1898	0.00026
ERR1762085_1_kneaddata_paired	Campylobacterota	8700	P	124	0	124	0.00002
ERR1762085_1_kneaddata_paired	Firmicutes_C	17613	P	100	1	101	0.00001
ERR1762085_1_kneaddata_paired	Firmicutes_I	18140	P	57	0	57	0.00001
ERR1762085_1_kneaddata_paired	Deferribacterota	10822	P	18	0	18	0.00000
ERR1762085_1_kneaddata_paired	Elusimicrobiota	11888	P	12	0	12	0.00000
ERR1762085_1_kneaddata_paired	Thermotogota	33086	P	4	0	4	0.00000
ERR1762086_1_kneaddata_paired	Firmicutes_A	14608	P	4250856	161601	4412457	0.60391
ERR1762086_1_kneaddata_paired	Bacteroidota	4587	P	2235540	65219	2300759	0.31489
ERR1762086_1_kneaddata_paired	Firmicutes	12188	P	283140	16872	300012	0.04106
ERR1762086_1_kneaddata_paired	Desulfobacterota_A	11509	P	127784	2414	130198	0.01782
ERR1762086_1_kneaddata_paired	Actinobacteriota	615	P	84352	1269	85621	0.01172
ERR1762086_1_kneaddata_paired	Cyanobacteria	9876	P	24449	694	25143	0.00344
ERR1762086_1_kneaddata_paired	Verrucomicrobiota	33333	P	23197	11518	34715	0.00475
ERR1762086_1_kneaddata_paired	Proteobacteria	22518	P	10139	901	11040	0.00151
ERR1762086_1_kneaddata_paired	Spirochaetota	32587	P	4403	29	4432	0.00061
ERR1762086_1_kneaddata_paired	Firmicutes_B	17289	P	1375	428	1803	0.00025
ERR1762086_1_kneaddata_paired	Campylobacterota	8700	P	93	0	93	0.00001
ERR1762086_1_kneaddata_paired	Firmicutes_C	17613	P	79	1	80	0.00001
ERR1762086_1_kneaddata_paired	Firmicutes_I	18140	P	60	0	60	0.00001
ERR1762086_1_kneaddata_paired	Deferribacterota	10822	P	24	0	24	0.00000
ERR1762086_1_kneaddata_paired	Elusimicrobiota	11888	P	12	0	12	0.00000
ERR1762086_1_kneaddata_paired	Thermotogota	33086	P	6	0	6	0.00000
ERR1762091_1_kneaddata_paired	Firmicutes_A	14608	P	3709887	7449	3717336	0.40031
ERR1762091_1_kneaddata_paired	Bacteroidota	4587	P	3694551	8806	3703357	0.39880
ERR1762091_1_kneaddata_paired	Verrucomicrobiota	33333	P	1641940	57165	1699105	0.18297
ERR1762091_1_kneaddata_paired	Firmicutes	12188	P	147290	1278	148568	0.01600
ERR1762091_1_kneaddata_paired	Actinobacteriota	615	P	7330	11	7341	0.00079
ERR1762091_1_kneaddata_paired	Desulfobacterota_A	11509	P	6162	56	6218	0.00067
ERR1762091_1_kneaddata_paired	Cyanobacteria	9876	P	2000	4	2004	0.00022
ERR1762091_1_kneaddata_paired	Proteobacteria	22518	P	926	6	932	0.00010
ERR1762091_1_kneaddata_paired	Spirochaetota	32587	P	659	0	659	0.00007
ERR1762091_1_kneaddata_paired	Firmicutes_B	17289	P	507	10	517	0.00006
ERR1762091_1_kneaddata_paired	Campylobacterota	8700	P	74	0	74	0.00001
ERR1762091_1_kneaddata_paired	Firmicutes_C	17613	P	60	0	60	0.00001
ERR1762091_1_kneaddata_paired	Deferribacterota	10822	P	9	0	9	0.00000
ERR1762091_1_kneaddata_paired	Firmicutes_I	18140	P	9	0	9	0.00000
ERR1762091_1_kneaddata_paired	Thermotogota	33086	P	9	0	9	0.00000
ERR1762092_1_kneaddata_paired	Firmicutes_A	14608	P	3695184	7335	3702519	0.40026
ERR1762092_1_kneaddata_paired	Bacteroidota	4587	P	3681050	8665	3689715	0.39887
ERR1762092_1_kneaddata_paired	Verrucomicrobiota	33333	P	1635632	56262	1691894	0.18290
ERR1762092_1_kneaddata_paired	Firmicutes	12188	P	147426	1270	148696	0.01607
ERR1762092_1_kneaddata_paired	Actinobacteriota	615	P	7339	10	7349	0.00079
ERR1762092_1_kneaddata_paired	Desulfobacterota_A	11509	P	6001	56	6057	0.00065
ERR1762092_1_kneaddata_paired	Cyanobacteria	9876	P	1826	3	1829	0.00020
ERR1762092_1_kneaddata_paired	Proteobacteria	22518	P	935	5	940	0.00010
ERR1762092_1_kneaddata_paired	Spirochaetota	32587	P	664	0	664	0.00007
ERR1762092_1_kneaddata_paired	Firmicutes_B	17289	P	520	11	531	0.00006
ERR1762092_1_kneaddata_paired	Firmicutes_C	17613	P	67	0	67	0.00001
ERR1762092_1_kneaddata_paired	Campylobacterota	8700	P	56	0	56	0.00001
ERR1762092_1_kneaddata_paired	Firmicutes_I	18140	P	16	0	16	0.00000
ERR1762092_1_kneaddata_paired	Thermotogota	33086	P	9	0	9	0.00000
ERR1762092_1_kneaddata_paired	Deferribacterota	10822	P	6	0	6	0.00000
ERR1762092_1_kneaddata_paired	Elusimicrobiota	11888	P	4	0	4	0.00000
ERR1762093_1_kneaddata_paired	Firmicutes_A	14608	P	3696530	7462	3703992	0.40041
ERR1762093_1_kneaddata_paired	Bacteroidota	4587	P	3679958	8827	3688785	0.39877
ERR1762093_1_kneaddata_paired	Verrucomicrobiota	33333	P	1633270	57268	1690538	0.18275
ERR1762093_1_kneaddata_paired	Firmicutes	12188	P	148085	1295	149380	0.01615
ERR1762093_1_kneaddata_paired	Actinobacteriota	615	P	7416	11	7427	0.00080
ERR1762093_1_kneaddata_paired	Desulfobacterota_A	11509	P	6090	52	6142	0.00066
ERR1762093_1_kneaddata_paired	Cyanobacteria	9876	P	1944	3	1947	0.00021
ERR1762093_1_kneaddata_paired	Proteobacteria	22518	P	956	6	962	0.00010
ERR1762093_1_kneaddata_paired	Spirochaetota	32587	P	625	0	625	0.00007
ERR1762093_1_kneaddata_paired	Firmicutes_B	17289	P	514	11	525	0.00006
ERR1762093_1_kneaddata_paired	Firmicutes_C	17613	P	68	0	68	0.00001
ERR1762093_1_kneaddata_paired	Campylobacterota	8700	P	58	0	58	0.00001
ERR1762093_1_kneaddata_paired	Firmicutes_I	18140	P	13	0	13	0.00000
ERR1762093_1_kneaddata_paired	Thermotogota	33086	P	10	0	10	0.00000
ERR1762093_1_kneaddata_paired	Deferribacterota	10822	P	6	0	6	0.00000
ERR1762093_1_kneaddata_paired	Elusimicrobiota	11888	P	3	0	3	0.00000
ERR1762094_1_kneaddata_paired	Firmicutes_A	14608	P	3692474	7435	3699909	0.40031
ERR1762094_1_kneaddata_paired	Bacteroidota	4587	P	3677728	8806	3686534	0.39886
ERR1762094_1_kneaddata_paired	Verrucomicrobiota	33333	P	1632254	57045	1689299	0.18277
ERR1762094_1_kneaddata_paired	Firmicutes	12188	P	147897	1284	149181	0.01614
ERR1762094_1_kneaddata_paired	Actinobacteriota	615	P	7273	11	7284	0.00079
ERR1762094_1_kneaddata_paired	Desulfobacterota_A	11509	P	6142	58	6200	0.00067
ERR1762094_1_kneaddata_paired	Cyanobacteria	9876	P	1980	3	1983	0.00021
ERR1762094_1_kneaddata_paired	Proteobacteria	22518	P	893	6	899	0.00010
ERR1762094_1_kneaddata_paired	Spirochaetota	32587	P	672	0	672	0.00007
ERR1762094_1_kneaddata_paired	Firmicutes_B	17289	P	491	10	501	0.00005
ERR1762094_1_kneaddata_paired	Campylobacterota	8700	P	62	0	62	0.00001
ERR1762094_1_kneaddata_paired	Firmicutes_C	17613	P	47	0	47	0.00001
ERR1762094_1_kneaddata_paired	Firmicutes_I	18140	P	18	0	18	0.00000
ERR1762094_1_kneaddata_paired	Deferribacterota	10822	P	9	0	9	0.00000
ERR1762094_1_kneaddata_paired	Thermotogota	33086	P	9	0	9	0.00000
ERR1762094_1_kneaddata_paired	Elusimicrobiota	11888	P	1	0	1	0.00000
ERR1762095_1_kneaddata_paired	Bacteroidota	4587	P	8874035	55153	8929188	0.85822
ERR1762095_1_kneaddata_paired	Firmicutes_A	14608	P	782906	15664	798570	0.07675
ERR1762095_1_kneaddata_paired	Verrucomicrobiota	33333	P	527106	69069	596175	0.05730
ERR1762095_1_kneaddata_paired	Firmicutes	12188	P	65670	2115	67785	0.00652
ERR1762095_1_kneaddata_paired	Actinobacteriota	615	P	6958	49	7007	0.00067
ERR1762095_1_kneaddata_paired	Desulfobacterota_A	11509	P	1585	17	1602	0.00015
ERR1762095_1_kneaddata_paired	Cyanobacteria	9876	P	1456	15	1471	0.00014
ERR1762095_1_kneaddata_paired	Proteobacteria	22518	P	1383	48	1431	0.00014
ERR1762095_1_kneaddata_paired	Spirochaetota	32587	P	647	3	650	0.00006
ERR1762095_1_kneaddata_paired	Firmicutes_B	17289	P	203	16	219	0.00002
ERR1762095_1_kneaddata_paired	Campylobacterota	8700	P	164	0	164	0.00002
ERR1762095_1_kneaddata_paired	Thermotogota	33086	P	21	0	21	0.00000
ERR1762095_1_kneaddata_paired	Firmicutes_C	17613	P	13	0	13	0.00000
ERR1762095_1_kneaddata_paired	Firmicutes_I	18140	P	10	0	10	0.00000
ERR1762095_1_kneaddata_paired	Deferribacterota	10822	P	3	0	3	0.00000
ERR1762096_1_kneaddata_paired	Bacteroidota	4587	P	8838185	55127	8893312	0.85829
ERR1762096_1_kneaddata_paired	Firmicutes_A	14608	P	778596	15630	794226	0.07665
ERR1762096_1_kneaddata_paired	Verrucomicrobiota	33333	P	525225	69012	594237	0.05735
ERR1762096_1_kneaddata_paired	Firmicutes	12188	P	65245	2096	67341	0.00650
ERR1762096_1_kneaddata_paired	Actinobacteriota	615	P	6889	50	6939	0.00067
ERR1762096_1_kneaddata_paired	Desulfobacterota_A	11509	P	1583	16	1599	0.00015
ERR1762096_1_kneaddata_paired	Cyanobacteria	9876	P	1438	15	1453	0.00014
ERR1762096_1_kneaddata_paired	Proteobacteria	22518	P	1383	47	1430	0.00014
ERR1762096_1_kneaddata_paired	Spirochaetota	32587	P	638	3	641	0.00006
ERR1762096_1_kneaddata_paired	Firmicutes_B	17289	P	195	15	210	0.00002
ERR1762096_1_kneaddata_paired	Campylobacterota	8700	P	159	0	159	0.00002
ERR1762096_1_kneaddata_paired	Thermotogota	33086	P	27	0	27	0.00000
ERR1762096_1_kneaddata_paired	Firmicutes_C	17613	P	14	0	14	0.00000
ERR1762096_1_kneaddata_paired	Firmicutes_I	18140	P	11	0	11	0.00000
ERR1762096_1_kneaddata_paired	Deferribacterota	10822	P	4	0	4	0.00000
ERR1762097_1_kneaddata_paired	Bacteroidota	4587	P	8844679	55117	8899796	0.85842
ERR1762097_1_kneaddata_paired	Firmicutes_A	14608	P	779156	15619	794775	0.07666
ERR1762097_1_kneaddata_paired	Verrucomicrobiota	33333	P	523861	68752	592613	0.05716
ERR1762097_1_kneaddata_paired	Firmicutes	12188	P	65702	2124	67826	0.00654
ERR1762097_1_kneaddata_paired	Actinobacteriota	615	P	6878	54	6932	0.00067
ERR1762097_1_kneaddata_paired	Desulfobacterota_A	11509	P	1640	20	1660	0.00016
ERR1762097_1_kneaddata_paired	Cyanobacteria	9876	P	1458	15	1473	0.00014
ERR1762097_1_kneaddata_paired	Proteobacteria	22518	P	1378	48	1426	0.00014
ERR1762097_1_kneaddata_paired	Spirochaetota	32587	P	632	2	634	0.00006
ERR1762097_1_kneaddata_paired	Firmicutes_B	17289	P	218	17	235	0.00002
ERR1762097_1_kneaddata_paired	Campylobacterota	8700	P	157	0	157	0.00002
ERR1762097_1_kneaddata_paired	Thermotogota	33086	P	26	0	26	0.00000
ERR1762097_1_kneaddata_paired	Firmicutes_C	17613	P	15	0	15	0.00000
ERR1762097_1_kneaddata_paired	Firmicutes_I	18140	P	13	0	13	0.00000
ERR1762097_1_kneaddata_paired	Deferribacterota	10822	P	3	0	3	0.00000
ERR1762098_1_kneaddata_paired	Bacteroidota	4587	P	8848262	55062	8903324	0.85848
ERR1762098_1_kneaddata_paired	Firmicutes_A	14608	P	778705	15530	794235	0.07658
ERR1762098_1_kneaddata_paired	Verrucomicrobiota	33333	P	524541	68772	593313	0.05721
ERR1762098_1_kneaddata_paired	Firmicutes	12188	P	65443	2119	67562	0.00651
ERR1762098_1_kneaddata_paired	Actinobacteriota	615	P	6859	46	6905	0.00067
ERR1762098_1_kneaddata_paired	Desulfobacterota_A	11509	P	1639	19	1658	0.00016
ERR1762098_1_kneaddata_paired	Cyanobacteria	9876	P	1473	14	1487	0.00014
ERR1762098_1_kneaddata_paired	Proteobacteria	22518	P	1390	46	1436	0.00014
ERR1762098_1_kneaddata_paired	Spirochaetota	32587	P	643	3	646	0.00006
ERR1762098_1_kneaddata_paired	Firmicutes_B	17289	P	207	16	223	0.00002
ERR1762098_1_kneaddata_paired	Campylobacterota	8700	P	177	0	177	0.00002
ERR1762098_1_kneaddata_paired	Thermotogota	33086	P	25	0	25	0.00000
ERR1762098_1_kneaddata_paired	Firmicutes_C	17613	P	13	0	13	0.00000
ERR1762098_1_kneaddata_paired	Firmicutes_I	18140	P	13	0	13	0.00000
ERR1762098_1_kneaddata_paired	Deferribacterota	10822	P	4	0	4	0.00000
ERR1762099_1_kneaddata_paired	Bacteroidota	4587	P	3662277	24316	3686593	0.50406
ERR1762099_1_kneaddata_paired	Firmicutes_A	14608	P	2968293	21184	2989477	0.40875
ERR1762099_1_kneaddata_paired	Verrucomicrobiota	33333	P	448458	47708	496166	0.06784
ERR1762099_1_kneaddata_paired	Firmicutes	12188	P	87662	2949	90611	0.01239
ERR1762099_1_kneaddata_paired	Actinobacteriota	615	P	37215	107	37322	0.00510
ERR1762099_1_kneaddata_paired	Desulfobacterota_A	11509	P	8198	198	8396	0.00115
ERR1762099_1_kneaddata_paired	Cyanobacteria	9876	P	2867	31	2898	0.00040
ERR1762099_1_kneaddata_paired	Proteobacteria	22518	P	1239	24	1263	0.00017
ERR1762099_1_kneaddata_paired	Spirochaetota	32587	P	666	2	668	0.00009
ERR1762099_1_kneaddata_paired	Firmicutes_B	17289	P	218	14	232	0.00003
ERR1762099_1_kneaddata_paired	Firmicutes_C	17613	P	47	0	47	0.00001
ERR1762099_1_kneaddata_paired	Campylobacterota	8700	P	41	0	41	0.00001
ERR1762099_1_kneaddata_paired	Firmicutes_I	18140	P	20	0	20	0.00000
ERR1762099_1_kneaddata_paired	Deferribacterota	10822	P	4	0	4	0.00000
ERR1762099_1_kneaddata_paired	Elusimicrobiota	11888	P	3	0	3	0.00000
ERR1762099_1_kneaddata_paired	Thermotogota	33086	P	2	0	2	0.00000
ERR1762100_1_kneaddata_paired	Bacteroidota	4587	P	3642622	24346	3666968	0.50365
ERR1762100_1_kneaddata_paired	Firmicutes_A	14608	P	2956352	21174	2977526	0.40895
ERR1762100_1_kneaddata_paired	Verrucomicrobiota	33333	P	447246	47848	495094	0.06800
ERR1762100_1_kneaddata_paired	Firmicutes	12188	P	87904	2975	90879	0.01248
ERR1762100_1_kneaddata_paired	Actinobacteriota	615	P	36852	111	36963	0.00508
ERR1762100_1_kneaddata_paired	Desulfobacterota_A	11509	P	8088	215	8303	0.00114
ERR1762100_1_kneaddata_paired	Cyanobacteria	9876	P	2832	31	2863	0.00039
ERR1762100_1_kneaddata_paired	Proteobacteria	22518	P	1226	25	1251	0.00017
ERR1762100_1_kneaddata_paired	Spirochaetota	32587	P	647	2	649	0.00009
ERR1762100_1_kneaddata_paired	Firmicutes_B	17289	P	210	13	223	0.00003
ERR1762100_1_kneaddata_paired	Firmicutes_C	17613	P	36	0	36	0.00000
ERR1762100_1_kneaddata_paired	Campylobacterota	8700	P	23	0	23	0.00000
ERR1762100_1_kneaddata_paired	Firmicutes_I	18140	P	23	0	23	0.00000
ERR1762100_1_kneaddata_paired	Deferribacterota	10822	P	9	0	9	0.00000
ERR1762100_1_kneaddata_paired	Thermotogota	33086	P	2	0	2	0.00000
ERR1762101_1_kneaddata_paired	Bacteroidota	4587	P	3639798	24506	3664304	0.50374
ERR1762101_1_kneaddata_paired	Firmicutes_A	14608	P	2953966	21252	2975218	0.40901
ERR1762101_1_kneaddata_paired	Verrucomicrobiota	33333	P	445138	47946	493084	0.06779
ERR1762101_1_kneaddata_paired	Firmicutes	12188	P	88135	3013	91148	0.01253
ERR1762101_1_kneaddata_paired	Actinobacteriota	615	P	36798	112	36910	0.00507
ERR1762101_1_kneaddata_paired	Desulfobacterota_A	11509	P	8105	213	8318	0.00114
ERR1762101_1_kneaddata_paired	Cyanobacteria	9876	P	2862	32	2894	0.00040
ERR1762101_1_kneaddata_paired	Proteobacteria	22518	P	1281	25	1306	0.00018
ERR1762101_1_kneaddata_paired	Spirochaetota	32587	P	609	2	611	0.00008
ERR1762101_1_kneaddata_paired	Firmicutes_B	17289	P	216	14	230	0.00003
ERR1762101_1_kneaddata_paired	Firmicutes_C	17613	P	38	0	38	0.00001
ERR1762101_1_kneaddata_paired	Campylobacterota	8700	P	29	0	29	0.00000
ERR1762101_1_kneaddata_paired	Firmicutes_I	18140	P	24	0	24	0.00000
ERR1762101_1_kneaddata_paired	Deferribacterota	10822	P	10	0	10	0.00000
ERR1762101_1_kneaddata_paired	Thermotogota	33086	P	4	0	4	0.00000
ERR1762101_1_kneaddata_paired	Elusimicrobiota	11888	P	1	0	1	0.00000
ERR1762102_1_kneaddata_paired	Bacteroidota	4587	P	3638141	24463	3662604	0.50402
ERR1762102_1_kneaddata_paired	Firmicutes_A	14608	P	2948849	21244	2970093	0.40872
ERR1762102_1_kneaddata_paired	Verrucomicrobiota	33333	P	445255	47822	493077	0.06785
ERR1762102_1_kneaddata_paired	Firmicutes	12188	P	87925	3019	90944	0.01251
ERR1762102_1_kneaddata_paired	Actinobacteriota	615	P	36617	111	36728	0.00505
ERR1762102_1_kneaddata_paired	Desulfobacterota_A	11509	P	8152	202	8354	0.00115
ERR1762102_1_kneaddata_paired	Cyanobacteria	9876	P	2829	29	2858	0.00039
ERR1762102_1_kneaddata_paired	Proteobacteria	22518	P	1215	24	1239	0.00017
ERR1762102_1_kneaddata_paired	Spirochaetota	32587	P	606	1	607	0.00008
ERR1762102_1_kneaddata_paired	Firmicutes_B	17289	P	208	13	221	0.00003
ERR1762102_1_kneaddata_paired	Firmicutes_C	17613	P	35	0	35	0.00000
ERR1762102_1_kneaddata_paired	Firmicutes_I	18140	P	29	0	29	0.00000
ERR1762102_1_kneaddata_paired	Campylobacterota	8700	P	28	0	28	0.00000
ERR1762102_1_kneaddata_paired	Deferribacterota	10822	P	7	0	7	0.00000
ERR1762102_1_kneaddata_paired	Elusimicrobiota	11888	P	3	0	3	0.00000
ERR1762102_1_kneaddata_paired	Thermotogota	33086	P	2	0	2	0.00000
ERR1762103_1_kneaddata_paired	Bacteroidota	4587	P	6601462	30099	6631561	0.67285
ERR1762103_1_kneaddata_paired	Firmicutes_A	14608	P	1540679	11351	1552030	0.15747
ERR1762103_1_kneaddata_paired	Verrucomicrobiota	33333	P	1278369	92003	1370372	0.13904
ERR1762103_1_kneaddata_paired	Firmicutes	12188	P	263523	3550	267073	0.02710
ERR1762103_1_kneaddata_paired	Actinobacteriota	615	P	27803	64	27867	0.00283
ERR1762103_1_kneaddata_paired	Proteobacteria	22518	P	2007	53	2060	0.00021
ERR1762103_1_kneaddata_paired	Cyanobacteria	9876	P	1847	19	1866	0.00019
ERR1762103_1_kneaddata_paired	Spirochaetota	32587	P	1753	8	1761	0.00018
ERR1762103_1_kneaddata_paired	Desulfobacterota_A	11509	P	853	31	884	0.00009
ERR1762103_1_kneaddata_paired	Firmicutes_B	17289	P	316	14	330	0.00003
ERR1762103_1_kneaddata_paired	Campylobacterota	8700	P	54	0	54	0.00001
ERR1762103_1_kneaddata_paired	Firmicutes_I	18140	P	37	0	37	0.00000
ERR1762103_1_kneaddata_paired	Firmicutes_C	17613	P	30	0	30	0.00000
ERR1762103_1_kneaddata_paired	Thermotogota	33086	P	9	0	9	0.00000
ERR1762103_1_kneaddata_paired	Deferribacterota	10822	P	2	0	2	0.00000
ERR1762104_1_kneaddata_paired	Bacteroidota	4587	P	6565335	30010	6595345	0.67248
ERR1762104_1_kneaddata_paired	Firmicutes_A	14608	P	1536344	11363	1547707	0.15781
ERR1762104_1_kneaddata_paired	Verrucomicrobiota	33333	P	1272508	91764	1364272	0.13911
ERR1762104_1_kneaddata_paired	Firmicutes	12188	P	262075	3526	265601	0.02708
ERR1762104_1_kneaddata_paired	Actinobacteriota	615	P	27385	67	27452	0.00280
ERR1762104_1_kneaddata_paired	Proteobacteria	22518	P	1999	51	2050	0.00021
ERR1762104_1_kneaddata_paired	Cyanobacteria	9876	P	1904	18	1922	0.00020
ERR1762104_1_kneaddata_paired	Spirochaetota	32587	P	1678	8	1686	0.00017
ERR1762104_1_kneaddata_paired	Desulfobacterota_A	11509	P	859	35	894	0.00009
ERR1762104_1_kneaddata_paired	Firmicutes_B	17289	P	339	15	354	0.00004
ERR1762104_1_kneaddata_paired	Campylobacterota	8700	P	65	0	65	0.00001
ERR1762104_1_kneaddata_paired	Firmicutes_I	18140	P	50	0	50	0.00001
ERR1762104_1_kneaddata_paired	Firmicutes_C	17613	P	40	0	40	0.00000
ERR1762104_1_kneaddata_paired	Thermotogota	33086	P	5	0	5	0.00000
ERR1762104_1_kneaddata_paired	Deferribacterota	10822	P	2	0	2	0.00000
ERR1762104_1_kneaddata_paired	Elusimicrobiota	11888	P	1	0	1	0.00000
ERR1762105_1_kneaddata_paired	Bacteroidota	4587	P	6579868	30177	6610045	0.67221
ERR1762105_1_kneaddata_paired	Firmicutes_A	14608	P	1539609	11427	1551036	0.15773
ERR1762105_1_kneaddata_paired	Verrucomicrobiota	33333	P	1276505	92418	1368923	0.13921
ERR1762105_1_kneaddata_paired	Firmicutes	12188	P	264695	3592	268287	0.02728
ERR1762105_1_kneaddata_paired	Actinobacteriota	615	P	27929	68	27997	0.00285
ERR1762105_1_kneaddata_paired	Proteobacteria	22518	P	1996	51	2047	0.00021
ERR1762105_1_kneaddata_paired	Cyanobacteria	9876	P	1958	21	1979	0.00020
ERR1762105_1_kneaddata_paired	Spirochaetota	32587	P	1688	8	1696	0.00017
ERR1762105_1_kneaddata_paired	Desulfobacterota_A	11509	P	796	29	825	0.00008
ERR1762105_1_kneaddata_paired	Firmicutes_B	17289	P	295	13	308	0.00003
ERR1762105_1_kneaddata_paired	Campylobacterota	8700	P	57	0	57	0.00001
ERR1762105_1_kneaddata_paired	Firmicutes_I	18140	P	31	0	31	0.00000
ERR1762105_1_kneaddata_paired	Firmicutes_C	17613	P	30	0	30	0.00000
ERR1762105_1_kneaddata_paired	Thermotogota	33086	P	6	0	6	0.00000
ERR1762105_1_kneaddata_paired	Elusimicrobiota	11888	P	5	0	5	0.00000
ERR1762105_1_kneaddata_paired	Deferribacterota	10822	P	3	0	3	0.00000
ERR1762106_1_kneaddata_paired	Bacteroidota	4587	P	6577476	30141	6607617	0.67260
ERR1762106_1_kneaddata_paired	Firmicutes_A	14608	P	1539320	11417	1550737	0.15785
ERR1762106_1_kneaddata_paired	Verrucomicrobiota	33333	P	1272104	92039	1364143	0.13886
ERR1762106_1_kneaddata_paired	Firmicutes	12188	P	262928	3549	266477	0.02713
ERR1762106_1_kneaddata_paired	Actinobacteriota	615	P	27880	65	27945	0.00284
ERR1762106_1_kneaddata_paired	Proteobacteria	22518	P	2012	51	2063	0.00021
ERR1762106_1_kneaddata_paired	Cyanobacteria	9876	P	1895	20	1915	0.00020
ERR1762106_1_kneaddata_paired	Spirochaetota	32587	P	1689	8	1697	0.00017
ERR1762106_1_kneaddata_paired	Desulfobacterota_A	11509	P	847	30	877	0.00009
ERR1762106_1_kneaddata_paired	Firmicutes_B	17289	P	307	13	320	0.00003
ERR1762106_1_kneaddata_paired	Campylobacterota	8700	P	70	0	70	0.00001
ERR1762106_1_kneaddata_paired	Firmicutes_C	17613	P	40	0	40	0.00000
ERR1762106_1_kneaddata_paired	Firmicutes_I	18140	P	31	0	31	0.00000
ERR1762106_1_kneaddata_paired	Thermotogota	33086	P	10	0	10	0.00000
ERR1762106_1_kneaddata_paired	Elusimicrobiota	11888	P	6	0	6	0.00000
ERR1762106_1_kneaddata_paired	Deferribacterota	10822	P	4	0	4	0.00000
ERR1762107_1_kneaddata_paired	Firmicutes_A	14608	P	5012857	38914	5051771	0.71298
ERR1762107_1_kneaddata_paired	Bacteroidota	4587	P	1620640	4448	1625088	0.22936
ERR1762107_1_kneaddata_paired	Firmicutes	12188	P	344327	17190	361517	0.05102
ERR1762107_1_kneaddata_paired	Actinobacteriota	615	P	38120	342	38462	0.00543
ERR1762107_1_kneaddata_paired	Cyanobacteria	9876	P	3395	34	3429	0.00048
ERR1762107_1_kneaddata_paired	Desulfobacterota_A	11509	P	1335	343	1678	0.00024
ERR1762107_1_kneaddata_paired	Proteobacteria	22518	P	1128	16	1144	0.00016
ERR1762107_1_kneaddata_paired	Spirochaetota	32587	P	964	5	969	0.00014
ERR1762107_1_kneaddata_paired	Verrucomicrobiota	33333	P	513	43	556	0.00008
ERR1762107_1_kneaddata_paired	Firmicutes_B	17289	P	329	25	354	0.00005
ERR1762107_1_kneaddata_paired	Campylobacterota	8700	P	261	0	261	0.00004
ERR1762107_1_kneaddata_paired	Firmicutes_I	18140	P	114	0	114	0.00002
ERR1762107_1_kneaddata_paired	Firmicutes_C	17613	P	81	0	81	0.00001
ERR1762107_1_kneaddata_paired	Deferribacterota	10822	P	20	0	20	0.00000
ERR1762107_1_kneaddata_paired	Thermotogota	33086	P	15	0	15	0.00000
ERR1762107_1_kneaddata_paired	Elusimicrobiota	11888	P	4	0	4	0.00000
ERR1762108_1_kneaddata_paired	Firmicutes_A	14608	P	4993232	38788	5032020	0.71317
ERR1762108_1_kneaddata_paired	Bacteroidota	4587	P	1614074	4415	1618489	0.22938
ERR1762108_1_kneaddata_paired	Firmicutes	12188	P	341365	16988	358353	0.05079
ERR1762108_1_kneaddata_paired	Actinobacteriota	615	P	38156	338	38494	0.00546
ERR1762108_1_kneaddata_paired	Cyanobacteria	9876	P	3346	35	3381	0.00048
ERR1762108_1_kneaddata_paired	Desulfobacterota_A	11509	P	1242	313	1555	0.00022
ERR1762108_1_kneaddata_paired	Proteobacteria	22518	P	1076	17	1093	0.00015
ERR1762108_1_kneaddata_paired	Spirochaetota	32587	P	953	4	957	0.00014
ERR1762108_1_kneaddata_paired	Verrucomicrobiota	33333	P	521	45	566	0.00008
ERR1762108_1_kneaddata_paired	Firmicutes_B	17289	P	364	28	392	0.00006
ERR1762108_1_kneaddata_paired	Campylobacterota	8700	P	273	0	273	0.00004
ERR1762108_1_kneaddata_paired	Firmicutes_I	18140	P	108	0	108	0.00002
ERR1762108_1_kneaddata_paired	Firmicutes_C	17613	P	88	0	88	0.00001
ERR1762108_1_kneaddata_paired	Deferribacterota	10822	P	23	0	23	0.00000
ERR1762108_1_kneaddata_paired	Thermotogota	33086	P	11	0	11	0.00000
ERR1762108_1_kneaddata_paired	Elusimicrobiota	11888	P	2	0	2	0.00000
ERR1762109_1_kneaddata_paired	Firmicutes_A	14608	P	4997711	38993	5036704	0.71307
ERR1762109_1_kneaddata_paired	Bacteroidota	4587	P	1615339	4462	1619801	0.22932
ERR1762109_1_kneaddata_paired	Firmicutes	12188	P	343124	17208	360332	0.05101
ERR1762109_1_kneaddata_paired	Actinobacteriota	615	P	37676	337	38013	0.00538
ERR1762109_1_kneaddata_paired	Cyanobacteria	9876	P	3460	34	3494	0.00049
ERR1762109_1_kneaddata_paired	Desulfobacterota_A	11509	P	1226	315	1541	0.00022
ERR1762109_1_kneaddata_paired	Proteobacteria	22518	P	1086	16	1102	0.00016
ERR1762109_1_kneaddata_paired	Spirochaetota	32587	P	1018	5	1023	0.00014
ERR1762109_1_kneaddata_paired	Verrucomicrobiota	33333	P	474	39	513	0.00007
ERR1762109_1_kneaddata_paired	Firmicutes_B	17289	P	359	27	386	0.00005
ERR1762109_1_kneaddata_paired	Campylobacterota	8700	P	263	0	263	0.00004
ERR1762109_1_kneaddata_paired	Firmicutes_I	18140	P	111	0	111	0.00002
ERR1762109_1_kneaddata_paired	Firmicutes_C	17613	P	76	0	76	0.00001
ERR1762109_1_kneaddata_paired	Deferribacterota	10822	P	29	0	29	0.00000
ERR1762109_1_kneaddata_paired	Thermotogota	33086	P	7	0	7	0.00000
ERR1762109_1_kneaddata_paired	Elusimicrobiota	11888	P	4	0	4	0.00000
ERR1762110_1_kneaddata_paired	Firmicutes_A	14608	P	4998132	39011	5037143	0.71295
ERR1762110_1_kneaddata_paired	Bacteroidota	4587	P	1615487	4430	1619917	0.22928
ERR1762110_1_kneaddata_paired	Firmicutes	12188	P	343739	17224	360963	0.05109
ERR1762110_1_kneaddata_paired	Actinobacteriota	615	P	37981	343	38324	0.00542
ERR1762110_1_kneaddata_paired	Cyanobacteria	9876	P	3566	39	3605	0.00051
ERR1762110_1_kneaddata_paired	Desulfobacterota_A	11509	P	1257	336	1593	0.00023
ERR1762110_1_kneaddata_paired	Proteobacteria	22518	P	1155	16	1171	0.00017
ERR1762110_1_kneaddata_paired	Spirochaetota	32587	P	1015	5	1020	0.00014
ERR1762110_1_kneaddata_paired	Verrucomicrobiota	33333	P	522	46	568	0.00008
ERR1762110_1_kneaddata_paired	Firmicutes_B	17289	P	325	25	350	0.00005
ERR1762110_1_kneaddata_paired	Campylobacterota	8700	P	300	0	300	0.00004
ERR1762110_1_kneaddata_paired	Firmicutes_I	18140	P	108	0	108	0.00002
ERR1762110_1_kneaddata_paired	Firmicutes_C	17613	P	81	0	81	0.00001
ERR1762110_1_kneaddata_paired	Deferribacterota	10822	P	25	0	25	0.00000
ERR1762110_1_kneaddata_paired	Thermotogota	33086	P	7	0	7	0.00000
ERR1762110_1_kneaddata_paired	Elusimicrobiota	11888	P	2	0	2	0.00000
ERR1762111_1_kneaddata_paired	Firmicutes_A	14608	P	4675793	22860	4698653	0.54739
ERR1762111_1_kneaddata_paired	Firmicutes	12188	P	2777503	66327	2843830	0.33130
ERR1762111_1_kneaddata_paired	Actinobacteriota	615	P	1008110	1245	1009355	0.11759
ERR1762111_1_kneaddata_paired	Bacteroidota	4587	P	13514	169	13683	0.00159
ERR1762111_1_kneaddata_paired	Spirochaetota	32587	P	7681	41	7722	0.00090
ERR1762111_1_kneaddata_paired	Cyanobacteria	9876	P	4487	36	4523	0.00053
ERR1762111_1_kneaddata_paired	Verrucomicrobiota	33333	P	1490	87	1577	0.00018
ERR1762111_1_kneaddata_paired	Proteobacteria	22518	P	1395	7	1402	0.00016
ERR1762111_1_kneaddata_paired	Firmicutes_B	17289	P	980	39	1019	0.00012
ERR1762111_1_kneaddata_paired	Desulfobacterota_A	11509	P	844	124	968	0.00011
ERR1762111_1_kneaddata_paired	Campylobacterota	8700	P	630	0	630	0.00007
ERR1762111_1_kneaddata_paired	Firmicutes_I	18140	P	242	0	242	0.00003
ERR1762111_1_kneaddata_paired	Firmicutes_C	17613	P	67	0	67	0.00001
ERR1762111_1_kneaddata_paired	Elusimicrobiota	11888	P	60	0	60	0.00001
ERR1762111_1_kneaddata_paired	Deferribacterota	10822	P	19	0	19	0.00000
ERR1762111_1_kneaddata_paired	Thermotogota	33086	P	10	0	10	0.00000
ERR1762112_1_kneaddata_paired	Firmicutes_A	14608	P	4661932	22790	4684722	0.54760
ERR1762112_1_kneaddata_paired	Firmicutes	12188	P	2766107	66285	2832392	0.33108
ERR1762112_1_kneaddata_paired	Actinobacteriota	615	P	1004364	1243	1005607	0.11755
ERR1762112_1_kneaddata_paired	Bacteroidota	4587	P	13771	169	13940	0.00163
ERR1762112_1_kneaddata_paired	Spirochaetota	32587	P	7696	41	7737	0.00090
ERR1762112_1_kneaddata_paired	Cyanobacteria	9876	P	4522	35	4557	0.00053
ERR1762112_1_kneaddata_paired	Verrucomicrobiota	33333	P	1470	84	1554	0.00018
ERR1762112_1_kneaddata_paired	Proteobacteria	22518	P	1389	6	1395	0.00016
ERR1762112_1_kneaddata_paired	Firmicutes_B	17289	P	1020	41	1061	0.00012
ERR1762112_1_kneaddata_paired	Desulfobacterota_A	11509	P	859	125	984	0.00012
ERR1762112_1_kneaddata_paired	Campylobacterota	8700	P	662	0	662	0.00008
ERR1762112_1_kneaddata_paired	Firmicutes_I	18140	P	222	0	222	0.00003
ERR1762112_1_kneaddata_paired	Firmicutes_C	17613	P	54	0	54	0.00001
ERR1762112_1_kneaddata_paired	Elusimicrobiota	11888	P	48	0	48	0.00001
ERR1762112_1_kneaddata_paired	Deferribacterota	10822	P	16	0	16	0.00000
ERR1762112_1_kneaddata_paired	Thermotogota	33086	P	9	0	9	0.00000
ERR1762113_1_kneaddata_paired	Firmicutes_A	14608	P	4677166	22973	4700139	0.54801
ERR1762113_1_kneaddata_paired	Firmicutes	12188	P	2778764	66709	2845473	0.33176
ERR1762113_1_kneaddata_paired	Actinobacteriota	615	P	997733	1239	998972	0.11647
ERR1762113_1_kneaddata_paired	Bacteroidota	4587	P	13641	173	13814	0.00161
ERR1762113_1_kneaddata_paired	Spirochaetota	32587	P	7820	42	7862	0.00092
ERR1762113_1_kneaddata_paired	Cyanobacteria	9876	P	4472	36	4508	0.00053
ERR1762113_1_kneaddata_paired	Verrucomicrobiota	33333	P	1432	82	1514	0.00018
ERR1762113_1_kneaddata_paired	Proteobacteria	22518	P	1396	6	1402	0.00016
ERR1762113_1_kneaddata_paired	Firmicutes_B	17289	P	1008	41	1049	0.00012
ERR1762113_1_kneaddata_paired	Desulfobacterota_A	11509	P	844	128	972	0.00011
ERR1762113_1_kneaddata_paired	Campylobacterota	8700	P	668	0	668	0.00008
ERR1762113_1_kneaddata_paired	Firmicutes_I	18140	P	230	0	230	0.00003
ERR1762113_1_kneaddata_paired	Firmicutes_C	17613	P	88	0	88	0.00001
ERR1762113_1_kneaddata_paired	Elusimicrobiota	11888	P	62	0	62	0.00001
ERR1762113_1_kneaddata_paired	Deferribacterota	10822	P	24	0	24	0.00000
ERR1762113_1_kneaddata_paired	Thermotogota	33086	P	5	0	5	0.00000
ERR1762114_1_kneaddata_paired	Firmicutes_A	14608	P	4672702	22907	4695609	0.54842
ERR1762114_1_kneaddata_paired	Firmicutes	12188	P	2769042	66359	2835401	0.33116
ERR1762114_1_kneaddata_paired	Actinobacteriota	615	P	997268	1231	998499	0.11662
ERR1762114_1_kneaddata_paired	Bacteroidota	4587	P	13754	168	13922	0.00163
ERR1762114_1_kneaddata_paired	Spirochaetota	32587	P	7827	42	7869	0.00092
ERR1762114_1_kneaddata_paired	Cyanobacteria	9876	P	4491	35	4526	0.00053
ERR1762114_1_kneaddata_paired	Verrucomicrobiota	33333	P	1569	89	1658	0.00019
ERR1762114_1_kneaddata_paired	Proteobacteria	22518	P	1402	6	1408	0.00016
ERR1762114_1_kneaddata_paired	Firmicutes_B	17289	P	1038	42	1080	0.00013
ERR1762114_1_kneaddata_paired	Desulfobacterota_A	11509	P	912	135	1047	0.00012
ERR1762114_1_kneaddata_paired	Campylobacterota	8700	P	626	0	626	0.00007
ERR1762114_1_kneaddata_paired	Firmicutes_I	18140	P	229	0	229	0.00003
ERR1762114_1_kneaddata_paired	Firmicutes_C	17613	P	76	0	76	0.00001
ERR1762114_1_kneaddata_paired	Elusimicrobiota	11888	P	61	0	61	0.00001
ERR1762114_1_kneaddata_paired	Deferribacterota	10822	P	20	0	20	0.00000
ERR1762114_1_kneaddata_paired	Thermotogota	33086	P	14	0	14	0.00000
ERR1762115_1_kneaddata_paired	Firmicutes_A	14608	P	8973720	60858	9034578	0.92198
ERR1762115_1_kneaddata_paired	Firmicutes	12188	P	602949	24717	627666	0.06405
ERR1762115_1_kneaddata_paired	Actinobacteriota	615	P	107679	263	107942	0.01102
ERR1762115_1_kneaddata_paired	Bacteroidota	4587	P	16864	497	17361	0.00177
ERR1762115_1_kneaddata_paired	Cyanobacteria	9876	P	3605	36	3641	0.00037
ERR1762115_1_kneaddata_paired	Verrucomicrobiota	33333	P	1689	188	1877	0.00019
ERR1762115_1_kneaddata_paired	Spirochaetota	32587	P	1599	11	1610	0.00016
ERR1762115_1_kneaddata_paired	Desulfobacterota_A	11509	P	1549	433	1982	0.00020
ERR1762115_1_kneaddata_paired	Proteobacteria	22518	P	1335	14	1349	0.00014
ERR1762115_1_kneaddata_paired	Firmicutes_B	17289	P	579	45	624	0.00006
ERR1762115_1_kneaddata_paired	Campylobacterota	8700	P	192	0	192	0.00002
ERR1762115_1_kneaddata_paired	Firmicutes_I	18140	P	125	0	125	0.00001
ERR1762115_1_kneaddata_paired	Firmicutes_C	17613	P	94	0	94	0.00001
ERR1762115_1_kneaddata_paired	Deferribacterota	10822	P	27	0	27	0.00000
ERR1762115_1_kneaddata_paired	Thermotogota	33086	P	8	0	8	0.00000
ERR1762115_1_kneaddata_paired	Elusimicrobiota	11888	P	7	0	7	0.00000
ERR1762116_1_kneaddata_paired	Firmicutes_A	14608	P	8930275	60403	8990678	0.92182
ERR1762116_1_kneaddata_paired	Firmicutes	12188	P	601230	24553	625783	0.06416
ERR1762116_1_kneaddata_paired	Actinobacteriota	615	P	107878	263	108141	0.01109
ERR1762116_1_kneaddata_paired	Bacteroidota	4587	P	17008	497	17505	0.00179
ERR1762116_1_kneaddata_paired	Cyanobacteria	9876	P	3482	38	3520	0.00036
ERR1762116_1_kneaddata_paired	Verrucomicrobiota	33333	P	1677	184	1861	0.00019
ERR1762116_1_kneaddata_paired	Spirochaetota	32587	P	1507	10	1517	0.00016
ERR1762116_1_kneaddata_paired	Desulfobacterota_A	11509	P	1409	394	1803	0.00018
ERR1762116_1_kneaddata_paired	Proteobacteria	22518	P	1272	13	1285	0.00013
ERR1762116_1_kneaddata_paired	Firmicutes_B	17289	P	574	44	618	0.00006
ERR1762116_1_kneaddata_paired	Campylobacterota	8700	P	200	0	200	0.00002
ERR1762116_1_kneaddata_paired	Firmicutes_I	18140	P	109	0	109	0.00001
ERR1762116_1_kneaddata_paired	Firmicutes_C	17613	P	98	0	98	0.00001
ERR1762116_1_kneaddata_paired	Deferribacterota	10822	P	39	0	39	0.00000
ERR1762116_1_kneaddata_paired	Elusimicrobiota	11888	P	16	0	16	0.00000
ERR1762116_1_kneaddata_paired	Thermotogota	33086	P	15	0	15	0.00000
ERR1762117_1_kneaddata_paired	Firmicutes_A	14608	P	8947759	60579	9008338	0.92162
ERR1762117_1_kneaddata_paired	Firmicutes	12188	P	605239	24628	629867	0.06444
ERR1762117_1_kneaddata_paired	Actinobacteriota	615	P	107317	260	107577	0.01101
ERR1762117_1_kneaddata_paired	Bacteroidota	4587	P	16934	507	17441	0.00178
ERR1762117_1_kneaddata_paired	Cyanobacteria	9876	P	3612	37	3649	0.00037
ERR1762117_1_kneaddata_paired	Verrucomicrobiota	33333	P	1682	185	1867	0.00019
ERR1762117_1_kneaddata_paired	Spirochaetota	32587	P	1525	10	1535	0.00016
ERR1762117_1_kneaddata_paired	Desulfobacterota_A	11509	P	1471	424	1895	0.00019
ERR1762117_1_kneaddata_paired	Proteobacteria	22518	P	1260	13	1273	0.00013
ERR1762117_1_kneaddata_paired	Firmicutes_B	17289	P	561	43	604	0.00006
ERR1762117_1_kneaddata_paired	Campylobacterota	8700	P	195	0	195	0.00002
ERR1762117_1_kneaddata_paired	Firmicutes_I	18140	P	110	0	110	0.00001
ERR1762117_1_kneaddata_paired	Firmicutes_C	17613	P	86	0	86	0.00001
ERR1762117_1_kneaddata_paired	Deferribacterota	10822	P	27	0	27	0.00000
ERR1762117_1_kneaddata_paired	Elusimicrobiota	11888	P	13	0	13	0.00000
ERR1762117_1_kneaddata_paired	Thermotogota	33086	P	7	0	7	0.00000
ERR1762118_1_kneaddata_paired	Firmicutes_A	14608	P	8942472	60640	9003112	0.92164
ERR1762118_1_kneaddata_paired	Firmicutes	12188	P	604171	24679	628850	0.06437
ERR1762118_1_kneaddata_paired	Actinobacteriota	615	P	107215	260	107475	0.01100
ERR1762118_1_kneaddata_paired	Bacteroidota	4587	P	17226	509	17735	0.00182
ERR1762118_1_kneaddata_paired	Cyanobacteria	9876	P	3580	36	3616	0.00037
ERR1762118_1_kneaddata_paired	Verrucomicrobiota	33333	P	1692	188	1880	0.00019
ERR1762118_1_kneaddata_paired	Spirochaetota	32587	P	1540	10	1550	0.00016
ERR1762118_1_kneaddata_paired	Desulfobacterota_A	11509	P	1497	433	1930	0.00020
ERR1762118_1_kneaddata_paired	Proteobacteria	22518	P	1301	12	1313	0.00013
ERR1762118_1_kneaddata_paired	Firmicutes_B	17289	P	588	46	634	0.00006
ERR1762118_1_kneaddata_paired	Campylobacterota	8700	P	213	0	213	0.00002
ERR1762118_1_kneaddata_paired	Firmicutes_I	18140	P	108	0	108	0.00001
ERR1762118_1_kneaddata_paired	Firmicutes_C	17613	P	75	0	75	0.00001
ERR1762118_1_kneaddata_paired	Deferribacterota	10822	P	31	0	31	0.00000
ERR1762118_1_kneaddata_paired	Elusimicrobiota	11888	P	17	0	17	0.00000
ERR1762118_1_kneaddata_paired	Thermotogota	33086	P	9	0	9	0.00000
ERR1762119_1_kneaddata_paired	Firmicutes_A	14608	P	8719405	40082	8759487	0.70032
ERR1762119_1_kneaddata_paired	Firmicutes	12188	P	3021472	90107	3111579	0.24877
ERR1762119_1_kneaddata_paired	Actinobacteriota	615	P	601156	921	602077	0.04814
ERR1762119_1_kneaddata_paired	Bacteroidota	4587	P	13832	162	13994	0.00112
ERR1762119_1_kneaddata_paired	Spirochaetota	32587	P	5403	28	5431	0.00043
ERR1762119_1_kneaddata_paired	Cyanobacteria	9876	P	4686	50	4736	0.00038
ERR1762119_1_kneaddata_paired	Verrucomicrobiota	33333	P	2864	186	3050	0.00024
ERR1762119_1_kneaddata_paired	Proteobacteria	22518	P	2061	14	2075	0.00017
ERR1762119_1_kneaddata_paired	Desulfobacterota_A	11509	P	1924	322	2246	0.00018
ERR1762119_1_kneaddata_paired	Firmicutes_B	17289	P	1893	83	1976	0.00016
ERR1762119_1_kneaddata_paired	Campylobacterota	8700	P	751	0	751	0.00006
ERR1762119_1_kneaddata_paired	Firmicutes_I	18140	P	312	0	312	0.00002
ERR1762119_1_kneaddata_paired	Firmicutes_C	17613	P	76	0	76	0.00001
ERR1762119_1_kneaddata_paired	Elusimicrobiota	11888	P	27	0	27	0.00000
ERR1762119_1_kneaddata_paired	Deferribacterota	10822	P	17	0	17	0.00000
ERR1762119_1_kneaddata_paired	Thermotogota	33086	P	11	0	11	0.00000
ERR1762120_1_kneaddata_paired	Firmicutes_A	14608	P	8693024	39956	8732980	0.70030
ERR1762120_1_kneaddata_paired	Firmicutes	12188	P	3011647	89790	3101437	0.24871
ERR1762120_1_kneaddata_paired	Actinobacteriota	615	P	599914	922	600836	0.04818
ERR1762120_1_kneaddata_paired	Bacteroidota	4587	P	14031	164	14195	0.00114
ERR1762120_1_kneaddata_paired	Spirochaetota	32587	P	5595	29	5624	0.00045
ERR1762120_1_kneaddata_paired	Cyanobacteria	9876	P	4554	49	4603	0.00037
ERR1762120_1_kneaddata_paired	Verrucomicrobiota	33333	P	3090	197	3287	0.00026
ERR1762120_1_kneaddata_paired	Proteobacteria	22518	P	1996	13	2009	0.00016
ERR1762120_1_kneaddata_paired	Desulfobacterota_A	11509	P	1833	305	2138	0.00017
ERR1762120_1_kneaddata_paired	Firmicutes_B	17289	P	1808	79	1887	0.00015
ERR1762120_1_kneaddata_paired	Campylobacterota	8700	P	805	0	805	0.00006
ERR1762120_1_kneaddata_paired	Firmicutes_I	18140	P	309	0	309	0.00002
ERR1762120_1_kneaddata_paired	Firmicutes_C	17613	P	69	0	69	0.00001
ERR1762120_1_kneaddata_paired	Deferribacterota	10822	P	32	0	32	0.00000
ERR1762120_1_kneaddata_paired	Elusimicrobiota	11888	P	28	0	28	0.00000
ERR1762120_1_kneaddata_paired	Thermotogota	33086	P	18	0	18	0.00000
ERR1762121_1_kneaddata_paired	Firmicutes_A	14608	P	8717369	40049	8757418	0.70046
ERR1762121_1_kneaddata_paired	Firmicutes	12188	P	3023890	90153	3114043	0.24908
ERR1762121_1_kneaddata_paired	Actinobacteriota	615	P	595001	915	595916	0.04766
ERR1762121_1_kneaddata_paired	Bacteroidota	4587	P	13987	162	14149	0.00113
ERR1762121_1_kneaddata_paired	Spirochaetota	32587	P	5519	29	5548	0.00044
ERR1762121_1_kneaddata_paired	Cyanobacteria	9876	P	4639	50	4689	0.00038
ERR1762121_1_kneaddata_paired	Verrucomicrobiota	33333	P	3016	197	3213	0.00026
ERR1762121_1_kneaddata_paired	Proteobacteria	22518	P	2118	13	2131	0.00017
ERR1762121_1_kneaddata_paired	Firmicutes_B	17289	P	1833	80	1913	0.00015
ERR1762121_1_kneaddata_paired	Desulfobacterota_A	11509	P	1763	295	2058	0.00016
ERR1762121_1_kneaddata_paired	Campylobacterota	8700	P	822	0	822	0.00007
ERR1762121_1_kneaddata_paired	Firmicutes_I	18140	P	305	0	305	0.00002
ERR1762121_1_kneaddata_paired	Firmicutes_C	17613	P	86	0	86	0.00001
ERR1762121_1_kneaddata_paired	Deferribacterota	10822	P	27	0	27	0.00000
ERR1762121_1_kneaddata_paired	Elusimicrobiota	11888	P	24	0	24	0.00000
ERR1762121_1_kneaddata_paired	Thermotogota	33086	P	7	0	7	0.00000
ERR1762122_1_kneaddata_paired	Firmicutes_A	14608	P	8707065	40205	8747270	0.70048
ERR1762122_1_kneaddata_paired	Firmicutes	12188	P	3018443	90434	3108877	0.24896
ERR1762122_1_kneaddata_paired	Actinobacteriota	615	P	595518	921	596439	0.04776
ERR1762122_1_kneaddata_paired	Bacteroidota	4587	P	14118	167	14285	0.00114
ERR1762122_1_kneaddata_paired	Spirochaetota	32587	P	5457	28	5485	0.00044
ERR1762122_1_kneaddata_paired	Cyanobacteria	9876	P	4640	49	4689	0.00038
ERR1762122_1_kneaddata_paired	Verrucomicrobiota	33333	P	3011	191	3202	0.00026
ERR1762122_1_kneaddata_paired	Proteobacteria	22518	P	1993	14	2007	0.00016
ERR1762122_1_kneaddata_paired	Desulfobacterota_A	11509	P	1876	311	2187	0.00018
ERR1762122_1_kneaddata_paired	Firmicutes_B	17289	P	1862	82	1944	0.00016
ERR1762122_1_kneaddata_paired	Campylobacterota	8700	P	735	0	735	0.00006
ERR1762122_1_kneaddata_paired	Firmicutes_I	18140	P	312	0	312	0.00002
ERR1762122_1_kneaddata_paired	Firmicutes_C	17613	P	77	0	77	0.00001
ERR1762122_1_kneaddata_paired	Elusimicrobiota	11888	P	34	0	34	0.00000
ERR1762122_1_kneaddata_paired	Deferribacterota	10822	P	26	0	26	0.00000
ERR1762122_1_kneaddata_paired	Thermotogota	33086	P	8	0	8	0.00000
ERR1806394_1_kneaddata_paired	Firmicutes_A	14608	P	3009931	20085	3030016	0.65190
ERR1806394_1_kneaddata_paired	Bacteroidota	4587	P	993565	7949	1001514	0.21547
ERR1806394_1_kneaddata_paired	Firmicutes	12188	P	274799	2340	277139	0.05963
ERR1806394_1_kneaddata_paired	Desulfobacterota_A	11509	P	108941	652	109593	0.02358
ERR1806394_1_kneaddata_paired	Deferribacterota	10822	P	84084	13	84097	0.01809
ERR1806394_1_kneaddata_paired	Verrucomicrobiota	33333	P	83416	407	83823	0.01803
ERR1806394_1_kneaddata_paired	Campylobacterota	8700	P	32718	1	32719	0.00704
ERR1806394_1_kneaddata_paired	Actinobacteriota	615	P	13854	43	13897	0.00299
ERR1806394_1_kneaddata_paired	Cyanobacteria	9876	P	9200	38	9238	0.00199
ERR1806394_1_kneaddata_paired	Proteobacteria	22518	P	4881	34	4915	0.00106
ERR1806394_1_kneaddata_paired	Spirochaetota	32587	P	434	0	434	0.00009
ERR1806394_1_kneaddata_paired	Firmicutes_B	17289	P	358	14	372	0.00008
ERR1806394_1_kneaddata_paired	Firmicutes_I	18140	P	138	0	138	0.00003
ERR1806394_1_kneaddata_paired	Firmicutes_C	17613	P	102	0	102	0.00002
ERR1806394_1_kneaddata_paired	Elusimicrobiota	11888	P	4	0	4	0.00000
ERR1806394_1_kneaddata_paired	Thermotogota	33086	P	2	0	2	0.00000
ERR1806395_1_kneaddata_paired	Firmicutes_A	14608	P	7149188	118142	7267330	0.82495
ERR1806395_1_kneaddata_paired	Bacteroidota	4587	P	1041846	24737	1066583	0.12107
ERR1806395_1_kneaddata_paired	Desulfobacterota_A	11509	P	305951	10308	316259	0.03590
ERR1806395_1_kneaddata_paired	Firmicutes	12188	P	90842	2611	93453	0.01061
ERR1806395_1_kneaddata_paired	Verrucomicrobiota	33333	P	18846	664	19510	0.00221
ERR1806395_1_kneaddata_paired	Deferribacterota	10822	P	12059	4	12063	0.00137
ERR1806395_1_kneaddata_paired	Actinobacteriota	615	P	10420	68	10488	0.00119
ERR1806395_1_kneaddata_paired	Proteobacteria	22518	P	10402	177	10579	0.00120
ERR1806395_1_kneaddata_paired	Campylobacterota	8700	P	8947	1	8948	0.00102
ERR1806395_1_kneaddata_paired	Cyanobacteria	9876	P	3541	49	3590	0.00041
ERR1806395_1_kneaddata_paired	Spirochaetota	32587	P	215	0	215	0.00002
ERR1806395_1_kneaddata_paired	Firmicutes_B	17289	P	191	20	211	0.00002
ERR1806395_1_kneaddata_paired	Firmicutes_C	17613	P	137	0	137	0.00002
ERR1806395_1_kneaddata_paired	Firmicutes_I	18140	P	41	0	41	0.00000
ERR1806395_1_kneaddata_paired	Elusimicrobiota	11888	P	1	0	1	0.00000
ERR1806395_1_kneaddata_paired	Thermotogota	33086	P	1	0	1	0.00000
ERR192252_1_kneaddata_paired	Firmicutes_A	14608	P	2483230	14972	2498202	0.60835
ERR192252_1_kneaddata_paired	Bacteroidota	4587	P	927983	10048	938031	0.22843
ERR192252_1_kneaddata_paired	Campylobacterota	8700	P	283496	29	283525	0.06904
ERR192252_1_kneaddata_paired	Firmicutes	12188	P	251635	1461	253096	0.06163
ERR192252_1_kneaddata_paired	Desulfobacterota_A	11509	P	49127	502	49629	0.01209
ERR192252_1_kneaddata_paired	Deferribacterota	10822	P	43106	4	43110	0.01050
ERR192252_1_kneaddata_paired	Actinobacteriota	615	P	25820	131	25951	0.00632
ERR192252_1_kneaddata_paired	Proteobacteria	22518	P	11664	18	11682	0.00284
ERR192252_1_kneaddata_paired	Cyanobacteria	9876	P	2393	99	2492	0.00061
ERR192252_1_kneaddata_paired	Verrucomicrobiota	33333	P	297	9	306	0.00007
ERR192252_1_kneaddata_paired	Spirochaetota	32587	P	252	0	252	0.00006
ERR192252_1_kneaddata_paired	Firmicutes_B	17289	P	129	4	133	0.00003
ERR192252_1_kneaddata_paired	Firmicutes_C	17613	P	40	0	40	0.00001
ERR192252_1_kneaddata_paired	Firmicutes_I	18140	P	34	0	34	0.00001
ERR192252_1_kneaddata_paired	Thermotogota	33086	P	23	0	23	0.00001
ERR192252_1_kneaddata_paired	Elusimicrobiota	11888	P	6	0	6	0.00000
ERR192254_1_kneaddata_paired	Bacteroidota	4587	P	2854787	27693	2882480	0.60658
ERR192254_1_kneaddata_paired	Firmicutes_A	14608	P	1374181	8880	1383061	0.29105
ERR192254_1_kneaddata_paired	Firmicutes	12188	P	322152	2274	324426	0.06827
ERR192254_1_kneaddata_paired	Verrucomicrobiota	33333	P	62903	465	63368	0.01334
ERR192254_1_kneaddata_paired	Campylobacterota	8700	P	36003	2	36005	0.00758
ERR192254_1_kneaddata_paired	Desulfobacterota_A	11509	P	20526	225	20751	0.00437
ERR192254_1_kneaddata_paired	Actinobacteriota	615	P	18677	81	18758	0.00395
ERR192254_1_kneaddata_paired	Proteobacteria	22518	P	13736	25	13761	0.00290
ERR192254_1_kneaddata_paired	Cyanobacteria	9876	P	5399	216	5615	0.00118
ERR192254_1_kneaddata_paired	Deferribacterota	10822	P	3570	0	3570	0.00075
ERR192254_1_kneaddata_paired	Spirochaetota	32587	P	80	0	80	0.00002
ERR192254_1_kneaddata_paired	Firmicutes_B	17289	P	63	2	65	0.00001
ERR192254_1_kneaddata_paired	Firmicutes_C	17613	P	16	0	16	0.00000
ERR192254_1_kneaddata_paired	Firmicutes_I	18140	P	15	0	15	0.00000
ERR192254_1_kneaddata_paired	Thermotogota	33086	P	9	0	9	0.00000
ERR192254_1_kneaddata_paired	Elusimicrobiota	11888	P	2	0	2	0.00000
ERR192256_1_kneaddata_paired	Bacteroidota	4587	P	2208136	20099	2228235	0.46597
ERR192256_1_kneaddata_paired	Firmicutes_A	14608	P	2206063	13193	2219256	0.46409
ERR192256_1_kneaddata_paired	Firmicutes	12188	P	193164	1178	194342	0.04064
ERR192256_1_kneaddata_paired	Campylobacterota	8700	P	51451	2	51453	0.01076
ERR192256_1_kneaddata_paired	Actinobacteriota	615	P	30400	63	30463	0.00637
ERR192256_1_kneaddata_paired	Desulfobacterota_A	11509	P	27975	253	28228	0.00590
ERR192256_1_kneaddata_paired	Proteobacteria	22518	P	17964	28	17992	0.00376
ERR192256_1_kneaddata_paired	Deferribacterota	10822	P	9888	0	9888	0.00207
ERR192256_1_kneaddata_paired	Cyanobacteria	9876	P	1717	65	1782	0.00037
ERR192256_1_kneaddata_paired	Spirochaetota	32587	P	103	0	103	0.00002
ERR192256_1_kneaddata_paired	Verrucomicrobiota	33333	P	72	2	74	0.00002
ERR192256_1_kneaddata_paired	Firmicutes_B	17289	P	68	2	70	0.00001
ERR192256_1_kneaddata_paired	Firmicutes_C	17613	P	37	0	37	0.00001
ERR192256_1_kneaddata_paired	Firmicutes_I	18140	P	17	0	17	0.00000
ERR192256_1_kneaddata_paired	Elusimicrobiota	11888	P	1	0	1	0.00000
ERR192256_1_kneaddata_paired	Thermotogota	33086	P	1	0	1	0.00000
ERR192258_1_kneaddata_paired	Firmicutes_A	14608	P	2590661	13076	2603737	0.55161
ERR192258_1_kneaddata_paired	Bacteroidota	4587	P	1579142	16838	1595980	0.33811
ERR192258_1_kneaddata_paired	Firmicutes	12188	P	172165	1548	173713	0.03680
ERR192258_1_kneaddata_paired	Campylobacterota	8700	P	128659	5	128664	0.02726
ERR192258_1_kneaddata_paired	Desulfobacterota_A	11509	P	69200	698	69898	0.01481
ERR192258_1_kneaddata_paired	Verrucomicrobiota	33333	P	57157	769	57926	0.01227
ERR192258_1_kneaddata_paired	Proteobacteria	22518	P	42900	56	42956	0.00910
ERR192258_1_kneaddata_paired	Deferribacterota	10822	P	28639	2	28641	0.00607
ERR192258_1_kneaddata_paired	Actinobacteriota	615	P	12007	50	12057	0.00255
ERR192258_1_kneaddata_paired	Cyanobacteria	9876	P	6154	52	6206	0.00131
ERR192258_1_kneaddata_paired	Firmicutes_B	17289	P	213	7	220	0.00005
ERR192258_1_kneaddata_paired	Spirochaetota	32587	P	156	0	156	0.00003
ERR192258_1_kneaddata_paired	Firmicutes_C	17613	P	32	0	32	0.00001
ERR192258_1_kneaddata_paired	Firmicutes_I	18140	P	21	0	21	0.00000
ERR192258_1_kneaddata_paired	Thermotogota	33086	P	16	0	16	0.00000
ERR192258_1_kneaddata_paired	Elusimicrobiota	11888	P	7	0	7	0.00000
ERR2011065_1_kneaddata_paired	Firmicutes_A	14608	P	6222938	39291	6262229	0.49173
ERR2011065_1_kneaddata_paired	Bacteroidota	4587	P	5174257	117669	5291926	0.41554
ERR2011065_1_kneaddata_paired	Firmicutes	12188	P	809854	3001	812855	0.06383
ERR2011065_1_kneaddata_paired	Actinobacteriota	615	P	359303	316	359619	0.02824
ERR2011065_1_kneaddata_paired	Verrucomicrobiota	33333	P	2611	136	2747	0.00022
ERR2011065_1_kneaddata_paired	Cyanobacteria	9876	P	2003	77	2080	0.00016
ERR2011065_1_kneaddata_paired	Desulfobacterota_A	11509	P	1344	170	1514	0.00012
ERR2011065_1_kneaddata_paired	Firmicutes_B	17289	P	1208	39	1247	0.00010
ERR2011065_1_kneaddata_paired	Proteobacteria	22518	P	515	4	519	0.00004
ERR2011065_1_kneaddata_paired	Spirochaetota	32587	P	203	0	203	0.00002
ERR2011065_1_kneaddata_paired	Firmicutes_I	18140	P	88	0	88	0.00001
ERR2011065_1_kneaddata_paired	Firmicutes_C	17613	P	60	0	60	0.00000
ERR2011065_1_kneaddata_paired	Campylobacterota	8700	P	54	0	54	0.00000
ERR2011065_1_kneaddata_paired	Deferribacterota	10822	P	37	0	37	0.00000
ERR2011065_1_kneaddata_paired	Elusimicrobiota	11888	P	15	0	15	0.00000
ERR2011065_1_kneaddata_paired	Thermotogota	33086	P	9	0	9	0.00000
ERR2011066_1_kneaddata_paired	Firmicutes_A	14608	P	7313103	45336	7358439	0.71880
ERR2011066_1_kneaddata_paired	Bacteroidota	4587	P	2257135	47172	2304307	0.22509
ERR2011066_1_kneaddata_paired	Firmicutes	12188	P	365221	1258	366479	0.03580
ERR2011066_1_kneaddata_paired	Actinobacteriota	615	P	198971	169	199140	0.01945
ERR2011066_1_kneaddata_paired	Verrucomicrobiota	33333	P	3616	183	3799	0.00037
ERR2011066_1_kneaddata_paired	Desulfobacterota_A	11509	P	1687	206	1893	0.00018
ERR2011066_1_kneaddata_paired	Cyanobacteria	9876	P	1014	31	1045	0.00010
ERR2011066_1_kneaddata_paired	Firmicutes_B	17289	P	989	30	1019	0.00010
ERR2011066_1_kneaddata_paired	Proteobacteria	22518	P	580	10	590	0.00006
ERR2011066_1_kneaddata_paired	Spirochaetota	32587	P	143	0	143	0.00001
ERR2011066_1_kneaddata_paired	Firmicutes_I	18140	P	93	0	93	0.00001
ERR2011066_1_kneaddata_paired	Campylobacterota	8700	P	78	0	78	0.00001
ERR2011066_1_kneaddata_paired	Deferribacterota	10822	P	38	0	38	0.00000
ERR2011066_1_kneaddata_paired	Firmicutes_C	17613	P	35	0	35	0.00000
ERR2011066_1_kneaddata_paired	Elusimicrobiota	11888	P	13	0	13	0.00000
ERR2011066_1_kneaddata_paired	Thermotogota	33086	P	4	0	4	0.00000
ERR2011067_1_kneaddata_paired	Firmicutes_A	14608	P	7734355	50653	7785008	0.68162
ERR2011067_1_kneaddata_paired	Bacteroidota	4587	P	2896260	64996	2961256	0.25927
ERR2011067_1_kneaddata_paired	Firmicutes	12188	P	469789	1550	471339	0.04127
ERR2011067_1_kneaddata_paired	Actinobacteriota	615	P	193021	165	193186	0.01691
ERR2011067_1_kneaddata_paired	Verrucomicrobiota	33333	P	3704	186	3890	0.00034
ERR2011067_1_kneaddata_paired	Desulfobacterota_A	11509	P	1983	249	2232	0.00020
ERR2011067_1_kneaddata_paired	Cyanobacteria	9876	P	1707	44	1751	0.00015
ERR2011067_1_kneaddata_paired	Firmicutes_B	17289	P	1535	47	1582	0.00014
ERR2011067_1_kneaddata_paired	Proteobacteria	22518	P	471	2	473	0.00004
ERR2011067_1_kneaddata_paired	Spirochaetota	32587	P	399	1	400	0.00004
ERR2011067_1_kneaddata_paired	Firmicutes_I	18140	P	91	0	91	0.00001
ERR2011067_1_kneaddata_paired	Campylobacterota	8700	P	70	0	70	0.00001
ERR2011067_1_kneaddata_paired	Firmicutes_C	17613	P	63	0	63	0.00001
ERR2011067_1_kneaddata_paired	Deferribacterota	10822	P	40	0	40	0.00000
ERR2011067_1_kneaddata_paired	Elusimicrobiota	11888	P	18	0	18	0.00000
ERR2011067_1_kneaddata_paired	Thermotogota	33086	P	5	0	5	0.00000
ERR2011068_1_kneaddata_paired	Firmicutes_A	14608	P	6896447	37192	6933639	0.75912
ERR2011068_1_kneaddata_paired	Bacteroidota	4587	P	1880995	39694	1920689	0.21028
ERR2011068_1_kneaddata_paired	Firmicutes	12188	P	168607	1224	169831	0.01859
ERR2011068_1_kneaddata_paired	Actinobacteriota	615	P	94648	88	94736	0.01037
ERR2011068_1_kneaddata_paired	Verrucomicrobiota	33333	P	9673	509	10182	0.00111
ERR2011068_1_kneaddata_paired	Desulfobacterota_A	11509	P	1542	207	1749	0.00019
ERR2011068_1_kneaddata_paired	Cyanobacteria	9876	P	1131	32	1163	0.00013
ERR2011068_1_kneaddata_paired	Firmicutes_B	17289	P	727	24	751	0.00008
ERR2011068_1_kneaddata_paired	Proteobacteria	22518	P	382	6	388	0.00004
ERR2011068_1_kneaddata_paired	Campylobacterota	8700	P	284	0	284	0.00003
ERR2011068_1_kneaddata_paired	Spirochaetota	32587	P	142	0	142	0.00002
ERR2011068_1_kneaddata_paired	Firmicutes_I	18140	P	122	0	122	0.00001
ERR2011068_1_kneaddata_paired	Firmicutes_C	17613	P	34	0	34	0.00000
ERR2011068_1_kneaddata_paired	Deferribacterota	10822	P	25	0	25	0.00000
ERR2011068_1_kneaddata_paired	Thermotogota	33086	P	12	0	12	0.00000
ERR2011068_1_kneaddata_paired	Elusimicrobiota	11888	P	7	0	7	0.00000
ERR2011069_1_kneaddata_paired	Firmicutes_A	14608	P	7333814	43284	7377098	0.65332
ERR2011069_1_kneaddata_paired	Bacteroidota	4587	P	3037912	73365	3111277	0.27554
ERR2011069_1_kneaddata_paired	Firmicutes	12188	P	554361	2085	556446	0.04928
ERR2011069_1_kneaddata_paired	Actinobacteriota	615	P	236665	226	236891	0.02098
ERR2011069_1_kneaddata_paired	Verrucomicrobiota	33333	P	3777	210	3987	0.00035
ERR2011069_1_kneaddata_paired	Firmicutes_B	17289	P	1820	62	1882	0.00017
ERR2011069_1_kneaddata_paired	Desulfobacterota_A	11509	P	1756	235	1991	0.00018
ERR2011069_1_kneaddata_paired	Cyanobacteria	9876	P	1137	37	1174	0.00010
ERR2011069_1_kneaddata_paired	Proteobacteria	22518	P	492	3	495	0.00004
ERR2011069_1_kneaddata_paired	Spirochaetota	32587	P	183	0	183	0.00002
ERR2011069_1_kneaddata_paired	Firmicutes_I	18140	P	132	0	132	0.00001
ERR2011069_1_kneaddata_paired	Campylobacterota	8700	P	81	0	81	0.00001
ERR2011069_1_kneaddata_paired	Deferribacterota	10822	P	40	0	40	0.00000
ERR2011069_1_kneaddata_paired	Firmicutes_C	17613	P	39	0	39	0.00000
ERR2011069_1_kneaddata_paired	Elusimicrobiota	11888	P	12	0	12	0.00000
ERR2011069_1_kneaddata_paired	Thermotogota	33086	P	8	0	8	0.00000
ERR2011070_1_kneaddata_paired	Firmicutes_A	14608	P	3640006	27821	3667827	0.60206
ERR2011070_1_kneaddata_paired	Firmicutes	12188	P	1047134	3902	1051036	0.17252
ERR2011070_1_kneaddata_paired	Bacteroidota	4587	P	970772	19472	990244	0.16255
ERR2011070_1_kneaddata_paired	Actinobacteriota	615	P	379621	312	379933	0.06236
ERR2011070_1_kneaddata_paired	Firmicutes_B	17289	P	672	20	692	0.00011
ERR2011070_1_kneaddata_paired	Desulfobacterota_A	11509	P	620	74	694	0.00011
ERR2011070_1_kneaddata_paired	Cyanobacteria	9876	P	584	14	598	0.00010
ERR2011070_1_kneaddata_paired	Verrucomicrobiota	33333	P	368	17	385	0.00006
ERR2011070_1_kneaddata_paired	Proteobacteria	22518	P	352	1	353	0.00006
ERR2011070_1_kneaddata_paired	Spirochaetota	32587	P	180	0	180	0.00003
ERR2011070_1_kneaddata_paired	Firmicutes_I	18140	P	67	0	67	0.00001
ERR2011070_1_kneaddata_paired	Campylobacterota	8700	P	48	0	48	0.00001
ERR2011070_1_kneaddata_paired	Deferribacterota	10822	P	33	0	33	0.00001
ERR2011070_1_kneaddata_paired	Firmicutes_C	17613	P	14	0	14	0.00000
ERR2011070_1_kneaddata_paired	Elusimicrobiota	11888	P	10	0	10	0.00000
ERR2011070_1_kneaddata_paired	Thermotogota	33086	P	5	0	5	0.00000
ERR2011071_1_kneaddata_paired	Bacteroidota	4587	P	4053054	31539	4084593	0.45857
ERR2011071_1_kneaddata_paired	Firmicutes_A	14608	P	3235074	7921	3242995	0.36408
ERR2011071_1_kneaddata_paired	Verrucomicrobiota	33333	P	955691	27670	983361	0.11040
ERR2011071_1_kneaddata_paired	Firmicutes	12188	P	314645	1324	315969	0.03547
ERR2011071_1_kneaddata_paired	Actinobacteriota	615	P	275865	183	276048	0.03099
ERR2011071_1_kneaddata_paired	Firmicutes_B	17289	P	1462	27	1489	0.00017
ERR2011071_1_kneaddata_paired	Cyanobacteria	9876	P	1325	19	1344	0.00015
ERR2011071_1_kneaddata_paired	Proteobacteria	22518	P	549	1	550	0.00006
ERR2011071_1_kneaddata_paired	Desulfobacterota_A	11509	P	397	23	420	0.00005
ERR2011071_1_kneaddata_paired	Spirochaetota	32587	P	209	0	209	0.00002
ERR2011071_1_kneaddata_paired	Campylobacterota	8700	P	186	0	186	0.00002
ERR2011071_1_kneaddata_paired	Firmicutes_I	18140	P	66	0	66	0.00001
ERR2011071_1_kneaddata_paired	Deferribacterota	10822	P	42	0	42	0.00000
ERR2011071_1_kneaddata_paired	Firmicutes_C	17613	P	20	0	20	0.00000
ERR2011071_1_kneaddata_paired	Elusimicrobiota	11888	P	7	0	7	0.00000
ERR2011071_1_kneaddata_paired	Thermotogota	33086	P	2	0	2	0.00000
ERR2011072_1_kneaddata_paired	Firmicutes_A	14608	P	4198258	14424	4212682	0.49298
ERR2011072_1_kneaddata_paired	Bacteroidota	4587	P	3076023	29026	3105049	0.36336
ERR2011072_1_kneaddata_paired	Verrucomicrobiota	33333	P	630410	22962	653372	0.07646
ERR2011072_1_kneaddata_paired	Firmicutes	12188	P	411835	1394	413229	0.04836
ERR2011072_1_kneaddata_paired	Actinobacteriota	615	P	157599	222	157821	0.01847
ERR2011072_1_kneaddata_paired	Cyanobacteria	9876	P	988	20	1008	0.00012
ERR2011072_1_kneaddata_paired	Desulfobacterota_A	11509	P	506	43	549	0.00006
ERR2011072_1_kneaddata_paired	Firmicutes_B	17289	P	480	11	491	0.00006
ERR2011072_1_kneaddata_paired	Proteobacteria	22518	P	394	2	396	0.00005
ERR2011072_1_kneaddata_paired	Campylobacterota	8700	P	382	0	382	0.00004
ERR2011072_1_kneaddata_paired	Firmicutes_I	18140	P	119	0	119	0.00001
ERR2011072_1_kneaddata_paired	Spirochaetota	32587	P	109	0	109	0.00001
ERR2011072_1_kneaddata_paired	Firmicutes_C	17613	P	23	0	23	0.00000
ERR2011072_1_kneaddata_paired	Deferribacterota	10822	P	20	0	20	0.00000
ERR2011072_1_kneaddata_paired	Elusimicrobiota	11888	P	7	0	7	0.00000
ERR2011072_1_kneaddata_paired	Thermotogota	33086	P	4	0	4	0.00000
ERR2011073_1_kneaddata_paired	Firmicutes_A	14608	P	5376860	16145	5393005	0.58215
ERR2011073_1_kneaddata_paired	Bacteroidota	4587	P	2703132	19377	2722509	0.29388
ERR2011073_1_kneaddata_paired	Verrucomicrobiota	33333	P	434160	16741	450901	0.04867
ERR2011073_1_kneaddata_paired	Firmicutes	12188	P	393130	1753	394883	0.04263
ERR2011073_1_kneaddata_paired	Actinobacteriota	615	P	298109	490	298599	0.03223
ERR2011073_1_kneaddata_paired	Cyanobacteria	9876	P	905	16	921	0.00010
ERR2011073_1_kneaddata_paired	Firmicutes_B	17289	P	832	20	852	0.00009
ERR2011073_1_kneaddata_paired	Desulfobacterota_A	11509	P	685	60	745	0.00008
ERR2011073_1_kneaddata_paired	Campylobacterota	8700	P	634	0	634	0.00007
ERR2011073_1_kneaddata_paired	Proteobacteria	22518	P	515	3	518	0.00006
ERR2011073_1_kneaddata_paired	Firmicutes_I	18140	P	189	0	189	0.00002
ERR2011073_1_kneaddata_paired	Spirochaetota	32587	P	119	0	119	0.00001
ERR2011073_1_kneaddata_paired	Firmicutes_C	17613	P	36	0	36	0.00000
ERR2011073_1_kneaddata_paired	Deferribacterota	10822	P	22	0	22	0.00000
ERR2011073_1_kneaddata_paired	Elusimicrobiota	11888	P	13	0	13	0.00000
ERR2011073_1_kneaddata_paired	Thermotogota	33086	P	1	0	1	0.00000
ERR2011074_1_kneaddata_paired	Firmicutes_A	14608	P	5402246	20324	5422570	0.59078
ERR2011074_1_kneaddata_paired	Bacteroidota	4587	P	2298990	17332	2316322	0.25236
ERR2011074_1_kneaddata_paired	Verrucomicrobiota	33333	P	610265	21227	631492	0.06880
ERR2011074_1_kneaddata_paired	Actinobacteriota	615	P	418372	537	418909	0.04564
ERR2011074_1_kneaddata_paired	Firmicutes	12188	P	383868	1347	385215	0.04197
ERR2011074_1_kneaddata_paired	Firmicutes_B	17289	P	1010	22	1032	0.00011
ERR2011074_1_kneaddata_paired	Desulfobacterota_A	11509	P	836	69	905	0.00010
ERR2011074_1_kneaddata_paired	Cyanobacteria	9876	P	770	15	785	0.00009
ERR2011074_1_kneaddata_paired	Campylobacterota	8700	P	547	0	547	0.00006
ERR2011074_1_kneaddata_paired	Proteobacteria	22518	P	492	2	494	0.00005
ERR2011074_1_kneaddata_paired	Firmicutes_I	18140	P	207	0	207	0.00002
ERR2011074_1_kneaddata_paired	Spirochaetota	32587	P	133	0	133	0.00001
ERR2011074_1_kneaddata_paired	Firmicutes_C	17613	P	33	0	33	0.00000
ERR2011074_1_kneaddata_paired	Elusimicrobiota	11888	P	22	0	22	0.00000
ERR2011074_1_kneaddata_paired	Deferribacterota	10822	P	16	0	16	0.00000
ERR2011074_1_kneaddata_paired	Thermotogota	33086	P	6	0	6	0.00000
ERR2011075_1_kneaddata_paired	Firmicutes_A	14608	P	5117461	12799	5130260	0.49760
ERR2011075_1_kneaddata_paired	Bacteroidota	4587	P	2972453	20563	2993016	0.29030
ERR2011075_1_kneaddata_paired	Verrucomicrobiota	33333	P	1290013	36434	1326447	0.12866
ERR2011075_1_kneaddata_paired	Firmicutes	12188	P	574336	1260	575596	0.05583
ERR2011075_1_kneaddata_paired	Actinobacteriota	615	P	280389	418	280807	0.02724
ERR2011075_1_kneaddata_paired	Cyanobacteria	9876	P	989	15	1004	0.00010
ERR2011075_1_kneaddata_paired	Firmicutes_B	17289	P	750	13	763	0.00007
ERR2011075_1_kneaddata_paired	Desulfobacterota_A	11509	P	611	38	649	0.00006
ERR2011075_1_kneaddata_paired	Proteobacteria	22518	P	558	1	559	0.00005
ERR2011075_1_kneaddata_paired	Campylobacterota	8700	P	481	0	481	0.00005
ERR2011075_1_kneaddata_paired	Firmicutes_I	18140	P	187	0	187	0.00002
ERR2011075_1_kneaddata_paired	Spirochaetota	32587	P	182	0	182	0.00002
ERR2011075_1_kneaddata_paired	Deferribacterota	10822	P	35	0	35	0.00000
ERR2011075_1_kneaddata_paired	Firmicutes_C	17613	P	31	0	31	0.00000
ERR2011075_1_kneaddata_paired	Elusimicrobiota	11888	P	12	0	12	0.00000
ERR2011075_1_kneaddata_paired	Thermotogota	33086	P	2	0	2	0.00000
ERR2011076_1_kneaddata_paired	Firmicutes_A	14608	P	4358953	16309	4375262	0.62242
ERR2011076_1_kneaddata_paired	Bacteroidota	4587	P	1949513	23602	1973115	0.28070
ERR2011076_1_kneaddata_paired	Firmicutes	12188	P	319571	1750	321321	0.04571
ERR2011076_1_kneaddata_paired	Verrucomicrobiota	33333	P	224827	10522	235349	0.03348
ERR2011076_1_kneaddata_paired	Actinobacteriota	615	P	121559	186	121745	0.01732
ERR2011076_1_kneaddata_paired	Cyanobacteria	9876	P	663	15	678	0.00010
ERR2011076_1_kneaddata_paired	Desulfobacterota_A	11509	P	557	60	617	0.00009
ERR2011076_1_kneaddata_paired	Firmicutes_B	17289	P	544	16	560	0.00008
ERR2011076_1_kneaddata_paired	Proteobacteria	22518	P	342	2	344	0.00005
ERR2011076_1_kneaddata_paired	Campylobacterota	8700	P	133	0	133	0.00002
ERR2011076_1_kneaddata_paired	Spirochaetota	32587	P	102	0	102	0.00001
ERR2011076_1_kneaddata_paired	Firmicutes_I	18140	P	85	0	85	0.00001
ERR2011076_1_kneaddata_paired	Firmicutes_C	17613	P	35	0	35	0.00000
ERR2011076_1_kneaddata_paired	Deferribacterota	10822	P	23	0	23	0.00000
ERR2011076_1_kneaddata_paired	Thermotogota	33086	P	9	0	9	0.00000
ERR2011076_1_kneaddata_paired	Elusimicrobiota	11888	P	5	0	5	0.00000
ERR2059929_1_kneaddata_paired	Firmicutes_A	14608	P	10889550	30551	10920101	0.44643
ERR2059929_1_kneaddata_paired	Bacteroidota	4587	P	7607477	36617	7644094	0.31250
ERR2059929_1_kneaddata_paired	Firmicutes	12188	P	2873501	77038	2950539	0.12062
ERR2059929_1_kneaddata_paired	Actinobacteriota	615	P	1312098	1379	1313477	0.05370
ERR2059929_1_kneaddata_paired	Desulfobacterota_A	11509	P	967292	3511	970803	0.03969
ERR2059929_1_kneaddata_paired	Deferribacterota	10822	P	638940	846	639786	0.02616
ERR2059929_1_kneaddata_paired	Proteobacteria	22518	P	11343	12	11355	0.00046
ERR2059929_1_kneaddata_paired	Verrucomicrobiota	33333	P	4448	93	4541	0.00019
ERR2059929_1_kneaddata_paired	Cyanobacteria	9876	P	4334	43	4377	0.00018
ERR2059929_1_kneaddata_paired	Firmicutes_B	17289	P	586	7	593	0.00002
ERR2059929_1_kneaddata_paired	Spirochaetota	32587	P	560	0	560	0.00002
ERR2059929_1_kneaddata_paired	Campylobacterota	8700	P	391	0	391	0.00002
ERR2059929_1_kneaddata_paired	Firmicutes_I	18140	P	190	0	190	0.00001
ERR2059929_1_kneaddata_paired	Firmicutes_C	17613	P	162	0	162	0.00001
ERR2059929_1_kneaddata_paired	Elusimicrobiota	11888	P	6	0	6	0.00000
ERR2059929_1_kneaddata_paired	Thermotogota	33086	P	2	0	2	0.00000
ERR2059930_1_kneaddata_paired	Firmicutes_A	14608	P	13070744	28780	13099524	0.53505
ERR2059930_1_kneaddata_paired	Firmicutes	12188	P	3818600	107760	3926360	0.16037
ERR2059930_1_kneaddata_paired	Bacteroidota	4587	P	3542837	10516	3553353	0.14514
ERR2059930_1_kneaddata_paired	Actinobacteriota	615	P	1914377	1988	1916365	0.07827
ERR2059930_1_kneaddata_paired	Desulfobacterota_A	11509	P	1314869	4685	1319554	0.05390
ERR2059930_1_kneaddata_paired	Deferribacterota	10822	P	645090	844	645934	0.02638
ERR2059930_1_kneaddata_paired	Proteobacteria	22518	P	8627	9	8636	0.00035
ERR2059930_1_kneaddata_paired	Verrucomicrobiota	33333	P	5740	118	5858	0.00024
ERR2059930_1_kneaddata_paired	Cyanobacteria	9876	P	5240	51	5291	0.00022
ERR2059930_1_kneaddata_paired	Spirochaetota	32587	P	701	0	701	0.00003
ERR2059930_1_kneaddata_paired	Firmicutes_B	17289	P	628	8	636	0.00003
ERR2059930_1_kneaddata_paired	Campylobacterota	8700	P	271	0	271	0.00001
ERR2059930_1_kneaddata_paired	Firmicutes_I	18140	P	142	0	142	0.00001
ERR2059930_1_kneaddata_paired	Firmicutes_C	17613	P	93	0	93	0.00000
ERR2059930_1_kneaddata_paired	Elusimicrobiota	11888	P	10	0	10	0.00000
ERR2059930_1_kneaddata_paired	Thermotogota	33086	P	1	0	1	0.00000
ERR2059931_1_kneaddata_paired	Firmicutes_A	14608	P	11331359	16182	11347541	0.43256
ERR2059931_1_kneaddata_paired	Firmicutes	12188	P	7569787	153053	7722840	0.29439
ERR2059931_1_kneaddata_paired	Actinobacteriota	615	P	2734687	1838	2736525	0.10431
ERR2059931_1_kneaddata_paired	Bacteroidota	4587	P	2379801	3762	2383563	0.09086
ERR2059931_1_kneaddata_paired	Desulfobacterota_A	11509	P	1245031	2984	1248015	0.04757
ERR2059931_1_kneaddata_paired	Deferribacterota	10822	P	762174	646	762820	0.02908
ERR2059931_1_kneaddata_paired	Verrucomicrobiota	33333	P	12253	166	12419	0.00047
ERR2059931_1_kneaddata_paired	Proteobacteria	22518	P	10808	8	10816	0.00041
ERR2059931_1_kneaddata_paired	Cyanobacteria	9876	P	5346	28	5374	0.00020
ERR2059931_1_kneaddata_paired	Firmicutes_B	17289	P	1503	12	1515	0.00006
ERR2059931_1_kneaddata_paired	Firmicutes_I	18140	P	775	0	775	0.00003
ERR2059931_1_kneaddata_paired	Spirochaetota	32587	P	655	0	655	0.00002
ERR2059931_1_kneaddata_paired	Campylobacterota	8700	P	430	0	430	0.00002
ERR2059931_1_kneaddata_paired	Firmicutes_C	17613	P	140	0	140	0.00001
ERR2059931_1_kneaddata_paired	Elusimicrobiota	11888	P	3	0	3	0.00000
ERR2059932_1_kneaddata_paired	Firmicutes_A	14608	P	17869631	60355	17929986	0.83216
ERR2059932_1_kneaddata_paired	Bacteroidota	4587	P	1233947	6967	1240914	0.05759
ERR2059932_1_kneaddata_paired	Desulfobacterota_A	11509	P	799553	3508	803061	0.03727
ERR2059932_1_kneaddata_paired	Firmicutes	12188	P	594633	21330	615963	0.02859
ERR2059932_1_kneaddata_paired	Deferribacterota	10822	P	498718	772	499490	0.02318
ERR2059932_1_kneaddata_paired	Actinobacteriota	615	P	434035	291	434326	0.02016
ERR2059932_1_kneaddata_paired	Verrucomicrobiota	33333	P	11054	272	11326	0.00053
ERR2059932_1_kneaddata_paired	Proteobacteria	22518	P	5684	15	5699	0.00026
ERR2059932_1_kneaddata_paired	Cyanobacteria	9876	P	3181	17	3198	0.00015
ERR2059932_1_kneaddata_paired	Firmicutes_B	17289	P	919	13	932	0.00004
ERR2059932_1_kneaddata_paired	Spirochaetota	32587	P	593	0	593	0.00003
ERR2059932_1_kneaddata_paired	Campylobacterota	8700	P	446	0	446	0.00002
ERR2059932_1_kneaddata_paired	Firmicutes_I	18140	P	276	0	276	0.00001
ERR2059932_1_kneaddata_paired	Firmicutes_C	17613	P	144	0	144	0.00001
ERR2059932_1_kneaddata_paired	Elusimicrobiota	11888	P	19	0	19	0.00000
ERR2059932_1_kneaddata_paired	Thermotogota	33086	P	5	0	5	0.00000
ERR2059933_1_kneaddata_paired	Firmicutes_A	14608	P	21090311	62265	21152576	0.72404
ERR2059933_1_kneaddata_paired	Bacteroidota	4587	P	1994627	10907	2005534	0.06865
ERR2059933_1_kneaddata_paired	Desulfobacterota_A	11509	P	1775815	6939	1782754	0.06102
ERR2059933_1_kneaddata_paired	Deferribacterota	10822	P	1572261	2230	1574491	0.05389
ERR2059933_1_kneaddata_paired	Firmicutes	12188	P	1442507	41418	1483925	0.05079
ERR2059933_1_kneaddata_paired	Actinobacteriota	615	P	1178949	741	1179690	0.04038
ERR2059933_1_kneaddata_paired	Verrucomicrobiota	33333	P	13837	314	14151	0.00048
ERR2059933_1_kneaddata_paired	Proteobacteria	22518	P	11250	18	11268	0.00039
ERR2059933_1_kneaddata_paired	Cyanobacteria	9876	P	5569	20	5589	0.00019
ERR2059933_1_kneaddata_paired	Firmicutes_B	17289	P	1997	27	2024	0.00007
ERR2059933_1_kneaddata_paired	Campylobacterota	8700	P	1261	0	1261	0.00004
ERR2059933_1_kneaddata_paired	Spirochaetota	32587	P	978	0	978	0.00003
ERR2059933_1_kneaddata_paired	Firmicutes_I	18140	P	280	0	280	0.00001
ERR2059933_1_kneaddata_paired	Firmicutes_C	17613	P	172	0	172	0.00001
ERR2059933_1_kneaddata_paired	Elusimicrobiota	11888	P	11	0	11	0.00000
ERR2059933_1_kneaddata_paired	Thermotogota	33086	P	4	0	4	0.00000
ERR2059934_1_kneaddata_paired	Firmicutes_A	14608	P	16031301	50922	16082223	0.70117
ERR2059934_1_kneaddata_paired	Firmicutes	12188	P	2465092	65130	2530222	0.11032
ERR2059934_1_kneaddata_paired	Bacteroidota	4587	P	2015849	9521	2025370	0.08830
ERR2059934_1_kneaddata_paired	Actinobacteriota	615	P	1315027	722	1315749	0.05737
ERR2059934_1_kneaddata_paired	Desulfobacterota_A	11509	P	745374	2620	747994	0.03261
ERR2059934_1_kneaddata_paired	Deferribacterota	10822	P	195130	237	195367	0.00852
ERR2059934_1_kneaddata_paired	Proteobacteria	22518	P	21209	18	21227	0.00093
ERR2059934_1_kneaddata_paired	Verrucomicrobiota	33333	P	12183	237	12420	0.00054
ERR2059934_1_kneaddata_paired	Cyanobacteria	9876	P	3291	11	3302	0.00014
ERR2059934_1_kneaddata_paired	Campylobacterota	8700	P	815	0	815	0.00004
ERR2059934_1_kneaddata_paired	Firmicutes_B	17289	P	542	6	548	0.00002
ERR2059934_1_kneaddata_paired	Spirochaetota	32587	P	507	0	507	0.00002
ERR2059934_1_kneaddata_paired	Firmicutes_I	18140	P	261	0	261	0.00001
ERR2059934_1_kneaddata_paired	Firmicutes_C	17613	P	134	0	134	0.00001
ERR2059934_1_kneaddata_paired	Elusimicrobiota	11888	P	3	0	3	0.00000
ERR2059934_1_kneaddata_paired	Thermotogota	33086	P	3	0	3	0.00000
ERR2059935_1_kneaddata_paired	Bacteroidota	4587	P	15832545	65765	15898310	0.66928
ERR2059935_1_kneaddata_paired	Firmicutes_A	14608	P	5940615	46995	5987610	0.25206
ERR2059935_1_kneaddata_paired	Actinobacteriota	615	P	1280873	1939	1282812	0.05400
ERR2059935_1_kneaddata_paired	Firmicutes	12188	P	415903	6410	422313	0.01778
ERR2059935_1_kneaddata_paired	Desulfobacterota_A	11509	P	79516	236	79752	0.00336
ERR2059935_1_kneaddata_paired	Proteobacteria	22518	P	68012	107	68119	0.00287
ERR2059935_1_kneaddata_paired	Deferribacterota	10822	P	9529	25	9554	0.00040
ERR2059935_1_kneaddata_paired	Cyanobacteria	9876	P	2785	115	2900	0.00012
ERR2059935_1_kneaddata_paired	Campylobacterota	8700	P	1986	1	1987	0.00008
ERR2059935_1_kneaddata_paired	Firmicutes_I	18140	P	427	0	427	0.00002
ERR2059935_1_kneaddata_paired	Verrucomicrobiota	33333	P	235	7	242	0.00001
ERR2059935_1_kneaddata_paired	Spirochaetota	32587	P	211	0	211	0.00001
ERR2059935_1_kneaddata_paired	Firmicutes_B	17289	P	152	3	155	0.00001
ERR2059935_1_kneaddata_paired	Firmicutes_C	17613	P	71	0	71	0.00000
ERR2059935_1_kneaddata_paired	Elusimicrobiota	11888	P	5	0	5	0.00000
ERR2059935_1_kneaddata_paired	Thermotogota	33086	P	5	0	5	0.00000
ERR2059936_1_kneaddata_paired	Firmicutes_A	14608	P	17520518	84262	17604780	0.65056
ERR2059936_1_kneaddata_paired	Bacteroidota	4587	P	8642545	36972	8679517	0.32074
ERR2059936_1_kneaddata_paired	Desulfobacterota_A	11509	P	253585	705	254290	0.00940
ERR2059936_1_kneaddata_paired	Actinobacteriota	615	P	180998	484	181482	0.00671
ERR2059936_1_kneaddata_paired	Deferribacterota	10822	P	166518	343	166861	0.00617
ERR2059936_1_kneaddata_paired	Firmicutes	12188	P	118558	2356	120914	0.00447
ERR2059936_1_kneaddata_paired	Proteobacteria	22518	P	48560	75	48635	0.00180
ERR2059936_1_kneaddata_paired	Cyanobacteria	9876	P	2299	48	2347	0.00009
ERR2059936_1_kneaddata_paired	Verrucomicrobiota	33333	P	506	13	519	0.00002
ERR2059936_1_kneaddata_paired	Firmicutes_B	17289	P	503	10	513	0.00002
ERR2059936_1_kneaddata_paired	Spirochaetota	32587	P	454	0	454	0.00002
ERR2059936_1_kneaddata_paired	Campylobacterota	8700	P	350	0	350	0.00001
ERR2059936_1_kneaddata_paired	Firmicutes_C	17613	P	240	0	240	0.00001
ERR2059936_1_kneaddata_paired	Firmicutes_I	18140	P	117	0	117	0.00000
ERR2059936_1_kneaddata_paired	Thermotogota	33086	P	25	0	25	0.00000
ERR2059936_1_kneaddata_paired	Elusimicrobiota	11888	P	3	0	3	0.00000
ERR2059937_1_kneaddata_paired	Bacteroidota	4587	P	13227461	55747	13283208	0.47752
ERR2059937_1_kneaddata_paired	Firmicutes_A	14608	P	12757537	81619	12839156	0.46155
ERR2059937_1_kneaddata_paired	Actinobacteriota	615	P	795470	1282	796752	0.02864
ERR2059937_1_kneaddata_paired	Firmicutes	12188	P	435790	6008	441798	0.01588
ERR2059937_1_kneaddata_paired	Desulfobacterota_A	11509	P	215441	422	215863	0.00776
ERR2059937_1_kneaddata_paired	Deferribacterota	10822	P	154561	372	154933	0.00557
ERR2059937_1_kneaddata_paired	Proteobacteria	22518	P	78255	124	78379	0.00282
ERR2059937_1_kneaddata_paired	Cyanobacteria	9876	P	3891	110	4001	0.00014
ERR2059937_1_kneaddata_paired	Campylobacterota	8700	P	1533	0	1533	0.00006
ERR2059937_1_kneaddata_paired	Spirochaetota	32587	P	483	0	483	0.00002
ERR2059937_1_kneaddata_paired	Firmicutes_B	17289	P	422	9	431	0.00002
ERR2059937_1_kneaddata_paired	Verrucomicrobiota	33333	P	314	8	322	0.00001
ERR2059937_1_kneaddata_paired	Firmicutes_I	18140	P	301	0	301	0.00001
ERR2059937_1_kneaddata_paired	Firmicutes_C	17613	P	121	0	121	0.00000
ERR2059937_1_kneaddata_paired	Thermotogota	33086	P	8	0	8	0.00000
ERR2059937_1_kneaddata_paired	Elusimicrobiota	11888	P	5	0	5	0.00000
ERR2059938_1_kneaddata_paired	Firmicutes_A	14608	P	15042033	48832	15090865	0.66252
ERR2059938_1_kneaddata_paired	Bacteroidota	4587	P	2911408	10013	2921421	0.12826
ERR2059938_1_kneaddata_paired	Firmicutes	12188	P	1922149	40586	1962735	0.08617
ERR2059938_1_kneaddata_paired	Desulfobacterota_A	11509	P	1281902	4802	1286704	0.05649
ERR2059938_1_kneaddata_paired	Actinobacteriota	615	P	844794	447	845241	0.03711
ERR2059938_1_kneaddata_paired	Deferribacterota	10822	P	640210	838	641048	0.02814
ERR2059938_1_kneaddata_paired	Verrucomicrobiota	33333	P	14475	305	14780	0.00065
ERR2059938_1_kneaddata_paired	Proteobacteria	22518	P	8800	18	8818	0.00039
ERR2059938_1_kneaddata_paired	Cyanobacteria	9876	P	4673	9	4682	0.00021
ERR2059938_1_kneaddata_paired	Spirochaetota	32587	P	638	0	638	0.00003
ERR2059938_1_kneaddata_paired	Firmicutes_B	17289	P	423	5	428	0.00002
ERR2059938_1_kneaddata_paired	Campylobacterota	8700	P	379	0	379	0.00002
ERR2059938_1_kneaddata_paired	Firmicutes_C	17613	P	140	0	140	0.00001
ERR2059938_1_kneaddata_paired	Firmicutes_I	18140	P	133	0	133	0.00001
ERR2059938_1_kneaddata_paired	Elusimicrobiota	11888	P	8	0	8	0.00000
ERR2059938_1_kneaddata_paired	Thermotogota	33086	P	1	0	1	0.00000
ERR2059939_1_kneaddata_paired	Firmicutes_A	14608	P	10141973	27486	10169459	0.31120
ERR2059939_1_kneaddata_paired	Bacteroidota	4587	P	9118719	27119	9145838	0.27988
ERR2059939_1_kneaddata_paired	Firmicutes	12188	P	8310593	121456	8432049	0.25803
ERR2059939_1_kneaddata_paired	Actinobacteriota	615	P	4054975	1330	4056305	0.12413
ERR2059939_1_kneaddata_paired	Desulfobacterota_A	11509	P	753031	2071	755102	0.02311
ERR2059939_1_kneaddata_paired	Deferribacterota	10822	P	73869	70	73939	0.00226
ERR2059939_1_kneaddata_paired	Proteobacteria	22518	P	26567	25	26592	0.00081
ERR2059939_1_kneaddata_paired	Verrucomicrobiota	33333	P	11782	179	11961	0.00037
ERR2059939_1_kneaddata_paired	Cyanobacteria	9876	P	4273	19	4292	0.00013
ERR2059939_1_kneaddata_paired	Firmicutes_B	17289	P	1045	9	1054	0.00003
ERR2059939_1_kneaddata_paired	Campylobacterota	8700	P	773	0	773	0.00002
ERR2059939_1_kneaddata_paired	Spirochaetota	32587	P	501	0	501	0.00002
ERR2059939_1_kneaddata_paired	Firmicutes_I	18140	P	229	0	229	0.00001
ERR2059939_1_kneaddata_paired	Firmicutes_C	17613	P	159	0	159	0.00000
ERR2059939_1_kneaddata_paired	Elusimicrobiota	11888	P	10	0	10	0.00000
ERR2059939_1_kneaddata_paired	Thermotogota	33086	P	6	0	6	0.00000
ERR2059940_1_kneaddata_paired	Firmicutes_A	14608	P	10989083	34615	11023698	0.50076
ERR2059940_1_kneaddata_paired	Firmicutes	12188	P	4411756	67222	4478978	0.20346
ERR2059940_1_kneaddata_paired	Bacteroidota	4587	P	3694207	7553	3701760	0.16815
ERR2059940_1_kneaddata_paired	Actinobacteriota	615	P	1694792	620	1695412	0.07702
ERR2059940_1_kneaddata_paired	Desulfobacterota_A	11509	P	673797	1966	675763	0.03070
ERR2059940_1_kneaddata_paired	Deferribacterota	10822	P	405244	397	405641	0.01843
ERR2059940_1_kneaddata_paired	Verrucomicrobiota	33333	P	15666	247	15913	0.00072
ERR2059940_1_kneaddata_paired	Proteobacteria	22518	P	11517	11	11528	0.00052
ERR2059940_1_kneaddata_paired	Cyanobacteria	9876	P	3329	8	3337	0.00015
ERR2059940_1_kneaddata_paired	Campylobacterota	8700	P	1016	0	1016	0.00005
ERR2059940_1_kneaddata_paired	Spirochaetota	32587	P	381	0	381	0.00002
ERR2059940_1_kneaddata_paired	Firmicutes_I	18140	P	259	0	259	0.00001
ERR2059940_1_kneaddata_paired	Firmicutes_B	17289	P	249	2	251	0.00001
ERR2059940_1_kneaddata_paired	Firmicutes_C	17613	P	70	0	70	0.00000
ERR2059940_1_kneaddata_paired	Thermotogota	33086	P	2	0	2	0.00000
ERR2059940_1_kneaddata_paired	Elusimicrobiota	11888	P	1	0	1	0.00000
ERR2059941_1_kneaddata_paired	Firmicutes_A	14608	P	7025461	11443	7036904	0.30798
ERR2059941_1_kneaddata_paired	Firmicutes	12188	P	6966597	143258	7109855	0.31117
ERR2059941_1_kneaddata_paired	Bacteroidota	4587	P	5562482	10219	5572701	0.24390
ERR2059941_1_kneaddata_paired	Actinobacteriota	615	P	1928038	1225	1929263	0.08444
ERR2059941_1_kneaddata_paired	Desulfobacterota_A	11509	P	827904	1870	829774	0.03632
ERR2059941_1_kneaddata_paired	Deferribacterota	10822	P	340980	274	341254	0.01494
ERR2059941_1_kneaddata_paired	Proteobacteria	22518	P	12076	8	12084	0.00053
ERR2059941_1_kneaddata_paired	Verrucomicrobiota	33333	P	11693	143	11836	0.00052
ERR2059941_1_kneaddata_paired	Cyanobacteria	9876	P	3666	22	3688	0.00016
ERR2059941_1_kneaddata_paired	Spirochaetota	32587	P	521	0	521	0.00002
ERR2059941_1_kneaddata_paired	Firmicutes_B	17289	P	279	2	281	0.00001
ERR2059941_1_kneaddata_paired	Campylobacterota	8700	P	162	0	162	0.00001
ERR2059941_1_kneaddata_paired	Firmicutes_I	18140	P	77	0	77	0.00000
ERR2059941_1_kneaddata_paired	Firmicutes_C	17613	P	73	0	73	0.00000
ERR2059941_1_kneaddata_paired	Elusimicrobiota	11888	P	3	0	3	0.00000
ERR2059941_1_kneaddata_paired	Thermotogota	33086	P	1	0	1	0.00000
ERR2059942_1_kneaddata_paired	Firmicutes_A	14608	P	7706755	13134	7719889	0.32019
ERR2059942_1_kneaddata_paired	Firmicutes	12188	P	7564642	145656	7710298	0.31979
ERR2059942_1_kneaddata_paired	Bacteroidota	4587	P	4486003	9045	4495048	0.18643
ERR2059942_1_kneaddata_paired	Actinobacteriota	615	P	2041928	1244	2043172	0.08474
ERR2059942_1_kneaddata_paired	Deferribacterota	10822	P	1094777	834	1095611	0.04544
ERR2059942_1_kneaddata_paired	Desulfobacterota_A	11509	P	1010866	2225	1013091	0.04202
ERR2059942_1_kneaddata_paired	Proteobacteria	22518	P	14434	9	14443	0.00060
ERR2059942_1_kneaddata_paired	Verrucomicrobiota	33333	P	12436	152	12588	0.00052
ERR2059942_1_kneaddata_paired	Cyanobacteria	9876	P	4661	24	4685	0.00019
ERR2059942_1_kneaddata_paired	Spirochaetota	32587	P	552	0	552	0.00002
ERR2059942_1_kneaddata_paired	Campylobacterota	8700	P	542	0	542	0.00002
ERR2059942_1_kneaddata_paired	Firmicutes_B	17289	P	482	3	485	0.00002
ERR2059942_1_kneaddata_paired	Firmicutes_I	18140	P	128	0	128	0.00001
ERR2059942_1_kneaddata_paired	Firmicutes_C	17613	P	95	0	95	0.00000
ERR2059942_1_kneaddata_paired	Elusimicrobiota	11888	P	5	0	5	0.00000
ERR2059942_1_kneaddata_paired	Thermotogota	33086	P	3	0	3	0.00000
ERR2059943_1_kneaddata_paired	Firmicutes_A	14608	P	10806762	21496	10828258	0.47073
ERR2059943_1_kneaddata_paired	Bacteroidota	4587	P	4329200	10985	4340185	0.18868
ERR2059943_1_kneaddata_paired	Firmicutes	12188	P	4246417	100404	4346821	0.18897
ERR2059943_1_kneaddata_paired	Actinobacteriota	615	P	1680498	1425	1681923	0.07312
ERR2059943_1_kneaddata_paired	Desulfobacterota_A	11509	P	1516383	4449	1520832	0.06611
ERR2059943_1_kneaddata_paired	Deferribacterota	10822	P	264524	282	264806	0.01151
ERR2059943_1_kneaddata_paired	Proteobacteria	22518	P	6495	7	6502	0.00028
ERR2059943_1_kneaddata_paired	Verrucomicrobiota	33333	P	6324	107	6431	0.00028
ERR2059943_1_kneaddata_paired	Cyanobacteria	9876	P	5583	33	5616	0.00024
ERR2059943_1_kneaddata_paired	Firmicutes_B	17289	P	548	5	553	0.00002
ERR2059943_1_kneaddata_paired	Spirochaetota	32587	P	511	0	511	0.00002
ERR2059943_1_kneaddata_paired	Campylobacterota	8700	P	366	0	366	0.00002
ERR2059943_1_kneaddata_paired	Firmicutes_I	18140	P	186	0	186	0.00001
ERR2059943_1_kneaddata_paired	Firmicutes_C	17613	P	160	0	160	0.00001
ERR2059943_1_kneaddata_paired	Elusimicrobiota	11888	P	13	0	13	0.00000
ERR2059943_1_kneaddata_paired	Thermotogota	33086	P	2	0	2	0.00000
ERR2059944_1_kneaddata_paired	Bacteroidota	4587	P	15284400	37374	15321774	0.67027
ERR2059944_1_kneaddata_paired	Firmicutes_A	14608	P	3512747	14561	3527308	0.15431
ERR2059944_1_kneaddata_paired	Firmicutes	12188	P	2346064	91025	2437089	0.10661
ERR2059944_1_kneaddata_paired	Actinobacteriota	615	P	1312329	679	1313008	0.05744
ERR2059944_1_kneaddata_paired	Proteobacteria	22518	P	119111	137	119248	0.00522
ERR2059944_1_kneaddata_paired	Desulfobacterota_A	11509	P	87456	142	87598	0.00383
ERR2059944_1_kneaddata_paired	Verrucomicrobiota	33333	P	39930	199	40129	0.00176
ERR2059944_1_kneaddata_paired	Deferribacterota	10822	P	9938	12	9950	0.00044
ERR2059944_1_kneaddata_paired	Cyanobacteria	9876	P	2469	46	2515	0.00011
ERR2059944_1_kneaddata_paired	Campylobacterota	8700	P	244	0	244	0.00001
ERR2059944_1_kneaddata_paired	Spirochaetota	32587	P	194	0	194	0.00001
ERR2059944_1_kneaddata_paired	Firmicutes_B	17289	P	97	1	98	0.00000
ERR2059944_1_kneaddata_paired	Firmicutes_C	17613	P	38	0	38	0.00000
ERR2059944_1_kneaddata_paired	Firmicutes_I	18140	P	31	0	31	0.00000
ERR2059944_1_kneaddata_paired	Elusimicrobiota	11888	P	2	0	2	0.00000
ERR2059944_1_kneaddata_paired	Thermotogota	33086	P	2	0	2	0.00000
ERR2059945_1_kneaddata_paired	Bacteroidota	4587	P	12003658	18002	12021660	0.41881
ERR2059945_1_kneaddata_paired	Firmicutes_A	14608	P	10845855	27647	10873502	0.37881
ERR2059945_1_kneaddata_paired	Firmicutes	12188	P	3146146	110055	3256201	0.11344
ERR2059945_1_kneaddata_paired	Actinobacteriota	615	P	1776307	819	1777126	0.06191
ERR2059945_1_kneaddata_paired	Deferribacterota	10822	P	256298	271	256569	0.00894
ERR2059945_1_kneaddata_paired	Proteobacteria	22518	P	204138	177	204315	0.00712
ERR2059945_1_kneaddata_paired	Verrucomicrobiota	33333	P	201347	629	201976	0.00704
ERR2059945_1_kneaddata_paired	Desulfobacterota_A	11509	P	104597	329	104926	0.00366
ERR2059945_1_kneaddata_paired	Cyanobacteria	9876	P	5021	42	5063	0.00018
ERR2059945_1_kneaddata_paired	Spirochaetota	32587	P	963	0	963	0.00003
ERR2059945_1_kneaddata_paired	Campylobacterota	8700	P	764	0	764	0.00003
ERR2059945_1_kneaddata_paired	Firmicutes_B	17289	P	755	7	762	0.00003
ERR2059945_1_kneaddata_paired	Firmicutes_I	18140	P	228	0	228	0.00001
ERR2059945_1_kneaddata_paired	Firmicutes_C	17613	P	196	0	196	0.00001
ERR2059945_1_kneaddata_paired	Thermotogota	33086	P	15	0	15	0.00000
ERR2059945_1_kneaddata_paired	Elusimicrobiota	11888	P	2	0	2	0.00000
ERR2059946_1_kneaddata_paired	Firmicutes_A	14608	P	15553784	28950	15582734	0.54635
ERR2059946_1_kneaddata_paired	Bacteroidota	4587	P	8378651	16661	8395312	0.29435
ERR2059946_1_kneaddata_paired	Firmicutes	12188	P	2391637	89721	2481358	0.08700
ERR2059946_1_kneaddata_paired	Actinobacteriota	615	P	1713260	846	1714106	0.06010
ERR2059946_1_kneaddata_paired	Desulfobacterota_A	11509	P	148125	447	148572	0.00521
ERR2059946_1_kneaddata_paired	Verrucomicrobiota	33333	P	94143	373	94516	0.00331
ERR2059946_1_kneaddata_paired	Proteobacteria	22518	P	65686	44	65730	0.00230
ERR2059946_1_kneaddata_paired	Deferribacterota	10822	P	32481	39	32520	0.00114
ERR2059946_1_kneaddata_paired	Cyanobacteria	9876	P	3310	40	3350	0.00012
ERR2059946_1_kneaddata_paired	Firmicutes_B	17289	P	1231	14	1245	0.00004
ERR2059946_1_kneaddata_paired	Firmicutes_I	18140	P	984	0	984	0.00003
ERR2059946_1_kneaddata_paired	Spirochaetota	32587	P	380	0	380	0.00001
ERR2059946_1_kneaddata_paired	Campylobacterota	8700	P	285	0	285	0.00001
ERR2059946_1_kneaddata_paired	Firmicutes_C	17613	P	219	0	219	0.00001
ERR2059946_1_kneaddata_paired	Thermotogota	33086	P	40	0	40	0.00000
ERR2059946_1_kneaddata_paired	Elusimicrobiota	11888	P	7	0	7	0.00000
ERR2059947_1_kneaddata_paired	Firmicutes_A	14608	P	19815441	73197	19888638	0.67786
ERR2059947_1_kneaddata_paired	Firmicutes	12188	P	2299936	59933	2359869	0.08043
ERR2059947_1_kneaddata_paired	Deferribacterota	10822	P	2112459	3002	2115461	0.07210
ERR2059947_1_kneaddata_paired	Bacteroidota	4587	P	2101512	9653	2111165	0.07195
ERR2059947_1_kneaddata_paired	Actinobacteriota	615	P	1635382	909	1636291	0.05577
ERR2059947_1_kneaddata_paired	Desulfobacterota_A	11509	P	1188062	4867	1192929	0.04066
ERR2059947_1_kneaddata_paired	Verrucomicrobiota	33333	P	14648	330	14978	0.00051
ERR2059947_1_kneaddata_paired	Proteobacteria	22518	P	11014	21	11035	0.00038
ERR2059947_1_kneaddata_paired	Cyanobacteria	9876	P	5571	21	5592	0.00019
ERR2059947_1_kneaddata_paired	Campylobacterota	8700	P	1628	0	1628	0.00006
ERR2059947_1_kneaddata_paired	Spirochaetota	32587	P	1231	0	1231	0.00004
ERR2059947_1_kneaddata_paired	Firmicutes_B	17289	P	740	10	750	0.00003
ERR2059947_1_kneaddata_paired	Firmicutes_I	18140	P	339	0	339	0.00001
ERR2059947_1_kneaddata_paired	Firmicutes_C	17613	P	214	0	214	0.00001
ERR2059947_1_kneaddata_paired	Elusimicrobiota	11888	P	7	0	7	0.00000
ERR2059947_1_kneaddata_paired	Thermotogota	33086	P	6	0	6	0.00000
ERR2059948_1_kneaddata_paired	Firmicutes_A	14608	P	19856423	62863	19919286	0.76346
ERR2059948_1_kneaddata_paired	Bacteroidota	4587	P	1486747	8020	1494767	0.05729
ERR2059948_1_kneaddata_paired	Firmicutes	12188	P	1466475	47676	1514151	0.05803
ERR2059948_1_kneaddata_paired	Desulfobacterota_A	11509	P	1150289	4305	1154594	0.04425
ERR2059948_1_kneaddata_paired	Actinobacteriota	615	P	1077468	629	1078097	0.04132
ERR2059948_1_kneaddata_paired	Deferribacterota	10822	P	894973	1180	896153	0.03435
ERR2059948_1_kneaddata_paired	Verrucomicrobiota	33333	P	18889	351	19240	0.00074
ERR2059948_1_kneaddata_paired	Proteobacteria	22518	P	8179	13	8192	0.00031
ERR2059948_1_kneaddata_paired	Cyanobacteria	9876	P	4141	12	4153	0.00016
ERR2059948_1_kneaddata_paired	Spirochaetota	32587	P	753	0	753	0.00003
ERR2059948_1_kneaddata_paired	Campylobacterota	8700	P	602	0	602	0.00002
ERR2059948_1_kneaddata_paired	Firmicutes_B	17289	P	543	7	550	0.00002
ERR2059948_1_kneaddata_paired	Firmicutes_C	17613	P	197	0	197	0.00001
ERR2059948_1_kneaddata_paired	Firmicutes_I	18140	P	166	0	166	0.00001
ERR2059948_1_kneaddata_paired	Elusimicrobiota	11888	P	9	0	9	0.00000
ERR2059948_1_kneaddata_paired	Thermotogota	33086	P	2	0	2	0.00000
ERR2059949_1_kneaddata_paired	Firmicutes_A	14608	P	15136935	40251	15177186	0.67730
ERR2059949_1_kneaddata_paired	Bacteroidota	4587	P	2635740	7678	2643418	0.11797
ERR2059949_1_kneaddata_paired	Firmicutes	12188	P	2304790	61967	2366757	0.10562
ERR2059949_1_kneaddata_paired	Actinobacteriota	615	P	1761591	606	1762197	0.07864
ERR2059949_1_kneaddata_paired	Desulfobacterota_A	11509	P	420028	1225	421253	0.01880
ERR2059949_1_kneaddata_paired	Proteobacteria	22518	P	11484	17	11501	0.00051
ERR2059949_1_kneaddata_paired	Deferribacterota	10822	P	9042	8	9050	0.00040
ERR2059949_1_kneaddata_paired	Verrucomicrobiota	33333	P	8973	92	9065	0.00040
ERR2059949_1_kneaddata_paired	Firmicutes_B	17289	P	3106	30	3136	0.00014
ERR2059949_1_kneaddata_paired	Cyanobacteria	9876	P	2960	21	2981	0.00013
ERR2059949_1_kneaddata_paired	Campylobacterota	8700	P	1003	0	1003	0.00004
ERR2059949_1_kneaddata_paired	Spirochaetota	32587	P	431	0	431	0.00002
ERR2059949_1_kneaddata_paired	Firmicutes_I	18140	P	332	0	332	0.00001
ERR2059949_1_kneaddata_paired	Firmicutes_C	17613	P	149	0	149	0.00001
ERR2059949_1_kneaddata_paired	Thermotogota	33086	P	9	0	9	0.00000
ERR2059949_1_kneaddata_paired	Elusimicrobiota	11888	P	6	0	6	0.00000
ERR2059950_1_kneaddata_paired	Firmicutes_A	14608	P	11388272	18448	11406720	0.51186
ERR2059950_1_kneaddata_paired	Firmicutes	12188	P	4184821	92394	4277215	0.19194
ERR2059950_1_kneaddata_paired	Bacteroidota	4587	P	2701542	5316	2706858	0.12147
ERR2059950_1_kneaddata_paired	Actinobacteriota	615	P	2049361	516	2049877	0.09199
ERR2059950_1_kneaddata_paired	Desulfobacterota_A	11509	P	1386352	2611	1388963	0.06233
ERR2059950_1_kneaddata_paired	Deferribacterota	10822	P	339918	224	340142	0.01526
ERR2059950_1_kneaddata_paired	Verrucomicrobiota	33333	P	95817	273	96090	0.00431
ERR2059950_1_kneaddata_paired	Proteobacteria	22518	P	12130	9	12139	0.00054
ERR2059950_1_kneaddata_paired	Cyanobacteria	9876	P	4691	10	4701	0.00021
ERR2059950_1_kneaddata_paired	Spirochaetota	32587	P	615	0	615	0.00003
ERR2059950_1_kneaddata_paired	Campylobacterota	8700	P	557	0	557	0.00002
ERR2059950_1_kneaddata_paired	Firmicutes_B	17289	P	481	3	484	0.00002
ERR2059950_1_kneaddata_paired	Firmicutes_I	18140	P	178	0	178	0.00001
ERR2059950_1_kneaddata_paired	Firmicutes_C	17613	P	132	0	132	0.00001
ERR2059950_1_kneaddata_paired	Elusimicrobiota	11888	P	6	0	6	0.00000
ERR2059950_1_kneaddata_paired	Thermotogota	33086	P	1	0	1	0.00000
ERR2059951_1_kneaddata_paired	Firmicutes_A	14608	P	8735293	15850	8751143	0.40674
ERR2059951_1_kneaddata_paired	Actinobacteriota	615	P	6180803	1472	6182275	0.28734
ERR2059951_1_kneaddata_paired	Firmicutes	12188	P	3813034	74674	3887708	0.18069
ERR2059951_1_kneaddata_paired	Bacteroidota	4587	P	1523061	1979	1525040	0.07088
ERR2059951_1_kneaddata_paired	Desulfobacterota_A	11509	P	825043	1707	826750	0.03843
ERR2059951_1_kneaddata_paired	Deferribacterota	10822	P	292384	211	292595	0.01360
ERR2059951_1_kneaddata_paired	Verrucomicrobiota	33333	P	32463	138	32601	0.00152
ERR2059951_1_kneaddata_paired	Proteobacteria	22518	P	10359	7	10366	0.00048
ERR2059951_1_kneaddata_paired	Cyanobacteria	9876	P	3680	11	3691	0.00017
ERR2059951_1_kneaddata_paired	Campylobacterota	8700	P	1642	0	1642	0.00008
ERR2059951_1_kneaddata_paired	Spirochaetota	32587	P	595	0	595	0.00003
ERR2059951_1_kneaddata_paired	Firmicutes_B	17289	P	497	3	500	0.00002
ERR2059951_1_kneaddata_paired	Firmicutes_I	18140	P	392	0	392	0.00002
ERR2059951_1_kneaddata_paired	Firmicutes_C	17613	P	106	0	106	0.00000
ERR2059951_1_kneaddata_paired	Elusimicrobiota	11888	P	14	0	14	0.00000
ERR2059951_1_kneaddata_paired	Thermotogota	33086	P	2	0	2	0.00000
ERR2059952_1_kneaddata_paired	Firmicutes_A	14608	P	5881357	15509	5896866	0.27359
ERR2059952_1_kneaddata_paired	Firmicutes	12188	P	5372002	104793	5476795	0.25410
ERR2059952_1_kneaddata_paired	Actinobacteriota	615	P	5108054	1555	5109609	0.23707
ERR2059952_1_kneaddata_paired	Bacteroidota	4587	P	4608015	9229	4617244	0.21422
ERR2059952_1_kneaddata_paired	Desulfobacterota_A	11509	P	208273	610	208883	0.00969
ERR2059952_1_kneaddata_paired	Verrucomicrobiota	33333	P	171709	473	172182	0.00799
ERR2059952_1_kneaddata_paired	Deferribacterota	10822	P	51087	46	51133	0.00237
ERR2059952_1_kneaddata_paired	Proteobacteria	22518	P	12900	13	12913	0.00060
ERR2059952_1_kneaddata_paired	Cyanobacteria	9876	P	3746	14	3760	0.00017
ERR2059952_1_kneaddata_paired	Firmicutes_B	17289	P	1752	15	1767	0.00008
ERR2059952_1_kneaddata_paired	Campylobacterota	8700	P	1582	0	1582	0.00007
ERR2059952_1_kneaddata_paired	Spirochaetota	32587	P	325	0	325	0.00002
ERR2059952_1_kneaddata_paired	Firmicutes_I	18140	P	277	0	277	0.00001
ERR2059952_1_kneaddata_paired	Firmicutes_C	17613	P	91	0	91	0.00000
ERR2059952_1_kneaddata_paired	Elusimicrobiota	11888	P	9	0	9	0.00000
ERR2059952_1_kneaddata_paired	Thermotogota	33086	P	2	0	2	0.00000
ERR2136550_1_kneaddata_paired	Firmicutes_A	14608	P	5649413	30026	5679439	0.39691
ERR2136550_1_kneaddata_paired	Bacteroidota	4587	P	4145251	31733	4176984	0.29191
ERR2136550_1_kneaddata_paired	Firmicutes	12188	P	3811415	23493	3834908	0.26800
ERR2136550_1_kneaddata_paired	Verrucomicrobiota	33333	P	352873	3500	356373	0.02491
ERR2136550_1_kneaddata_paired	Actinobacteriota	615	P	128359	79	128438	0.00898
ERR2136550_1_kneaddata_paired	Cyanobacteria	9876	P	65752	1131	66883	0.00467
ERR2136550_1_kneaddata_paired	Proteobacteria	22518	P	42946	69	43015	0.00301
ERR2136550_1_kneaddata_paired	Desulfobacterota_A	11509	P	21510	115	21625	0.00151
ERR2136550_1_kneaddata_paired	Campylobacterota	8700	P	364	0	364	0.00003
ERR2136550_1_kneaddata_paired	Deferribacterota	10822	P	328	0	328	0.00002
ERR2136550_1_kneaddata_paired	Firmicutes_I	18140	P	228	0	228	0.00002
ERR2136550_1_kneaddata_paired	Spirochaetota	32587	P	228	0	228	0.00002
ERR2136550_1_kneaddata_paired	Firmicutes_B	17289	P	213	8	221	0.00002
ERR2136550_1_kneaddata_paired	Firmicutes_C	17613	P	76	0	76	0.00001
ERR2136550_1_kneaddata_paired	Thermotogota	33086	P	48	0	48	0.00000
ERR2136550_1_kneaddata_paired	Elusimicrobiota	11888	P	10	0	10	0.00000
ERR2136551_1_kneaddata_paired	Firmicutes_A	14608	P	6443679	38283	6481962	0.33849
ERR2136551_1_kneaddata_paired	Firmicutes	12188	P	6380201	28672	6408873	0.33468
ERR2136551_1_kneaddata_paired	Bacteroidota	4587	P	4633251	23917	4657168	0.24320
ERR2136551_1_kneaddata_paired	Verrucomicrobiota	33333	P	752535	7212	759747	0.03967
ERR2136551_1_kneaddata_paired	Cyanobacteria	9876	P	396564	6452	403016	0.02105
ERR2136551_1_kneaddata_paired	Proteobacteria	22518	P	210332	294	210626	0.01100
ERR2136551_1_kneaddata_paired	Actinobacteriota	615	P	166527	73	166600	0.00870
ERR2136551_1_kneaddata_paired	Desulfobacterota_A	11509	P	59065	136	59201	0.00309
ERR2136551_1_kneaddata_paired	Deferribacterota	10822	P	781	1	782	0.00004
ERR2136551_1_kneaddata_paired	Campylobacterota	8700	P	462	0	462	0.00002
ERR2136551_1_kneaddata_paired	Spirochaetota	32587	P	341	0	341	0.00002
ERR2136551_1_kneaddata_paired	Firmicutes_B	17289	P	293	11	304	0.00002
ERR2136551_1_kneaddata_paired	Firmicutes_I	18140	P	250	0	250	0.00001
ERR2136551_1_kneaddata_paired	Firmicutes_C	17613	P	111	0	111	0.00001
ERR2136551_1_kneaddata_paired	Thermotogota	33086	P	61	0	61	0.00000
ERR2136551_1_kneaddata_paired	Elusimicrobiota	11888	P	13	0	13	0.00000
ERR2136552_1_kneaddata_paired	Firmicutes_A	14608	P	7182652	36088	7218740	0.38001
ERR2136552_1_kneaddata_paired	Firmicutes	12188	P	5866471	23616	5890087	0.31006
ERR2136552_1_kneaddata_paired	Bacteroidota	4587	P	4456296	24185	4480481	0.23586
ERR2136552_1_kneaddata_paired	Cyanobacteria	9876	P	603598	9122	612720	0.03225
ERR2136552_1_kneaddata_paired	Verrucomicrobiota	33333	P	562301	5000	567301	0.02986
ERR2136552_1_kneaddata_paired	Proteobacteria	22518	P	92185	144	92329	0.00486
ERR2136552_1_kneaddata_paired	Actinobacteriota	615	P	88169	63	88232	0.00464
ERR2136552_1_kneaddata_paired	Desulfobacterota_A	11509	P	43925	155	44080	0.00232
ERR2136552_1_kneaddata_paired	Deferribacterota	10822	P	646	0	646	0.00003
ERR2136552_1_kneaddata_paired	Campylobacterota	8700	P	547	0	547	0.00003
ERR2136552_1_kneaddata_paired	Firmicutes_B	17289	P	381	13	394	0.00002
ERR2136552_1_kneaddata_paired	Firmicutes_I	18140	P	331	0	331	0.00002
ERR2136552_1_kneaddata_paired	Spirochaetota	32587	P	291	0	291	0.00002
ERR2136552_1_kneaddata_paired	Firmicutes_C	17613	P	143	0	143	0.00001
ERR2136552_1_kneaddata_paired	Thermotogota	33086	P	75	0	75	0.00000
ERR2136552_1_kneaddata_paired	Elusimicrobiota	11888	P	26	0	26	0.00000
ERR2136553_1_kneaddata_paired	Firmicutes_A	14608	P	7766303	34112	7800415	0.45178
ERR2136553_1_kneaddata_paired	Firmicutes	12188	P	4596482	22490	4618972	0.26752
ERR2136553_1_kneaddata_paired	Bacteroidota	4587	P	3803740	25386	3829126	0.22177
ERR2136553_1_kneaddata_paired	Verrucomicrobiota	33333	P	420417	3934	424351	0.02458
ERR2136553_1_kneaddata_paired	Cyanobacteria	9876	P	348400	5529	353929	0.02050
ERR2136553_1_kneaddata_paired	Proteobacteria	22518	P	117611	186	117797	0.00682
ERR2136553_1_kneaddata_paired	Actinobacteriota	615	P	91098	43	91141	0.00528
ERR2136553_1_kneaddata_paired	Desulfobacterota_A	11509	P	27762	133	27895	0.00162
ERR2136553_1_kneaddata_paired	Deferribacterota	10822	P	531	0	531	0.00003
ERR2136553_1_kneaddata_paired	Campylobacterota	8700	P	523	0	523	0.00003
ERR2136553_1_kneaddata_paired	Firmicutes_B	17289	P	403	15	418	0.00002
ERR2136553_1_kneaddata_paired	Spirochaetota	32587	P	308	0	308	0.00002
ERR2136553_1_kneaddata_paired	Firmicutes_I	18140	P	249	0	249	0.00001
ERR2136553_1_kneaddata_paired	Firmicutes_C	17613	P	148	0	148	0.00001
ERR2136553_1_kneaddata_paired	Thermotogota	33086	P	37	0	37	0.00000
ERR2136553_1_kneaddata_paired	Elusimicrobiota	11888	P	30	0	30	0.00000
ERR2136554_1_kneaddata_paired	Bacteroidota	4587	P	4093313	29096	4122409	0.32502
ERR2136554_1_kneaddata_paired	Firmicutes	12188	P	3949701	19569	3969270	0.31295
ERR2136554_1_kneaddata_paired	Firmicutes_A	14608	P	3460887	19222	3480109	0.27438
ERR2136554_1_kneaddata_paired	Verrucomicrobiota	33333	P	581100	5794	586894	0.04627
ERR2136554_1_kneaddata_paired	Cyanobacteria	9876	P	284487	4861	289348	0.02281
ERR2136554_1_kneaddata_paired	Proteobacteria	22518	P	156968	215	157183	0.01239
ERR2136554_1_kneaddata_paired	Actinobacteriota	615	P	69806	44	69850	0.00551
ERR2136554_1_kneaddata_paired	Desulfobacterota_A	11509	P	6749	51	6800	0.00054
ERR2136554_1_kneaddata_paired	Campylobacterota	8700	P	446	0	446	0.00004
ERR2136554_1_kneaddata_paired	Deferribacterota	10822	P	423	0	423	0.00003
ERR2136554_1_kneaddata_paired	Firmicutes_B	17289	P	279	11	290	0.00002
ERR2136554_1_kneaddata_paired	Spirochaetota	32587	P	207	0	207	0.00002
ERR2136554_1_kneaddata_paired	Firmicutes_I	18140	P	150	0	150	0.00001
ERR2136554_1_kneaddata_paired	Firmicutes_C	17613	P	95	0	95	0.00001
ERR2136554_1_kneaddata_paired	Thermotogota	33086	P	23	0	23	0.00000
ERR2136554_1_kneaddata_paired	Elusimicrobiota	11888	P	14	0	14	0.00000
ERR2136555_1_kneaddata_paired	Firmicutes_A	14608	P	11426264	80690	11506954	0.54765
ERR2136555_1_kneaddata_paired	Bacteroidota	4587	P	6130476	40723	6171199	0.29371
ERR2136555_1_kneaddata_paired	Firmicutes	12188	P	2188426	15240	2203666	0.10488
ERR2136555_1_kneaddata_paired	Verrucomicrobiota	33333	P	467338	4720	472058	0.02247
ERR2136555_1_kneaddata_paired	Cyanobacteria	9876	P	269136	4650	273786	0.01303
ERR2136555_1_kneaddata_paired	Proteobacteria	22518	P	205617	325	205942	0.00980
ERR2136555_1_kneaddata_paired	Actinobacteriota	615	P	111563	108	111671	0.00531
ERR2136555_1_kneaddata_paired	Desulfobacterota_A	11509	P	63575	307	63882	0.00304
ERR2136555_1_kneaddata_paired	Firmicutes_B	17289	P	561	23	584	0.00003
ERR2136555_1_kneaddata_paired	Campylobacterota	8700	P	446	0	446	0.00002
ERR2136555_1_kneaddata_paired	Spirochaetota	32587	P	279	0	279	0.00001
ERR2136555_1_kneaddata_paired	Deferribacterota	10822	P	250	0	250	0.00001
ERR2136555_1_kneaddata_paired	Firmicutes_I	18140	P	228	0	228	0.00001
ERR2136555_1_kneaddata_paired	Thermotogota	33086	P	189	0	189	0.00001
ERR2136555_1_kneaddata_paired	Firmicutes_C	17613	P	183	0	183	0.00001
ERR2136555_1_kneaddata_paired	Elusimicrobiota	11888	P	24	0	24	0.00000
ERR2136556_1_kneaddata_paired	Firmicutes_A	14608	P	6761211	42252	6803463	0.69507
ERR2136556_1_kneaddata_paired	Bacteroidota	4587	P	2270487	27282	2297769	0.23475
ERR2136556_1_kneaddata_paired	Firmicutes	12188	P	454306	3576	457882	0.04678
ERR2136556_1_kneaddata_paired	Verrucomicrobiota	33333	P	119560	1570	121130	0.01238
ERR2136556_1_kneaddata_paired	Actinobacteriota	615	P	45979	153	46132	0.00471
ERR2136556_1_kneaddata_paired	Cyanobacteria	9876	P	28327	643	28970	0.00296
ERR2136556_1_kneaddata_paired	Proteobacteria	22518	P	22639	37	22676	0.00232
ERR2136556_1_kneaddata_paired	Desulfobacterota_A	11509	P	8938	162	9100	0.00093
ERR2136556_1_kneaddata_paired	Firmicutes_B	17289	P	382	19	401	0.00004
ERR2136556_1_kneaddata_paired	Campylobacterota	8700	P	210	0	210	0.00002
ERR2136556_1_kneaddata_paired	Spirochaetota	32587	P	101	0	101	0.00001
ERR2136556_1_kneaddata_paired	Firmicutes_C	17613	P	89	0	89	0.00001
ERR2136556_1_kneaddata_paired	Deferribacterota	10822	P	87	0	87	0.00001
ERR2136556_1_kneaddata_paired	Firmicutes_I	18140	P	74	0	74	0.00001
ERR2136556_1_kneaddata_paired	Thermotogota	33086	P	19	0	19	0.00000
ERR2136556_1_kneaddata_paired	Elusimicrobiota	11888	P	3	0	3	0.00000
ERR2136557_1_kneaddata_paired	Firmicutes_A	14608	P	4184370	24772	4209142	0.45871
ERR2136557_1_kneaddata_paired	Bacteroidota	4587	P	3417916	24129	3442045	0.37511
ERR2136557_1_kneaddata_paired	Firmicutes	12188	P	600404	5421	605825	0.06602
ERR2136557_1_kneaddata_paired	Verrucomicrobiota	33333	P	537376	6923	544299	0.05932
ERR2136557_1_kneaddata_paired	Cyanobacteria	9876	P	201001	4429	205430	0.02239
ERR2136557_1_kneaddata_paired	Proteobacteria	22518	P	122163	264	122427	0.01334
ERR2136557_1_kneaddata_paired	Actinobacteriota	615	P	39238	105	39343	0.00429
ERR2136557_1_kneaddata_paired	Desulfobacterota_A	11509	P	6523	83	6606	0.00072
ERR2136557_1_kneaddata_paired	Campylobacterota	8700	P	308	0	308	0.00003
ERR2136557_1_kneaddata_paired	Firmicutes_B	17289	P	199	10	209	0.00002
ERR2136557_1_kneaddata_paired	Spirochaetota	32587	P	145	0	145	0.00002
ERR2136557_1_kneaddata_paired	Deferribacterota	10822	P	143	0	143	0.00002
ERR2136557_1_kneaddata_paired	Firmicutes_C	17613	P	78	0	78	0.00001
ERR2136557_1_kneaddata_paired	Firmicutes_I	18140	P	76	0	76	0.00001
ERR2136557_1_kneaddata_paired	Thermotogota	33086	P	20	0	20	0.00000
ERR2136557_1_kneaddata_paired	Elusimicrobiota	11888	P	11	0	11	0.00000
ERR2136558_1_kneaddata_paired	Firmicutes_A	14608	P	6306279	45551	6351830	0.56419
ERR2136558_1_kneaddata_paired	Bacteroidota	4587	P	2699925	20438	2720363	0.24163
ERR2136558_1_kneaddata_paired	Firmicutes	12188	P	1399248	5455	1404703	0.12477
ERR2136558_1_kneaddata_paired	Verrucomicrobiota	33333	P	426277	4704	430981	0.03828
ERR2136558_1_kneaddata_paired	Cyanobacteria	9876	P	186347	3478	189825	0.01686
ERR2136558_1_kneaddata_paired	Proteobacteria	22518	P	88176	138	88314	0.00784
ERR2136558_1_kneaddata_paired	Actinobacteriota	615	P	64078	103	64181	0.00570
ERR2136558_1_kneaddata_paired	Desulfobacterota_A	11509	P	6754	156	6910	0.00061
ERR2136558_1_kneaddata_paired	Firmicutes_B	17289	P	323	14	337	0.00003
ERR2136558_1_kneaddata_paired	Campylobacterota	8700	P	292	0	292	0.00003
ERR2136558_1_kneaddata_paired	Deferribacterota	10822	P	224	0	224	0.00002
ERR2136558_1_kneaddata_paired	Spirochaetota	32587	P	169	0	169	0.00002
ERR2136558_1_kneaddata_paired	Firmicutes_I	18140	P	114	0	114	0.00001
ERR2136558_1_kneaddata_paired	Firmicutes_C	17613	P	64	0	64	0.00001
ERR2136558_1_kneaddata_paired	Thermotogota	33086	P	61	0	61	0.00001
ERR2136558_1_kneaddata_paired	Elusimicrobiota	11888	P	22	0	22	0.00000
ERR2136559_1_kneaddata_paired	Firmicutes_A	14608	P	2884128	18079	2902207	0.59375
ERR2136559_1_kneaddata_paired	Bacteroidota	4587	P	1296601	13337	1309938	0.26800
ERR2136559_1_kneaddata_paired	Firmicutes	12188	P	399886	3124	403010	0.08245
ERR2136559_1_kneaddata_paired	Verrucomicrobiota	33333	P	103561	1456	105017	0.02149
ERR2136559_1_kneaddata_paired	Cyanobacteria	9876	P	79907	1871	81778	0.01673
ERR2136559_1_kneaddata_paired	Actinobacteriota	615	P	51467	91	51558	0.01055
ERR2136559_1_kneaddata_paired	Proteobacteria	22518	P	29679	79	29758	0.00609
ERR2136559_1_kneaddata_paired	Desulfobacterota_A	11509	P	4038	47	4085	0.00084
ERR2136559_1_kneaddata_paired	Campylobacterota	8700	P	202	0	202	0.00004
ERR2136559_1_kneaddata_paired	Firmicutes_B	17289	P	103	5	108	0.00002
ERR2136559_1_kneaddata_paired	Deferribacterota	10822	P	93	0	93	0.00002
ERR2136559_1_kneaddata_paired	Spirochaetota	32587	P	82	0	82	0.00002
ERR2136559_1_kneaddata_paired	Firmicutes_I	18140	P	34	0	34	0.00001
ERR2136559_1_kneaddata_paired	Firmicutes_C	17613	P	24	0	24	0.00000
ERR2136559_1_kneaddata_paired	Thermotogota	33086	P	9	0	9	0.00000
ERR2136559_1_kneaddata_paired	Elusimicrobiota	11888	P	3	0	3	0.00000
ERR2136560_1_kneaddata_paired	Firmicutes_A	14608	P	3021360	21806	3043166	0.34870
ERR2136560_1_kneaddata_paired	Bacteroidota	4587	P	2534460	22256	2556716	0.29296
ERR2136560_1_kneaddata_paired	Firmicutes	12188	P	1947007	10353	1957360	0.22428
ERR2136560_1_kneaddata_paired	Verrucomicrobiota	33333	P	491063	7804	498867	0.05716
ERR2136560_1_kneaddata_paired	Proteobacteria	22518	P	343870	591	344461	0.03947
ERR2136560_1_kneaddata_paired	Cyanobacteria	9876	P	154599	2746	157345	0.01803
ERR2136560_1_kneaddata_paired	Campylobacterota	8700	P	90972	4	90976	0.01042
ERR2136560_1_kneaddata_paired	Actinobacteriota	615	P	46490	79	46569	0.00534
ERR2136560_1_kneaddata_paired	Desulfobacterota_A	11509	P	27453	85	27538	0.00316
ERR2136560_1_kneaddata_paired	Firmicutes_B	17289	P	1635	83	1718	0.00020
ERR2136560_1_kneaddata_paired	Deferribacterota	10822	P	1510	2	1512	0.00017
ERR2136560_1_kneaddata_paired	Spirochaetota	32587	P	476	1	477	0.00005
ERR2136560_1_kneaddata_paired	Firmicutes_I	18140	P	333	0	333	0.00004
ERR2136560_1_kneaddata_paired	Firmicutes_C	17613	P	79	0	79	0.00001
ERR2136560_1_kneaddata_paired	Elusimicrobiota	11888	P	42	0	42	0.00000
ERR2136560_1_kneaddata_paired	Thermotogota	33086	P	15	0	15	0.00000
ERR2136561_1_kneaddata_paired	Firmicutes_A	14608	P	5450280	33688	5483968	0.81848
ERR2136561_1_kneaddata_paired	Bacteroidota	4587	P	692764	7068	699832	0.10445
ERR2136561_1_kneaddata_paired	Firmicutes	12188	P	399241	2673	401914	0.05999
ERR2136561_1_kneaddata_paired	Verrucomicrobiota	33333	P	68881	864	69745	0.01041
ERR2136561_1_kneaddata_paired	Cyanobacteria	9876	P	17782	370	18152	0.00271
ERR2136561_1_kneaddata_paired	Proteobacteria	22518	P	11737	20	11757	0.00175
ERR2136561_1_kneaddata_paired	Actinobacteriota	615	P	9035	40	9075	0.00135
ERR2136561_1_kneaddata_paired	Desulfobacterota_A	11509	P	5102	113	5215	0.00078
ERR2136561_1_kneaddata_paired	Firmicutes_B	17289	P	143	7	150	0.00002
ERR2136561_1_kneaddata_paired	Campylobacterota	8700	P	125	0	125	0.00002
ERR2136561_1_kneaddata_paired	Spirochaetota	32587	P	76	0	76	0.00001
ERR2136561_1_kneaddata_paired	Deferribacterota	10822	P	66	0	66	0.00001
ERR2136561_1_kneaddata_paired	Firmicutes_I	18140	P	52	0	52	0.00001
ERR2136561_1_kneaddata_paired	Thermotogota	33086	P	40	0	40	0.00001
ERR2136561_1_kneaddata_paired	Firmicutes_C	17613	P	33	0	33	0.00000
ERR2136561_1_kneaddata_paired	Elusimicrobiota	11888	P	16	0	16	0.00000
ERR2136562_1_kneaddata_paired	Firmicutes_A	14608	P	9600915	77847	9678762	0.58255
ERR2136562_1_kneaddata_paired	Bacteroidota	4587	P	5280458	37318	5317776	0.32007
ERR2136562_1_kneaddata_paired	Firmicutes	12188	P	891471	5522	896993	0.05399
ERR2136562_1_kneaddata_paired	Verrucomicrobiota	33333	P	503154	5660	508814	0.03062
ERR2136562_1_kneaddata_paired	Cyanobacteria	9876	P	77675	1515	79190	0.00477
ERR2136562_1_kneaddata_paired	Proteobacteria	22518	P	61384	106	61490	0.00370
ERR2136562_1_kneaddata_paired	Actinobacteriota	615	P	37409	131	37540	0.00226
ERR2136562_1_kneaddata_paired	Desulfobacterota_A	11509	P	32301	242	32543	0.00196
ERR2136562_1_kneaddata_paired	Campylobacterota	8700	P	474	0	474	0.00003
ERR2136562_1_kneaddata_paired	Firmicutes_B	17289	P	304	13	317	0.00002
ERR2136562_1_kneaddata_paired	Spirochaetota	32587	P	174	0	174	0.00001
ERR2136562_1_kneaddata_paired	Thermotogota	33086	P	118	0	118	0.00001
ERR2136562_1_kneaddata_paired	Firmicutes_I	18140	P	84	0	84	0.00001
ERR2136562_1_kneaddata_paired	Firmicutes_C	17613	P	69	0	69	0.00000
ERR2136562_1_kneaddata_paired	Deferribacterota	10822	P	48	0	48	0.00000
ERR2136562_1_kneaddata_paired	Elusimicrobiota	11888	P	23	0	23	0.00000
ERR2136563_1_kneaddata_paired	Firmicutes_A	14608	P	14207644	95494	14303138	0.67596
ERR2136563_1_kneaddata_paired	Bacteroidota	4587	P	4440095	34612	4474707	0.21147
ERR2136563_1_kneaddata_paired	Firmicutes	12188	P	1429699	30816	1460515	0.06902
ERR2136563_1_kneaddata_paired	Actinobacteriota	615	P	699541	1145	700686	0.03311
ERR2136563_1_kneaddata_paired	Verrucomicrobiota	33333	P	73233	1016	74249	0.00351
ERR2136563_1_kneaddata_paired	Proteobacteria	22518	P	58794	162	58956	0.00279
ERR2136563_1_kneaddata_paired	Cyanobacteria	9876	P	54998	1482	56480	0.00267
ERR2136563_1_kneaddata_paired	Desulfobacterota_A	11509	P	28486	291	28777	0.00136
ERR2136563_1_kneaddata_paired	Campylobacterota	8700	P	568	0	568	0.00003
ERR2136563_1_kneaddata_paired	Firmicutes_B	17289	P	531	27	558	0.00003
ERR2136563_1_kneaddata_paired	Deferribacterota	10822	P	411	0	411	0.00002
ERR2136563_1_kneaddata_paired	Spirochaetota	32587	P	397	1	398	0.00002
ERR2136563_1_kneaddata_paired	Firmicutes_C	17613	P	161	0	161	0.00001
ERR2136563_1_kneaddata_paired	Firmicutes_I	18140	P	160	0	160	0.00001
ERR2136563_1_kneaddata_paired	Elusimicrobiota	11888	P	37	0	37	0.00000
ERR2136563_1_kneaddata_paired	Thermotogota	33086	P	18	0	18	0.00000
ERR2136564_1_kneaddata_paired	Bacteroidota	4587	P	9760462	98472	9858934	0.47378
ERR2136564_1_kneaddata_paired	Verrucomicrobiota	33333	P	4201560	54978	4256538	0.20455
ERR2136564_1_kneaddata_paired	Firmicutes_A	14608	P	3780229	32885	3813114	0.18324
ERR2136564_1_kneaddata_paired	Firmicutes	12188	P	1637335	14536	1651871	0.07938
ERR2136564_1_kneaddata_paired	Actinobacteriota	615	P	1031853	3330	1035183	0.04975
ERR2136564_1_kneaddata_paired	Proteobacteria	22518	P	97141	198	97339	0.00468
ERR2136564_1_kneaddata_paired	Cyanobacteria	9876	P	58214	1338	59552	0.00286
ERR2136564_1_kneaddata_paired	Desulfobacterota_A	11509	P	33133	128	33261	0.00160
ERR2136564_1_kneaddata_paired	Campylobacterota	8700	P	2144	2	2146	0.00010
ERR2136564_1_kneaddata_paired	Spirochaetota	32587	P	340	1	341	0.00002
ERR2136564_1_kneaddata_paired	Firmicutes_B	17289	P	253	13	266	0.00001
ERR2136564_1_kneaddata_paired	Deferribacterota	10822	P	237	0	237	0.00001
ERR2136564_1_kneaddata_paired	Firmicutes_I	18140	P	176	0	176	0.00001
ERR2136564_1_kneaddata_paired	Firmicutes_C	17613	P	52	0	52	0.00000
ERR2136564_1_kneaddata_paired	Elusimicrobiota	11888	P	51	0	51	0.00000
ERR2136564_1_kneaddata_paired	Thermotogota	33086	P	46	0	46	0.00000
ERR2136565_1_kneaddata_paired	Firmicutes_A	14608	P	7136805	42224	7179029	0.44365
ERR2136565_1_kneaddata_paired	Bacteroidota	4587	P	5941062	39222	5980284	0.36957
ERR2136565_1_kneaddata_paired	Verrucomicrobiota	33333	P	1231316	12278	1243594	0.07685
ERR2136565_1_kneaddata_paired	Firmicutes	12188	P	892504	35015	927519	0.05732
ERR2136565_1_kneaddata_paired	Proteobacteria	22518	P	345140	561	345701	0.02136
ERR2136565_1_kneaddata_paired	Actinobacteriota	615	P	251448	580	252028	0.01557
ERR2136565_1_kneaddata_paired	Cyanobacteria	9876	P	186578	3226	189804	0.01173
ERR2136565_1_kneaddata_paired	Desulfobacterota_A	11509	P	61531	129	61660	0.00381
ERR2136565_1_kneaddata_paired	Firmicutes_B	17289	P	765	31	796	0.00005
ERR2136565_1_kneaddata_paired	Campylobacterota	8700	P	588	0	588	0.00004
ERR2136565_1_kneaddata_paired	Spirochaetota	32587	P	287	0	287	0.00002
ERR2136565_1_kneaddata_paired	Deferribacterota	10822	P	205	0	205	0.00001
ERR2136565_1_kneaddata_paired	Firmicutes_I	18140	P	146	0	146	0.00001
ERR2136565_1_kneaddata_paired	Firmicutes_C	17613	P	118	0	118	0.00001
ERR2136565_1_kneaddata_paired	Elusimicrobiota	11888	P	15	0	15	0.00000
ERR2136565_1_kneaddata_paired	Thermotogota	33086	P	10	0	10	0.00000
ERR2136566_1_kneaddata_paired	Proteobacteria	22518	P	4351082	11736	4362818	0.56968
ERR2136566_1_kneaddata_paired	Firmicutes	12188	P	2567751	32032	2599783	0.33947
ERR2136566_1_kneaddata_paired	Actinobacteriota	615	P	423523	897	424420	0.05542
ERR2136566_1_kneaddata_paired	Bacteroidota	4587	P	154401	1808	156209	0.02040
ERR2136566_1_kneaddata_paired	Firmicutes_A	14608	P	72448	1090	73538	0.00960
ERR2136566_1_kneaddata_paired	Verrucomicrobiota	33333	P	36656	767	37423	0.00489
ERR2136566_1_kneaddata_paired	Campylobacterota	8700	P	1843	3	1846	0.00024
ERR2136566_1_kneaddata_paired	Cyanobacteria	9876	P	1314	131	1445	0.00019
ERR2136566_1_kneaddata_paired	Firmicutes_I	18140	P	557	0	557	0.00007
ERR2136566_1_kneaddata_paired	Desulfobacterota_A	11509	P	266	3	269	0.00004
ERR2136566_1_kneaddata_paired	Spirochaetota	32587	P	39	0	39	0.00001
ERR2136566_1_kneaddata_paired	Firmicutes_B	17289	P	20	1	21	0.00000
ERR2136566_1_kneaddata_paired	Elusimicrobiota	11888	P	10	0	10	0.00000
ERR2136566_1_kneaddata_paired	Deferribacterota	10822	P	4	0	4	0.00000
ERR2136566_1_kneaddata_paired	Firmicutes_C	17613	P	2	0	2	0.00000
ERR2136567_1_kneaddata_paired	Firmicutes_A	14608	P	8508586	141731	8650317	0.47736
ERR2136567_1_kneaddata_paired	Firmicutes	12188	P	5415287	76399	5491686	0.30306
ERR2136567_1_kneaddata_paired	Bacteroidota	4587	P	3577704	88109	3665813	0.20230
ERR2136567_1_kneaddata_paired	Proteobacteria	22518	P	184715	497	185212	0.01022
ERR2136567_1_kneaddata_paired	Actinobacteriota	615	P	74724	542	75266	0.00415
ERR2136567_1_kneaddata_paired	Verrucomicrobiota	33333	P	27303	675	27978	0.00154
ERR2136567_1_kneaddata_paired	Desulfobacterota_A	11509	P	18165	538	18703	0.00103
ERR2136567_1_kneaddata_paired	Cyanobacteria	9876	P	3542	112	3654	0.00020
ERR2136567_1_kneaddata_paired	Campylobacterota	8700	P	1644	5	1649	0.00009
ERR2136567_1_kneaddata_paired	Deferribacterota	10822	P	266	1	267	0.00001
ERR2136567_1_kneaddata_paired	Firmicutes_B	17289	P	152	13	165	0.00001
ERR2136567_1_kneaddata_paired	Spirochaetota	32587	P	119	0	119	0.00001
ERR2136567_1_kneaddata_paired	Firmicutes_I	18140	P	78	0	78	0.00000
ERR2136567_1_kneaddata_paired	Firmicutes_C	17613	P	51	0	51	0.00000
ERR2136567_1_kneaddata_paired	Thermotogota	33086	P	16	0	16	0.00000
ERR2136567_1_kneaddata_paired	Elusimicrobiota	11888	P	9	0	9	0.00000
ERR2136586_1_kneaddata_paired	Actinobacteriota	615	P	133180	65	133245	0.54449
ERR2136586_1_kneaddata_paired	Firmicutes_A	14608	P	35493	1931	37424	0.15293
ERR2136586_1_kneaddata_paired	Firmicutes	12188	P	25878	1438	27316	0.11162
ERR2136586_1_kneaddata_paired	Proteobacteria	22518	P	21473	244	21717	0.08874
ERR2136586_1_kneaddata_paired	Bacteroidota	4587	P	19524	861	20385	0.08330
ERR2136586_1_kneaddata_paired	Verrucomicrobiota	33333	P	2157	179	2336	0.00955
ERR2136586_1_kneaddata_paired	Cyanobacteria	9876	P	1040	123	1163	0.00476
ERR2136586_1_kneaddata_paired	Desulfobacterota_A	11509	P	679	47	726	0.00297
ERR2136586_1_kneaddata_paired	Campylobacterota	8700	P	136	0	136	0.00056
ERR2136586_1_kneaddata_paired	Firmicutes_I	18140	P	99	0	99	0.00041
ERR2136586_1_kneaddata_paired	Spirochaetota	32587	P	46	0	46	0.00019
ERR2136586_1_kneaddata_paired	Deferribacterota	10822	P	41	0	41	0.00017
ERR2136586_1_kneaddata_paired	Firmicutes_C	17613	P	33	0	33	0.00014
ERR2136586_1_kneaddata_paired	Elusimicrobiota	11888	P	24	0	24	0.00010
ERR2136586_1_kneaddata_paired	Firmicutes_B	17289	P	11	3	14	0.00006
ERR2136586_1_kneaddata_paired	Thermotogota	33086	P	4	0	4	0.00002
ERR2136587_1_kneaddata_paired	Actinobacteriota	615	P	10137	6	10143	0.39921
ERR2136587_1_kneaddata_paired	Firmicutes_A	14608	P	6776	423	7199	0.28333
ERR2136587_1_kneaddata_paired	Bacteroidota	4587	P	3064	100	3164	0.12456
ERR2136587_1_kneaddata_paired	Proteobacteria	22518	P	2644	18	2662	0.10478
ERR2136587_1_kneaddata_paired	Firmicutes	12188	P	1382	80	1462	0.05755
ERR2136587_1_kneaddata_paired	Verrucomicrobiota	33333	P	390	20	410	0.01614
ERR2136587_1_kneaddata_paired	Cyanobacteria	9876	P	161	8	169	0.00666
ERR2136587_1_kneaddata_paired	Desulfobacterota_A	11509	P	141	4	145	0.00571
ERR2136587_1_kneaddata_paired	Campylobacterota	8700	P	27	0	27	0.00106
ERR2136587_1_kneaddata_paired	Firmicutes_I	18140	P	10	0	10	0.00039
ERR2136587_1_kneaddata_paired	Firmicutes_C	17613	P	4	0	4	0.00016
ERR2136587_1_kneaddata_paired	Spirochaetota	32587	P	4	0	4	0.00016
ERR2136587_1_kneaddata_paired	Deferribacterota	10822	P	3	0	3	0.00012
ERR2136587_1_kneaddata_paired	Elusimicrobiota	11888	P	2	0	2	0.00008
ERR2136587_1_kneaddata_paired	Firmicutes_B	17289	P	2	0	2	0.00009
ERR2497911_1_kneaddata_paired	Bacteroidota	4587	P	7986212	41130	8027342	0.57047
ERR2497911_1_kneaddata_paired	Firmicutes_A	14608	P	4392151	27483	4419634	0.31408
ERR2497911_1_kneaddata_paired	Firmicutes	12188	P	547586	7252	554838	0.03943
ERR2497911_1_kneaddata_paired	Actinobacteriota	615	P	510122	1427	511549	0.03635
ERR2497911_1_kneaddata_paired	Verrucomicrobiota	33333	P	500426	5363	505789	0.03594
ERR2497911_1_kneaddata_paired	Desulfobacterota_A	11509	P	28093	193	28286	0.00201
ERR2497911_1_kneaddata_paired	Proteobacteria	22518	P	15431	120	15551	0.00111
ERR2497911_1_kneaddata_paired	Cyanobacteria	9876	P	7407	70	7477	0.00053
ERR2497911_1_kneaddata_paired	Campylobacterota	8700	P	350	0	350	0.00002
ERR2497911_1_kneaddata_paired	Spirochaetota	32587	P	219	0	219	0.00002
ERR2497911_1_kneaddata_paired	Firmicutes_B	17289	P	165	7	172	0.00001
ERR2497911_1_kneaddata_paired	Deferribacterota	10822	P	117	0	117	0.00001
ERR2497911_1_kneaddata_paired	Firmicutes_C	17613	P	104	0	104	0.00001
ERR2497911_1_kneaddata_paired	Firmicutes_I	18140	P	103	0	103	0.00001
ERR2497911_1_kneaddata_paired	Elusimicrobiota	11888	P	19	0	19	0.00000
ERR2497911_1_kneaddata_paired	Thermotogota	33086	P	6	0	6	0.00000
ERR2497912_1_kneaddata_paired	Bacteroidota	4587	P	8109048	41411	8150459	0.59076
ERR2497912_1_kneaddata_paired	Firmicutes_A	14608	P	4056027	22436	4078463	0.29561
ERR2497912_1_kneaddata_paired	Actinobacteriota	615	P	867143	1501	868644	0.06296
ERR2497912_1_kneaddata_paired	Verrucomicrobiota	33333	P	457750	4641	462391	0.03351
ERR2497912_1_kneaddata_paired	Firmicutes	12188	P	195947	4173	200120	0.01451
ERR2497912_1_kneaddata_paired	Proteobacteria	22518	P	24757	177	24934	0.00181
ERR2497912_1_kneaddata_paired	Desulfobacterota_A	11509	P	5762	130	5892	0.00043
ERR2497912_1_kneaddata_paired	Cyanobacteria	9876	P	4835	54	4889	0.00035
ERR2497912_1_kneaddata_paired	Campylobacterota	8700	P	202	0	202	0.00001
ERR2497912_1_kneaddata_paired	Firmicutes_B	17289	P	175	7	182	0.00001
ERR2497912_1_kneaddata_paired	Spirochaetota	32587	P	144	0	144	0.00001
ERR2497912_1_kneaddata_paired	Firmicutes_C	17613	P	92	0	92	0.00001
ERR2497912_1_kneaddata_paired	Firmicutes_I	18140	P	64	0	64	0.00000
ERR2497912_1_kneaddata_paired	Deferribacterota	10822	P	58	0	58	0.00000
ERR2497912_1_kneaddata_paired	Elusimicrobiota	11888	P	40	0	40	0.00000
ERR2497912_1_kneaddata_paired	Thermotogota	33086	P	8	0	8	0.00000
ERR2497913_1_kneaddata_paired	Bacteroidota	4587	P	5801830	35764	5837594	0.64465
ERR2497913_1_kneaddata_paired	Firmicutes_A	14608	P	2207332	18104	2225436	0.24576
ERR2497913_1_kneaddata_paired	Firmicutes	12188	P	562506	7393	569899	0.06293
ERR2497913_1_kneaddata_paired	Verrucomicrobiota	33333	P	199051	2261	201312	0.02223
ERR2497913_1_kneaddata_paired	Actinobacteriota	615	P	188978	646	189624	0.02094
ERR2497913_1_kneaddata_paired	Cyanobacteria	9876	P	15582	130	15712	0.00174
ERR2497913_1_kneaddata_paired	Proteobacteria	22518	P	13714	88	13802	0.00152
ERR2497913_1_kneaddata_paired	Desulfobacterota_A	11509	P	889	55	944	0.00010
ERR2497913_1_kneaddata_paired	Campylobacterota	8700	P	338	0	338	0.00004
ERR2497913_1_kneaddata_paired	Firmicutes_B	17289	P	235	11	246	0.00003
ERR2497913_1_kneaddata_paired	Spirochaetota	32587	P	197	0	197	0.00002
ERR2497913_1_kneaddata_paired	Deferribacterota	10822	P	169	0	169	0.00002
ERR2497913_1_kneaddata_paired	Firmicutes_I	18140	P	97	0	97	0.00001
ERR2497913_1_kneaddata_paired	Firmicutes_C	17613	P	67	0	67	0.00001
ERR2497913_1_kneaddata_paired	Elusimicrobiota	11888	P	14	0	14	0.00000
ERR2497913_1_kneaddata_paired	Thermotogota	33086	P	14	0	14	0.00000
ERR2497914_1_kneaddata_paired	Firmicutes_A	14608	P	4009379	22357	4031736	0.41612
ERR2497914_1_kneaddata_paired	Bacteroidota	4587	P	3518852	35019	3553871	0.36680
ERR2497914_1_kneaddata_paired	Firmicutes	12188	P	1752932	13334	1766266	0.18230
ERR2497914_1_kneaddata_paired	Actinobacteriota	615	P	218670	869	219539	0.02266
ERR2497914_1_kneaddata_paired	Verrucomicrobiota	33333	P	89034	789	89823	0.00927
ERR2497914_1_kneaddata_paired	Desulfobacterota_A	11509	P	22434	102	22536	0.00233
ERR2497914_1_kneaddata_paired	Cyanobacteria	9876	P	2532	30	2562	0.00026
ERR2497914_1_kneaddata_paired	Proteobacteria	22518	P	1708	8	1716	0.00018
ERR2497914_1_kneaddata_paired	Campylobacterota	8700	P	236	0	236	0.00002
ERR2497914_1_kneaddata_paired	Spirochaetota	32587	P	206	0	206	0.00002
ERR2497914_1_kneaddata_paired	Firmicutes_B	17289	P	200	7	207	0.00002
ERR2497914_1_kneaddata_paired	Firmicutes_I	18140	P	69	0	69	0.00001
ERR2497914_1_kneaddata_paired	Firmicutes_C	17613	P	37	0	37	0.00000
ERR2497914_1_kneaddata_paired	Deferribacterota	10822	P	30	0	30	0.00000
ERR2497914_1_kneaddata_paired	Elusimicrobiota	11888	P	12	0	12	0.00000
ERR2497914_1_kneaddata_paired	Thermotogota	33086	P	4	0	4	0.00000
ERR2497915_1_kneaddata_paired	Firmicutes_A	14608	P	6212113	33641	6245754	0.51284
ERR2497915_1_kneaddata_paired	Bacteroidota	4587	P	3891544	37589	3929133	0.32262
ERR2497915_1_kneaddata_paired	Firmicutes	12188	P	1475992	13712	1489704	0.12232
ERR2497915_1_kneaddata_paired	Actinobacteriota	615	P	244117	906	245023	0.02012
ERR2497915_1_kneaddata_paired	Verrucomicrobiota	33333	P	228006	2308	230314	0.01891
ERR2497915_1_kneaddata_paired	Proteobacteria	22518	P	16037	73	16110	0.00132
ERR2497915_1_kneaddata_paired	Desulfobacterota_A	11509	P	11774	169	11943	0.00098
ERR2497915_1_kneaddata_paired	Cyanobacteria	9876	P	9306	44	9350	0.00077
ERR2497915_1_kneaddata_paired	Campylobacterota	8700	P	392	0	392	0.00003
ERR2497915_1_kneaddata_paired	Firmicutes_B	17289	P	317	12	329	0.00003
ERR2497915_1_kneaddata_paired	Spirochaetota	32587	P	285	0	285	0.00002
ERR2497915_1_kneaddata_paired	Firmicutes_I	18140	P	171	0	171	0.00001
ERR2497915_1_kneaddata_paired	Deferribacterota	10822	P	137	0	137	0.00001
ERR2497915_1_kneaddata_paired	Firmicutes_C	17613	P	82	0	82	0.00001
ERR2497915_1_kneaddata_paired	Elusimicrobiota	11888	P	28	0	28	0.00000
ERR2497915_1_kneaddata_paired	Thermotogota	33086	P	24	0	24	0.00000
ERR2497916_1_kneaddata_paired	Bacteroidota	4587	P	4386772	43857	4430629	0.43580
ERR2497916_1_kneaddata_paired	Firmicutes_A	14608	P	3031797	20505	3052302	0.30023
ERR2497916_1_kneaddata_paired	Firmicutes	12188	P	2545926	23262	2569188	0.25271
ERR2497916_1_kneaddata_paired	Actinobacteriota	615	P	66539	202	66741	0.00656
ERR2497916_1_kneaddata_paired	Desulfobacterota_A	11509	P	19696	130	19826	0.00195
ERR2497916_1_kneaddata_paired	Verrucomicrobiota	33333	P	13850	150	14000	0.00138
ERR2497916_1_kneaddata_paired	Cyanobacteria	9876	P	9460	44	9504	0.00093
ERR2497916_1_kneaddata_paired	Proteobacteria	22518	P	3489	16	3505	0.00034
ERR2497916_1_kneaddata_paired	Campylobacterota	8700	P	416	0	416	0.00004
ERR2497916_1_kneaddata_paired	Spirochaetota	32587	P	151	0	151	0.00001
ERR2497916_1_kneaddata_paired	Firmicutes_B	17289	P	138	5	143	0.00001
ERR2497916_1_kneaddata_paired	Firmicutes_I	18140	P	106	0	106	0.00001
ERR2497916_1_kneaddata_paired	Deferribacterota	10822	P	78	0	78	0.00001
ERR2497916_1_kneaddata_paired	Firmicutes_C	17613	P	55	0	55	0.00001
ERR2497916_1_kneaddata_paired	Thermotogota	33086	P	10	0	10	0.00000
ERR2497916_1_kneaddata_paired	Elusimicrobiota	11888	P	4	0	4	0.00000
ERR2560588_1_kneaddata_paired	Bacteroidota	4587	P	3109579	17335	3126914	0.55251
ERR2560588_1_kneaddata_paired	Firmicutes	12188	P	2109679	36134	2145813	0.37915
ERR2560588_1_kneaddata_paired	Firmicutes_A	14608	P	298233	6590	304823	0.05386
ERR2560588_1_kneaddata_paired	Actinobacteriota	615	P	53675	186	53861	0.00952
ERR2560588_1_kneaddata_paired	Verrucomicrobiota	33333	P	16516	2409	18925	0.00334
ERR2560588_1_kneaddata_paired	Desulfobacterota_A	11509	P	4377	9	4386	0.00078
ERR2560588_1_kneaddata_paired	Proteobacteria	22518	P	1735	5	1740	0.00031
ERR2560588_1_kneaddata_paired	Cyanobacteria	9876	P	1401	13	1414	0.00025
ERR2560588_1_kneaddata_paired	Campylobacterota	8700	P	1151	4	1155	0.00020
ERR2560588_1_kneaddata_paired	Spirochaetota	32587	P	280	0	280	0.00005
ERR2560588_1_kneaddata_paired	Firmicutes_B	17289	P	66	6	72	0.00001
ERR2560588_1_kneaddata_paired	Thermotogota	33086	P	60	0	60	0.00001
ERR2560588_1_kneaddata_paired	Firmicutes_I	18140	P	59	0	59	0.00001
ERR2560588_1_kneaddata_paired	Firmicutes_C	17613	P	3	0	3	0.00000
ERR2560588_1_kneaddata_paired	Deferribacterota	10822	P	2	0	2	0.00000
ERR2560589_1_kneaddata_paired	Bacteroidota	4587	P	3417340	19404	3436744	0.55251
ERR2560589_1_kneaddata_paired	Firmicutes	12188	P	2321995	40314	2362309	0.37978
ERR2560589_1_kneaddata_paired	Firmicutes_A	14608	P	325416	7261	332677	0.05348
ERR2560589_1_kneaddata_paired	Actinobacteriota	615	P	58201	201	58402	0.00939
ERR2560589_1_kneaddata_paired	Verrucomicrobiota	33333	P	17262	2545	19807	0.00318
ERR2560589_1_kneaddata_paired	Desulfobacterota_A	11509	P	4653	16	4669	0.00075
ERR2560589_1_kneaddata_paired	Proteobacteria	22518	P	2032	5	2037	0.00033
ERR2560589_1_kneaddata_paired	Cyanobacteria	9876	P	1677	22	1699	0.00027
ERR2560589_1_kneaddata_paired	Campylobacterota	8700	P	1319	5	1324	0.00021
ERR2560589_1_kneaddata_paired	Spirochaetota	32587	P	321	0	321	0.00005
ERR2560589_1_kneaddata_paired	Firmicutes_B	17289	P	65	6	71	0.00001
ERR2560589_1_kneaddata_paired	Thermotogota	33086	P	64	0	64	0.00001
ERR2560589_1_kneaddata_paired	Firmicutes_I	18140	P	58	0	58	0.00001
ERR2560589_1_kneaddata_paired	Deferribacterota	10822	P	2	0	2	0.00000
ERR2560589_1_kneaddata_paired	Firmicutes_C	17613	P	1	0	1	0.00000
ERR2560590_1_kneaddata_paired	Bacteroidota	4587	P	3410642	19481	3430123	0.55863
ERR2560590_1_kneaddata_paired	Firmicutes	12188	P	2248957	39608	2288565	0.37272
ERR2560590_1_kneaddata_paired	Firmicutes_A	14608	P	326703	7302	334005	0.05440
ERR2560590_1_kneaddata_paired	Actinobacteriota	615	P	57558	201	57759	0.00941
ERR2560590_1_kneaddata_paired	Verrucomicrobiota	33333	P	17111	2575	19686	0.00321
ERR2560590_1_kneaddata_paired	Desulfobacterota_A	11509	P	4540	12	4552	0.00074
ERR2560590_1_kneaddata_paired	Proteobacteria	22518	P	2050	8	2058	0.00034
ERR2560590_1_kneaddata_paired	Cyanobacteria	9876	P	1651	20	1671	0.00027
ERR2560590_1_kneaddata_paired	Campylobacterota	8700	P	1245	5	1250	0.00020
ERR2560590_1_kneaddata_paired	Spirochaetota	32587	P	314	0	314	0.00005
ERR2560590_1_kneaddata_paired	Firmicutes_B	17289	P	97	9	106	0.00002
ERR2560590_1_kneaddata_paired	Thermotogota	33086	P	69	0	69	0.00001
ERR2560590_1_kneaddata_paired	Firmicutes_I	18140	P	48	0	48	0.00001
ERR2560590_1_kneaddata_paired	Elusimicrobiota	11888	P	5	0	5	0.00000
ERR2560591_1_kneaddata_paired	Verrucomicrobiota	33333	P	2043254	35308	2078562	0.41606
ERR2560591_1_kneaddata_paired	Firmicutes	12188	P	1864007	9082	1873089	0.37494
ERR2560591_1_kneaddata_paired	Firmicutes_A	14608	P	625391	1286	626677	0.12544
ERR2560591_1_kneaddata_paired	Actinobacteriota	615	P	240147	539	240686	0.04818
ERR2560591_1_kneaddata_paired	Desulfobacterota_A	11509	P	91766	19	91785	0.01837
ERR2560591_1_kneaddata_paired	Bacteroidota	4587	P	81433	112	81545	0.01632
ERR2560591_1_kneaddata_paired	Cyanobacteria	9876	P	1220	4	1224	0.00025
ERR2560591_1_kneaddata_paired	Proteobacteria	22518	P	1198	1	1199	0.00024
ERR2560591_1_kneaddata_paired	Campylobacterota	8700	P	372	0	372	0.00007
ERR2560591_1_kneaddata_paired	Spirochaetota	32587	P	363	0	363	0.00007
ERR2560591_1_kneaddata_paired	Firmicutes_B	17289	P	205	2	207	0.00004
ERR2560591_1_kneaddata_paired	Deferribacterota	10822	P	19	0	19	0.00000
ERR2560591_1_kneaddata_paired	Firmicutes_I	18140	P	17	0	17	0.00000
ERR2560591_1_kneaddata_paired	Elusimicrobiota	11888	P	13	0	13	0.00000
ERR2560591_1_kneaddata_paired	Firmicutes_C	17613	P	3	0	3	0.00000
ERR2560592_1_kneaddata_paired	Verrucomicrobiota	33333	P	2223861	39464	2263325	0.41299
ERR2560592_1_kneaddata_paired	Firmicutes	12188	P	2062283	10208	2072491	0.37817
ERR2560592_1_kneaddata_paired	Firmicutes_A	14608	P	687011	1456	688467	0.12562
ERR2560592_1_kneaddata_paired	Actinobacteriota	615	P	260490	608	261098	0.04764
ERR2560592_1_kneaddata_paired	Desulfobacterota_A	11509	P	100916	20	100936	0.01842
ERR2560592_1_kneaddata_paired	Bacteroidota	4587	P	89973	128	90101	0.01644
ERR2560592_1_kneaddata_paired	Cyanobacteria	9876	P	1455	4	1459	0.00027
ERR2560592_1_kneaddata_paired	Proteobacteria	22518	P	1346	1	1347	0.00025
ERR2560592_1_kneaddata_paired	Campylobacterota	8700	P	444	0	444	0.00008
ERR2560592_1_kneaddata_paired	Spirochaetota	32587	P	429	0	429	0.00008
ERR2560592_1_kneaddata_paired	Firmicutes_B	17289	P	186	2	188	0.00003
ERR2560592_1_kneaddata_paired	Firmicutes_I	18140	P	29	0	29	0.00001
ERR2560592_1_kneaddata_paired	Deferribacterota	10822	P	24	0	24	0.00000
ERR2560592_1_kneaddata_paired	Elusimicrobiota	11888	P	5	0	5	0.00000
ERR2560592_1_kneaddata_paired	Firmicutes_C	17613	P	2	0	2	0.00000
ERR2560593_1_kneaddata_paired	Verrucomicrobiota	33333	P	2189232	39464	2228696	0.41360
ERR2560593_1_kneaddata_paired	Firmicutes	12188	P	2009712	10113	2019825	0.37483
ERR2560593_1_kneaddata_paired	Firmicutes_A	14608	P	683695	1454	685149	0.12715
ERR2560593_1_kneaddata_paired	Actinobacteriota	615	P	261632	627	262259	0.04867
ERR2560593_1_kneaddata_paired	Desulfobacterota_A	11509	P	99548	20	99568	0.01848
ERR2560593_1_kneaddata_paired	Bacteroidota	4587	P	89042	128	89170	0.01655
ERR2560593_1_kneaddata_paired	Cyanobacteria	9876	P	1497	4	1501	0.00028
ERR2560593_1_kneaddata_paired	Proteobacteria	22518	P	1313	1	1314	0.00024
ERR2560593_1_kneaddata_paired	Spirochaetota	32587	P	420	0	420	0.00008
ERR2560593_1_kneaddata_paired	Campylobacterota	8700	P	394	0	394	0.00007
ERR2560593_1_kneaddata_paired	Firmicutes_B	17289	P	238	2	240	0.00004
ERR2560593_1_kneaddata_paired	Firmicutes_I	18140	P	23	0	23	0.00000
ERR2560593_1_kneaddata_paired	Deferribacterota	10822	P	16	0	16	0.00000
ERR2560593_1_kneaddata_paired	Elusimicrobiota	11888	P	6	0	6	0.00000
ERR2560593_1_kneaddata_paired	Thermotogota	33086	P	4	0	4	0.00000
ERR2560593_1_kneaddata_paired	Firmicutes_C	17613	P	2	0	2	0.00000
ERR2560594_1_kneaddata_paired	Firmicutes	12188	P	3609528	19349	3628877	0.66316
ERR2560594_1_kneaddata_paired	Verrucomicrobiota	33333	P	1029364	46893	1076257	0.19668
ERR2560594_1_kneaddata_paired	Bacteroidota	4587	P	438722	1369	440091	0.08042
ERR2560594_1_kneaddata_paired	Firmicutes_A	14608	P	195221	1358	196579	0.03592
ERR2560594_1_kneaddata_paired	Actinobacteriota	615	P	122162	118	122280	0.02235
ERR2560594_1_kneaddata_paired	Desulfobacterota_A	11509	P	3459	2	3461	0.00063
ERR2560594_1_kneaddata_paired	Proteobacteria	22518	P	1697	3	1700	0.00031
ERR2560594_1_kneaddata_paired	Cyanobacteria	9876	P	1584	11	1595	0.00029
ERR2560594_1_kneaddata_paired	Campylobacterota	8700	P	722	0	722	0.00013
ERR2560594_1_kneaddata_paired	Spirochaetota	32587	P	361	0	361	0.00007
ERR2560594_1_kneaddata_paired	Firmicutes_B	17289	P	131	3	134	0.00002
ERR2560594_1_kneaddata_paired	Firmicutes_I	18140	P	25	0	25	0.00000
ERR2560594_1_kneaddata_paired	Elusimicrobiota	11888	P	6	0	6	0.00000
ERR2560594_1_kneaddata_paired	Deferribacterota	10822	P	2	0	2	0.00000
ERR2560594_1_kneaddata_paired	Thermotogota	33086	P	2	0	2	0.00000
ERR2560594_1_kneaddata_paired	Firmicutes_C	17613	P	1	0	1	0.00000
ERR2560595_1_kneaddata_paired	Firmicutes	12188	P	3976782	21514	3998296	0.66577
ERR2560595_1_kneaddata_paired	Verrucomicrobiota	33333	P	1116544	51355	1167899	0.19447
ERR2560595_1_kneaddata_paired	Bacteroidota	4587	P	480836	1515	482351	0.08032
ERR2560595_1_kneaddata_paired	Firmicutes_A	14608	P	213811	1506	215317	0.03585
ERR2560595_1_kneaddata_paired	Actinobacteriota	615	P	132569	129	132698	0.02210
ERR2560595_1_kneaddata_paired	Desulfobacterota_A	11509	P	3839	3	3842	0.00064
ERR2560595_1_kneaddata_paired	Cyanobacteria	9876	P	1863	13	1876	0.00031
ERR2560595_1_kneaddata_paired	Proteobacteria	22518	P	1862	3	1865	0.00031
ERR2560595_1_kneaddata_paired	Campylobacterota	8700	P	788	1	789	0.00013
ERR2560595_1_kneaddata_paired	Spirochaetota	32587	P	413	0	413	0.00007
ERR2560595_1_kneaddata_paired	Firmicutes_B	17289	P	145	4	149	0.00002
ERR2560595_1_kneaddata_paired	Firmicutes_I	18140	P	28	0	28	0.00000
ERR2560595_1_kneaddata_paired	Elusimicrobiota	11888	P	9	0	9	0.00000
ERR2560595_1_kneaddata_paired	Deferribacterota	10822	P	4	0	4	0.00000
ERR2560595_1_kneaddata_paired	Firmicutes_C	17613	P	1	0	1	0.00000
ERR2560595_1_kneaddata_paired	Thermotogota	33086	P	1	0	1	0.00000
ERR2560596_1_kneaddata_paired	Firmicutes	12188	P	3832844	21302	3854146	0.66185
ERR2560596_1_kneaddata_paired	Verrucomicrobiota	33333	P	1087036	51363	1138399	0.19549
ERR2560596_1_kneaddata_paired	Bacteroidota	4587	P	478611	1551	480162	0.08246
ERR2560596_1_kneaddata_paired	Firmicutes_A	14608	P	210129	1537	211666	0.03635
ERR2560596_1_kneaddata_paired	Actinobacteriota	615	P	130094	129	130223	0.02236
ERR2560596_1_kneaddata_paired	Desulfobacterota_A	11509	P	3587	3	3590	0.00062
ERR2560596_1_kneaddata_paired	Proteobacteria	22518	P	1870	3	1873	0.00032
ERR2560596_1_kneaddata_paired	Cyanobacteria	9876	P	1855	13	1868	0.00032
ERR2560596_1_kneaddata_paired	Campylobacterota	8700	P	742	0	742	0.00013
ERR2560596_1_kneaddata_paired	Spirochaetota	32587	P	432	0	432	0.00007
ERR2560596_1_kneaddata_paired	Firmicutes_B	17289	P	131	4	135	0.00002
ERR2560596_1_kneaddata_paired	Firmicutes_I	18140	P	37	0	37	0.00001
ERR2560596_1_kneaddata_paired	Elusimicrobiota	11888	P	5	0	5	0.00000
ERR2560596_1_kneaddata_paired	Thermotogota	33086	P	2	0	2	0.00000
ERR2560596_1_kneaddata_paired	Deferribacterota	10822	P	1	0	1	0.00000
ERR2560596_1_kneaddata_paired	Firmicutes_C	17613	P	1	0	1	0.00000
ERR2560597_1_kneaddata_paired	Firmicutes	12188	P	2602517	20372	2622889	0.49129
ERR2560597_1_kneaddata_paired	Verrucomicrobiota	33333	P	1824570	47915	1872485	0.35073
ERR2560597_1_kneaddata_paired	Firmicutes_A	14608	P	343178	1504	344682	0.06456
ERR2560597_1_kneaddata_paired	Actinobacteriota	615	P	255278	925	256203	0.04799
ERR2560597_1_kneaddata_paired	Bacteroidota	4587	P	207019	410	207429	0.03885
ERR2560597_1_kneaddata_paired	Desulfobacterota_A	11509	P	29889	12	29901	0.00560
ERR2560597_1_kneaddata_paired	Cyanobacteria	9876	P	2232	8	2240	0.00042
ERR2560597_1_kneaddata_paired	Proteobacteria	22518	P	1721	4	1725	0.00032
ERR2560597_1_kneaddata_paired	Spirochaetota	32587	P	720	0	720	0.00013
ERR2560597_1_kneaddata_paired	Firmicutes_B	17289	P	255	4	259	0.00005
ERR2560597_1_kneaddata_paired	Campylobacterota	8700	P	232	0	232	0.00004
ERR2560597_1_kneaddata_paired	Firmicutes_I	18140	P	27	0	27	0.00001
ERR2560597_1_kneaddata_paired	Deferribacterota	10822	P	14	0	14	0.00000
ERR2560597_1_kneaddata_paired	Elusimicrobiota	11888	P	10	0	10	0.00000
ERR2560597_1_kneaddata_paired	Firmicutes_C	17613	P	3	0	3	0.00000
ERR2560598_1_kneaddata_paired	Firmicutes	12188	P	2901048	22810	2923858	0.49579
ERR2560598_1_kneaddata_paired	Verrucomicrobiota	33333	P	1989945	52991	2042936	0.34641
ERR2560598_1_kneaddata_paired	Firmicutes_A	14608	P	380413	1680	382093	0.06479
ERR2560598_1_kneaddata_paired	Actinobacteriota	615	P	280226	1034	281260	0.04769
ERR2560598_1_kneaddata_paired	Bacteroidota	4587	P	227953	461	228414	0.03873
ERR2560598_1_kneaddata_paired	Desulfobacterota_A	11509	P	32997	13	33010	0.00560
ERR2560598_1_kneaddata_paired	Cyanobacteria	9876	P	2421	9	2430	0.00041
ERR2560598_1_kneaddata_paired	Proteobacteria	22518	P	1866	4	1870	0.00032
ERR2560598_1_kneaddata_paired	Spirochaetota	32587	P	862	0	862	0.00015
ERR2560598_1_kneaddata_paired	Campylobacterota	8700	P	322	0	322	0.00005
ERR2560598_1_kneaddata_paired	Firmicutes_B	17289	P	276	4	280	0.00005
ERR2560598_1_kneaddata_paired	Deferribacterota	10822	P	21	0	21	0.00000
ERR2560598_1_kneaddata_paired	Firmicutes_I	18140	P	20	0	20	0.00000
ERR2560598_1_kneaddata_paired	Elusimicrobiota	11888	P	17	0	17	0.00000
ERR2560598_1_kneaddata_paired	Firmicutes_C	17613	P	2	0	2	0.00000
ERR2560598_1_kneaddata_paired	Thermotogota	33086	P	1	0	1	0.00000
ERR2560599_1_kneaddata_paired	Firmicutes	12188	P	2846021	23109	2869130	0.49305
ERR2560599_1_kneaddata_paired	Verrucomicrobiota	33333	P	1968233	54153	2022386	0.34754
ERR2560599_1_kneaddata_paired	Firmicutes_A	14608	P	377526	1720	379246	0.06517
ERR2560599_1_kneaddata_paired	Actinobacteriota	615	P	281630	1068	282698	0.04858
ERR2560599_1_kneaddata_paired	Bacteroidota	4587	P	227213	473	227686	0.03913
ERR2560599_1_kneaddata_paired	Desulfobacterota_A	11509	P	32042	17	32059	0.00551
ERR2560599_1_kneaddata_paired	Cyanobacteria	9876	P	2461	8	2469	0.00042
ERR2560599_1_kneaddata_paired	Proteobacteria	22518	P	1940	4	1944	0.00033
ERR2560599_1_kneaddata_paired	Spirochaetota	32587	P	847	0	847	0.00015
ERR2560599_1_kneaddata_paired	Firmicutes_B	17289	P	325	5	330	0.00006
ERR2560599_1_kneaddata_paired	Campylobacterota	8700	P	244	0	244	0.00004
ERR2560599_1_kneaddata_paired	Firmicutes_I	18140	P	25	0	25	0.00000
ERR2560599_1_kneaddata_paired	Deferribacterota	10822	P	24	0	24	0.00000
ERR2560599_1_kneaddata_paired	Elusimicrobiota	11888	P	7	0	7	0.00000
ERR2560599_1_kneaddata_paired	Firmicutes_C	17613	P	1	0	1	0.00000
ERR2560630_1_kneaddata_paired	Firmicutes	12188	P	4363336	21715	4385051	0.79866
ERR2560630_1_kneaddata_paired	Verrucomicrobiota	33333	P	636615	21193	657808	0.11981
ERR2560630_1_kneaddata_paired	Firmicutes_A	14608	P	275935	1309	277244	0.05050
ERR2560630_1_kneaddata_paired	Bacteroidota	4587	P	147193	193	147386	0.02684
ERR2560630_1_kneaddata_paired	Actinobacteriota	615	P	17242	4	17246	0.00314
ERR2560630_1_kneaddata_paired	Proteobacteria	22518	P	4830	11	4841	0.00088
ERR2560630_1_kneaddata_paired	Cyanobacteria	9876	P	495	1	496	0.00009
ERR2560630_1_kneaddata_paired	Desulfobacterota_A	11509	P	173	0	173	0.00003
ERR2560630_1_kneaddata_paired	Spirochaetota	32587	P	122	0	122	0.00002
ERR2560630_1_kneaddata_paired	Firmicutes_B	17289	P	88	1	89	0.00002
ERR2560630_1_kneaddata_paired	Firmicutes_I	18140	P	29	0	29	0.00001
ERR2560630_1_kneaddata_paired	Campylobacterota	8700	P	26	0	26	0.00000
ERR2560630_1_kneaddata_paired	Deferribacterota	10822	P	10	0	10	0.00000
ERR2560630_1_kneaddata_paired	Thermotogota	33086	P	6	0	6	0.00000
ERR2560630_1_kneaddata_paired	Elusimicrobiota	11888	P	2	0	2	0.00000
ERR2560630_1_kneaddata_paired	Firmicutes_C	17613	P	1	0	1	0.00000
ERR2560631_1_kneaddata_paired	Firmicutes	12188	P	4860399	24179	4884578	0.80224
ERR2560631_1_kneaddata_paired	Verrucomicrobiota	33333	P	691106	23023	714129	0.11729
ERR2560631_1_kneaddata_paired	Firmicutes_A	14608	P	301181	1434	302615	0.04970
ERR2560631_1_kneaddata_paired	Bacteroidota	4587	P	161521	208	161729	0.02656
ERR2560631_1_kneaddata_paired	Actinobacteriota	615	P	18908	5	18913	0.00311
ERR2560631_1_kneaddata_paired	Proteobacteria	22518	P	5651	13	5664	0.00093
ERR2560631_1_kneaddata_paired	Cyanobacteria	9876	P	592	1	593	0.00010
ERR2560631_1_kneaddata_paired	Desulfobacterota_A	11509	P	168	1	169	0.00003
ERR2560631_1_kneaddata_paired	Spirochaetota	32587	P	130	0	130	0.00002
ERR2560631_1_kneaddata_paired	Firmicutes_B	17289	P	69	1	70	0.00001
ERR2560631_1_kneaddata_paired	Firmicutes_I	18140	P	25	0	25	0.00000
ERR2560631_1_kneaddata_paired	Campylobacterota	8700	P	24	0	24	0.00000
ERR2560631_1_kneaddata_paired	Deferribacterota	10822	P	5	0	5	0.00000
ERR2560631_1_kneaddata_paired	Thermotogota	33086	P	4	0	4	0.00000
ERR2560631_1_kneaddata_paired	Elusimicrobiota	11888	P	1	0	1	0.00000
ERR2560632_1_kneaddata_paired	Firmicutes	12188	P	4750614	23890	4774504	0.80067
ERR2560632_1_kneaddata_paired	Verrucomicrobiota	33333	P	676444	22779	699223	0.11726
ERR2560632_1_kneaddata_paired	Firmicutes_A	14608	P	299711	1443	301154	0.05050
ERR2560632_1_kneaddata_paired	Bacteroidota	4587	P	162483	215	162698	0.02728
ERR2560632_1_kneaddata_paired	Actinobacteriota	615	P	18877	5	18882	0.00317
ERR2560632_1_kneaddata_paired	Proteobacteria	22518	P	5566	13	5579	0.00094
ERR2560632_1_kneaddata_paired	Cyanobacteria	9876	P	596	1	597	0.00010
ERR2560632_1_kneaddata_paired	Desulfobacterota_A	11509	P	173	0	173	0.00003
ERR2560632_1_kneaddata_paired	Spirochaetota	32587	P	143	0	143	0.00002
ERR2560632_1_kneaddata_paired	Firmicutes_B	17289	P	87	1	88	0.00001
ERR2560632_1_kneaddata_paired	Firmicutes_I	18140	P	36	0	36	0.00001
ERR2560632_1_kneaddata_paired	Campylobacterota	8700	P	35	0	35	0.00001
ERR2560632_1_kneaddata_paired	Deferribacterota	10822	P	12	0	12	0.00000
ERR2560632_1_kneaddata_paired	Elusimicrobiota	11888	P	6	0	6	0.00000
ERR2560632_1_kneaddata_paired	Firmicutes_C	17613	P	1	0	1	0.00000
ERR2560632_1_kneaddata_paired	Thermotogota	33086	P	1	0	1	0.00000
ERR2560633_1_kneaddata_paired	Verrucomicrobiota	33333	P	4527366	29378	4556744	0.79362
ERR2560633_1_kneaddata_paired	Firmicutes_A	14608	P	961688	785	962473	0.16763
ERR2560633_1_kneaddata_paired	Firmicutes	12188	P	116313	187	116500	0.02029
ERR2560633_1_kneaddata_paired	Bacteroidota	4587	P	89206	41	89247	0.01554
ERR2560633_1_kneaddata_paired	Proteobacteria	22518	P	13577	6	13583	0.00237
ERR2560633_1_kneaddata_paired	Actinobacteriota	615	P	1570	0	1570	0.00027
ERR2560633_1_kneaddata_paired	Desulfobacterota_A	11509	P	691	0	691	0.00012
ERR2560633_1_kneaddata_paired	Firmicutes_B	17289	P	379	1	380	0.00007
ERR2560633_1_kneaddata_paired	Cyanobacteria	9876	P	359	0	359	0.00006
ERR2560633_1_kneaddata_paired	Spirochaetota	32587	P	164	0	164	0.00003
ERR2560633_1_kneaddata_paired	Thermotogota	33086	P	14	0	14	0.00000
ERR2560633_1_kneaddata_paired	Firmicutes_I	18140	P	7	0	7	0.00000
ERR2560633_1_kneaddata_paired	Campylobacterota	8700	P	5	0	5	0.00000
ERR2560634_1_kneaddata_paired	Verrucomicrobiota	33333	P	4903221	32613	4935834	0.79162
ERR2560634_1_kneaddata_paired	Firmicutes_A	14608	P	1052478	880	1053358	0.16894
ERR2560634_1_kneaddata_paired	Firmicutes	12188	P	128319	209	128528	0.02061
ERR2560634_1_kneaddata_paired	Bacteroidota	4587	P	98733	46	98779	0.01584
ERR2560634_1_kneaddata_paired	Proteobacteria	22518	P	14860	7	14867	0.00238
ERR2560634_1_kneaddata_paired	Actinobacteriota	615	P	1885	0	1885	0.00030
ERR2560634_1_kneaddata_paired	Desulfobacterota_A	11509	P	804	0	804	0.00013
ERR2560634_1_kneaddata_paired	Cyanobacteria	9876	P	403	0	403	0.00006
ERR2560634_1_kneaddata_paired	Firmicutes_B	17289	P	395	1	396	0.00006
ERR2560634_1_kneaddata_paired	Spirochaetota	32587	P	224	0	224	0.00004
ERR2560634_1_kneaddata_paired	Firmicutes_I	18140	P	10	0	10	0.00000
ERR2560634_1_kneaddata_paired	Thermotogota	33086	P	6	0	6	0.00000
ERR2560634_1_kneaddata_paired	Campylobacterota	8700	P	4	0	4	0.00000
ERR2560635_1_kneaddata_paired	Verrucomicrobiota	33333	P	4788721	32003	4820724	0.78997
ERR2560635_1_kneaddata_paired	Firmicutes_A	14608	P	1038197	876	1039073	0.17027
ERR2560635_1_kneaddata_paired	Firmicutes	12188	P	124304	205	124509	0.02040
ERR2560635_1_kneaddata_paired	Bacteroidota	4587	P	99609	47	99656	0.01633
ERR2560635_1_kneaddata_paired	Proteobacteria	22518	P	14944	7	14951	0.00245
ERR2560635_1_kneaddata_paired	Actinobacteriota	615	P	1765	0	1765	0.00029
ERR2560635_1_kneaddata_paired	Desulfobacterota_A	11509	P	721	0	721	0.00012
ERR2560635_1_kneaddata_paired	Cyanobacteria	9876	P	448	0	448	0.00007
ERR2560635_1_kneaddata_paired	Firmicutes_B	17289	P	354	1	355	0.00006
ERR2560635_1_kneaddata_paired	Spirochaetota	32587	P	226	0	226	0.00004
ERR2560635_1_kneaddata_paired	Thermotogota	33086	P	7	0	7	0.00000
ERR2560635_1_kneaddata_paired	Firmicutes_I	18140	P	5	0	5	0.00000
ERR2560635_1_kneaddata_paired	Campylobacterota	8700	P	4	0	4	0.00000
ERR2560635_1_kneaddata_paired	Deferribacterota	10822	P	2	0	2	0.00000
ERR2560636_1_kneaddata_paired	Firmicutes	12188	P	5467591	20118	5487709	0.77827
ERR2560636_1_kneaddata_paired	Verrucomicrobiota	33333	P	1035176	24303	1059479	0.15026
ERR2560636_1_kneaddata_paired	Firmicutes_A	14608	P	473883	1971	475854	0.06749
ERR2560636_1_kneaddata_paired	Proteobacteria	22518	P	15265	26	15291	0.00217
ERR2560636_1_kneaddata_paired	Bacteroidota	4587	P	11013	32	11045	0.00157
ERR2560636_1_kneaddata_paired	Actinobacteriota	615	P	938	0	938	0.00013
ERR2560636_1_kneaddata_paired	Cyanobacteria	9876	P	383	0	383	0.00005
ERR2560636_1_kneaddata_paired	Desulfobacterota_A	11509	P	204	0	204	0.00003
ERR2560636_1_kneaddata_paired	Spirochaetota	32587	P	95	0	95	0.00001
ERR2560636_1_kneaddata_paired	Firmicutes_B	17289	P	91	1	92	0.00001
ERR2560636_1_kneaddata_paired	Firmicutes_I	18140	P	21	0	21	0.00000
ERR2560636_1_kneaddata_paired	Campylobacterota	8700	P	16	0	16	0.00000
ERR2560636_1_kneaddata_paired	Deferribacterota	10822	P	2	0	2	0.00000
ERR2560636_1_kneaddata_paired	Thermotogota	33086	P	2	0	2	0.00000
ERR2560636_1_kneaddata_paired	Firmicutes_C	17613	P	1	0	1	0.00000
ERR2560637_1_kneaddata_paired	Firmicutes	12188	P	6146561	22663	6169224	0.78196
ERR2560637_1_kneaddata_paired	Verrucomicrobiota	33333	P	1135357	26750	1162107	0.14730
ERR2560637_1_kneaddata_paired	Firmicutes_A	14608	P	524991	2188	527179	0.06682
ERR2560637_1_kneaddata_paired	Proteobacteria	22518	P	17121	30	17151	0.00217
ERR2560637_1_kneaddata_paired	Bacteroidota	4587	P	11716	34	11750	0.00149
ERR2560637_1_kneaddata_paired	Actinobacteriota	615	P	1084	0	1084	0.00014
ERR2560637_1_kneaddata_paired	Cyanobacteria	9876	P	442	0	442	0.00006
ERR2560637_1_kneaddata_paired	Desulfobacterota_A	11509	P	228	0	228	0.00003
ERR2560637_1_kneaddata_paired	Spirochaetota	32587	P	170	0	170	0.00002
ERR2560637_1_kneaddata_paired	Firmicutes_B	17289	P	102	1	103	0.00001
ERR2560637_1_kneaddata_paired	Firmicutes_I	18140	P	21	0	21	0.00000
ERR2560637_1_kneaddata_paired	Campylobacterota	8700	P	14	0	14	0.00000
ERR2560637_1_kneaddata_paired	Thermotogota	33086	P	3	0	3	0.00000
ERR2560638_1_kneaddata_paired	Firmicutes	12188	P	6043596	22616	6066212	0.78109
ERR2560638_1_kneaddata_paired	Verrucomicrobiota	33333	P	1117606	26748	1144354	0.14735
ERR2560638_1_kneaddata_paired	Firmicutes_A	14608	P	522763	2220	524983	0.06760
ERR2560638_1_kneaddata_paired	Proteobacteria	22518	P	16795	29	16824	0.00217
ERR2560638_1_kneaddata_paired	Bacteroidota	4587	P	11859	36	11895	0.00153
ERR2560638_1_kneaddata_paired	Actinobacteriota	615	P	1145	0	1145	0.00015
ERR2560638_1_kneaddata_paired	Cyanobacteria	9876	P	454	0	454	0.00006
ERR2560638_1_kneaddata_paired	Desulfobacterota_A	11509	P	210	0	210	0.00003
ERR2560638_1_kneaddata_paired	Spirochaetota	32587	P	135	0	135	0.00002
ERR2560638_1_kneaddata_paired	Firmicutes_B	17289	P	84	1	85	0.00001
ERR2560638_1_kneaddata_paired	Campylobacterota	8700	P	26	0	26	0.00000
ERR2560638_1_kneaddata_paired	Firmicutes_I	18140	P	26	0	26	0.00000
ERR2560638_1_kneaddata_paired	Deferribacterota	10822	P	3	0	3	0.00000
ERR2560638_1_kneaddata_paired	Thermotogota	33086	P	2	0	2	0.00000
ERR2560639_1_kneaddata_paired	Firmicutes	12188	P	5395427	97284	5492711	0.90150
ERR2560639_1_kneaddata_paired	Firmicutes_A	14608	P	333361	3044	336405	0.05521
ERR2560639_1_kneaddata_paired	Bacteroidota	4587	P	113295	419	113714	0.01866
ERR2560639_1_kneaddata_paired	Actinobacteriota	615	P	77156	97	77253	0.01268
ERR2560639_1_kneaddata_paired	Verrucomicrobiota	33333	P	60473	6497	66970	0.01099
ERR2560639_1_kneaddata_paired	Cyanobacteria	9876	P	2835	25	2860	0.00047
ERR2560639_1_kneaddata_paired	Proteobacteria	22518	P	1339	8	1347	0.00022
ERR2560639_1_kneaddata_paired	Spirochaetota	32587	P	796	1	797	0.00013
ERR2560639_1_kneaddata_paired	Campylobacterota	8700	P	330	0	330	0.00005
ERR2560639_1_kneaddata_paired	Firmicutes_I	18140	P	178	0	178	0.00003
ERR2560639_1_kneaddata_paired	Firmicutes_B	17289	P	174	12	186	0.00003
ERR2560639_1_kneaddata_paired	Desulfobacterota_A	11509	P	89	3	92	0.00002
ERR2560639_1_kneaddata_paired	Deferribacterota	10822	P	11	0	11	0.00000
ERR2560639_1_kneaddata_paired	Thermotogota	33086	P	7	0	7	0.00000
ERR2560639_1_kneaddata_paired	Firmicutes_C	17613	P	5	0	5	0.00000
ERR2560639_1_kneaddata_paired	Elusimicrobiota	11888	P	2	0	2	0.00000
ERR2560640_1_kneaddata_paired	Firmicutes	12188	P	6013731	108058	6121789	0.90214
ERR2560640_1_kneaddata_paired	Firmicutes_A	14608	P	368849	3350	372199	0.05485
ERR2560640_1_kneaddata_paired	Bacteroidota	4587	P	127855	469	128324	0.01891
ERR2560640_1_kneaddata_paired	Actinobacteriota	615	P	84064	107	84171	0.01240
ERR2560640_1_kneaddata_paired	Verrucomicrobiota	33333	P	66039	7076	73115	0.01077
ERR2560640_1_kneaddata_paired	Cyanobacteria	9876	P	3056	30	3086	0.00045
ERR2560640_1_kneaddata_paired	Proteobacteria	22518	P	1328	8	1336	0.00020
ERR2560640_1_kneaddata_paired	Spirochaetota	32587	P	881	1	882	0.00013
ERR2560640_1_kneaddata_paired	Campylobacterota	8700	P	372	0	372	0.00005
ERR2560640_1_kneaddata_paired	Firmicutes_I	18140	P	232	0	232	0.00003
ERR2560640_1_kneaddata_paired	Firmicutes_B	17289	P	186	12	198	0.00003
ERR2560640_1_kneaddata_paired	Desulfobacterota_A	11509	P	91	3	94	0.00001
ERR2560640_1_kneaddata_paired	Deferribacterota	10822	P	10	0	10	0.00000
ERR2560640_1_kneaddata_paired	Firmicutes_C	17613	P	7	0	7	0.00000
ERR2560641_1_kneaddata_paired	Firmicutes	12188	P	5877074	107832	5984906	0.89962
ERR2560641_1_kneaddata_paired	Firmicutes_A	14608	P	367806	3410	371216	0.05580
ERR2560641_1_kneaddata_paired	Bacteroidota	4587	P	133062	496	133558	0.02008
ERR2560641_1_kneaddata_paired	Actinobacteriota	615	P	84196	108	84304	0.01267
ERR2560641_1_kneaddata_paired	Verrucomicrobiota	33333	P	65165	7132	72297	0.01087
ERR2560641_1_kneaddata_paired	Cyanobacteria	9876	P	3228	28	3256	0.00049
ERR2560641_1_kneaddata_paired	Proteobacteria	22518	P	1431	8	1439	0.00022
ERR2560641_1_kneaddata_paired	Spirochaetota	32587	P	897	1	898	0.00014
ERR2560641_1_kneaddata_paired	Campylobacterota	8700	P	360	0	360	0.00005
ERR2560641_1_kneaddata_paired	Firmicutes_B	17289	P	191	13	204	0.00003
ERR2560641_1_kneaddata_paired	Firmicutes_I	18140	P	187	0	187	0.00003
ERR2560641_1_kneaddata_paired	Desulfobacterota_A	11509	P	82	2	84	0.00001
ERR2560641_1_kneaddata_paired	Deferribacterota	10822	P	9	0	9	0.00000
ERR2560641_1_kneaddata_paired	Firmicutes_C	17613	P	6	0	6	0.00000
ERR2560641_1_kneaddata_paired	Thermotogota	33086	P	3	0	3	0.00000
ERR2560641_1_kneaddata_paired	Elusimicrobiota	11888	P	1	0	1	0.00000
ERR2560642_1_kneaddata_paired	Firmicutes	12188	P	4904082	47623	4951705	0.90574
ERR2560642_1_kneaddata_paired	Firmicutes_A	14608	P	252654	2235	254889	0.04662
ERR2560642_1_kneaddata_paired	Verrucomicrobiota	33333	P	133985	9205	143190	0.02619
ERR2560642_1_kneaddata_paired	Bacteroidota	4587	P	78429	147	78576	0.01437
ERR2560642_1_kneaddata_paired	Actinobacteriota	615	P	36256	18	36274	0.00664
ERR2560642_1_kneaddata_paired	Cyanobacteria	9876	P	1138	9	1147	0.00021
ERR2560642_1_kneaddata_paired	Proteobacteria	22518	P	534	3	537	0.00010
ERR2560642_1_kneaddata_paired	Spirochaetota	32587	P	396	0	396	0.00007
ERR2560642_1_kneaddata_paired	Firmicutes_B	17289	P	96	4	100	0.00002
ERR2560642_1_kneaddata_paired	Desulfobacterota_A	11509	P	84	2	86	0.00002
ERR2560642_1_kneaddata_paired	Firmicutes_I	18140	P	42	0	42	0.00001
ERR2560642_1_kneaddata_paired	Campylobacterota	8700	P	28	0	28	0.00001
ERR2560642_1_kneaddata_paired	Deferribacterota	10822	P	15	0	15	0.00000
ERR2560642_1_kneaddata_paired	Firmicutes_C	17613	P	7	0	7	0.00000
ERR2560642_1_kneaddata_paired	Thermotogota	33086	P	1	0	1	0.00000
ERR2560643_1_kneaddata_paired	Firmicutes	12188	P	5540085	53525	5593610	0.90719
ERR2560643_1_kneaddata_paired	Firmicutes_A	14608	P	282767	2509	285276	0.04627
ERR2560643_1_kneaddata_paired	Verrucomicrobiota	33333	P	147219	10061	157280	0.02551
ERR2560643_1_kneaddata_paired	Bacteroidota	4587	P	87237	164	87401	0.01418
ERR2560643_1_kneaddata_paired	Actinobacteriota	615	P	39737	20	39757	0.00645
ERR2560643_1_kneaddata_paired	Cyanobacteria	9876	P	1290	10	1300	0.00021
ERR2560643_1_kneaddata_paired	Proteobacteria	22518	P	526	3	529	0.00009
ERR2560643_1_kneaddata_paired	Spirochaetota	32587	P	416	0	416	0.00007
ERR2560643_1_kneaddata_paired	Firmicutes_B	17289	P	95	4	99	0.00002
ERR2560643_1_kneaddata_paired	Desulfobacterota_A	11509	P	63	1	64	0.00001
ERR2560643_1_kneaddata_paired	Firmicutes_I	18140	P	44	0	44	0.00001
ERR2560643_1_kneaddata_paired	Campylobacterota	8700	P	43	0	43	0.00001
ERR2560643_1_kneaddata_paired	Deferribacterota	10822	P	6	0	6	0.00000
ERR2560643_1_kneaddata_paired	Thermotogota	33086	P	4	0	4	0.00000
ERR2560643_1_kneaddata_paired	Elusimicrobiota	11888	P	2	0	2	0.00000
ERR2560643_1_kneaddata_paired	Firmicutes_C	17613	P	1	0	1	0.00000
ERR2560644_1_kneaddata_paired	Firmicutes	12188	P	5474542	53764	5528306	0.90582
ERR2560644_1_kneaddata_paired	Firmicutes_A	14608	P	283737	2555	286292	0.04691
ERR2560644_1_kneaddata_paired	Verrucomicrobiota	33333	P	145003	10075	155078	0.02541
ERR2560644_1_kneaddata_paired	Bacteroidota	4587	P	89990	172	90162	0.01477
ERR2560644_1_kneaddata_paired	Actinobacteriota	615	P	40723	19	40742	0.00668
ERR2560644_1_kneaddata_paired	Cyanobacteria	9876	P	1258	7	1265	0.00021
ERR2560644_1_kneaddata_paired	Proteobacteria	22518	P	552	3	555	0.00009
ERR2560644_1_kneaddata_paired	Spirochaetota	32587	P	440	0	440	0.00007
ERR2560644_1_kneaddata_paired	Firmicutes_B	17289	P	81	3	84	0.00001
ERR2560644_1_kneaddata_paired	Desulfobacterota_A	11509	P	70	0	70	0.00001
ERR2560644_1_kneaddata_paired	Firmicutes_I	18140	P	54	0	54	0.00001
ERR2560644_1_kneaddata_paired	Campylobacterota	8700	P	38	0	38	0.00001
ERR2560644_1_kneaddata_paired	Deferribacterota	10822	P	16	0	16	0.00000
ERR2560644_1_kneaddata_paired	Thermotogota	33086	P	3	0	3	0.00000
ERR2560644_1_kneaddata_paired	Firmicutes_C	17613	P	1	0	1	0.00000
ERR2560645_1_kneaddata_paired	Firmicutes	12188	P	3654782	50857	3705639	0.67804
ERR2560645_1_kneaddata_paired	Bacteroidota	4587	P	793344	1953	795297	0.14552
ERR2560645_1_kneaddata_paired	Verrucomicrobiota	33333	P	520210	39134	559344	0.10235
ERR2560645_1_kneaddata_paired	Firmicutes_A	14608	P	306117	2370	308487	0.05645
ERR2560645_1_kneaddata_paired	Actinobacteriota	615	P	91155	65	91220	0.01669
ERR2560645_1_kneaddata_paired	Cyanobacteria	9876	P	2920	24	2944	0.00054
ERR2560645_1_kneaddata_paired	Proteobacteria	22518	P	759	5	764	0.00014
ERR2560645_1_kneaddata_paired	Spirochaetota	32587	P	706	0	706	0.00013
ERR2560645_1_kneaddata_paired	Campylobacterota	8700	P	276	0	276	0.00005
ERR2560645_1_kneaddata_paired	Firmicutes_B	17289	P	214	10	224	0.00004
ERR2560645_1_kneaddata_paired	Desulfobacterota_A	11509	P	141	2	143	0.00003
ERR2560645_1_kneaddata_paired	Firmicutes_I	18140	P	109	0	109	0.00002
ERR2560645_1_kneaddata_paired	Deferribacterota	10822	P	22	0	22	0.00000
ERR2560645_1_kneaddata_paired	Thermotogota	33086	P	7	0	7	0.00000
ERR2560645_1_kneaddata_paired	Elusimicrobiota	11888	P	2	0	2	0.00000
ERR2560645_1_kneaddata_paired	Firmicutes_C	17613	P	1	0	1	0.00000
ERR2560646_1_kneaddata_paired	Firmicutes	12188	P	4057165	56999	4114164	0.68020
ERR2560646_1_kneaddata_paired	Bacteroidota	4587	P	884489	2190	886679	0.14660
ERR2560646_1_kneaddata_paired	Verrucomicrobiota	33333	P	564235	42860	607095	0.10037
ERR2560646_1_kneaddata_paired	Firmicutes_A	14608	P	333990	2616	336606	0.05565
ERR2560646_1_kneaddata_paired	Actinobacteriota	615	P	97957	69	98026	0.01621
ERR2560646_1_kneaddata_paired	Cyanobacteria	9876	P	3207	24	3231	0.00053
ERR2560646_1_kneaddata_paired	Proteobacteria	22518	P	879	6	885	0.00015
ERR2560646_1_kneaddata_paired	Spirochaetota	32587	P	840	0	840	0.00014
ERR2560646_1_kneaddata_paired	Campylobacterota	8700	P	309	0	309	0.00005
ERR2560646_1_kneaddata_paired	Firmicutes_B	17289	P	280	13	293	0.00005
ERR2560646_1_kneaddata_paired	Desulfobacterota_A	11509	P	151	1	152	0.00003
ERR2560646_1_kneaddata_paired	Firmicutes_I	18140	P	135	0	135	0.00002
ERR2560646_1_kneaddata_paired	Deferribacterota	10822	P	25	0	25	0.00000
ERR2560646_1_kneaddata_paired	Thermotogota	33086	P	22	0	22	0.00000
ERR2560646_1_kneaddata_paired	Firmicutes_C	17613	P	4	0	4	0.00000
ERR2560647_1_kneaddata_paired	Firmicutes	12188	P	3935426	57137	3992563	0.67176
ERR2560647_1_kneaddata_paired	Bacteroidota	4587	P	912863	2322	915185	0.15398
ERR2560647_1_kneaddata_paired	Verrucomicrobiota	33333	P	550308	43210	593518	0.09986
ERR2560647_1_kneaddata_paired	Firmicutes_A	14608	P	336993	2741	339734	0.05716
ERR2560647_1_kneaddata_paired	Actinobacteriota	615	P	96320	70	96390	0.01622
ERR2560647_1_kneaddata_paired	Cyanobacteria	9876	P	3327	26	3353	0.00056
ERR2560647_1_kneaddata_paired	Proteobacteria	22518	P	954	7	961	0.00016
ERR2560647_1_kneaddata_paired	Spirochaetota	32587	P	874	0	874	0.00015
ERR2560647_1_kneaddata_paired	Campylobacterota	8700	P	252	0	252	0.00004
ERR2560647_1_kneaddata_paired	Firmicutes_B	17289	P	238	12	250	0.00004
ERR2560647_1_kneaddata_paired	Desulfobacterota_A	11509	P	144	1	145	0.00002
ERR2560647_1_kneaddata_paired	Firmicutes_I	18140	P	139	0	139	0.00002
ERR2560647_1_kneaddata_paired	Deferribacterota	10822	P	22	0	22	0.00000
ERR2560647_1_kneaddata_paired	Thermotogota	33086	P	16	0	16	0.00000
ERR2560647_1_kneaddata_paired	Firmicutes_C	17613	P	3	0	3	0.00000
ERR2560647_1_kneaddata_paired	Elusimicrobiota	11888	P	2	0	2	0.00000
ERR2560648_1_kneaddata_paired	Firmicutes	12188	P	5291627	52248	5343875	0.89822
ERR2560648_1_kneaddata_paired	Bacteroidota	4587	P	321162	638	321800	0.05409
ERR2560648_1_kneaddata_paired	Verrucomicrobiota	33333	P	149135	9503	158638	0.02666
ERR2560648_1_kneaddata_paired	Firmicutes_A	14608	P	110185	785	110970	0.01865
ERR2560648_1_kneaddata_paired	Actinobacteriota	615	P	12306	11	12317	0.00207
ERR2560648_1_kneaddata_paired	Cyanobacteria	9876	P	893	5	898	0.00015
ERR2560648_1_kneaddata_paired	Proteobacteria	22518	P	472	1	473	0.00008
ERR2560648_1_kneaddata_paired	Spirochaetota	32587	P	200	0	200	0.00003
ERR2560648_1_kneaddata_paired	Desulfobacterota_A	11509	P	115	2	117	0.00002
ERR2560648_1_kneaddata_paired	Firmicutes_B	17289	P	44	1	45	0.00001
ERR2560648_1_kneaddata_paired	Firmicutes_I	18140	P	41	0	41	0.00001
ERR2560648_1_kneaddata_paired	Campylobacterota	8700	P	35	0	35	0.00001
ERR2560648_1_kneaddata_paired	Thermotogota	33086	P	6	0	6	0.00000
ERR2560648_1_kneaddata_paired	Deferribacterota	10822	P	3	0	3	0.00000
ERR2560648_1_kneaddata_paired	Elusimicrobiota	11888	P	2	0	2	0.00000
ERR2560648_1_kneaddata_paired	Firmicutes_C	17613	P	2	0	2	0.00000
ERR2560649_1_kneaddata_paired	Firmicutes	12188	P	5876532	57850	5934382	0.89951
ERR2560649_1_kneaddata_paired	Bacteroidota	4587	P	352543	684	353227	0.05354
ERR2560649_1_kneaddata_paired	Verrucomicrobiota	33333	P	162779	10352	173131	0.02624
ERR2560649_1_kneaddata_paired	Firmicutes_A	14608	P	120208	857	121065	0.01835
ERR2560649_1_kneaddata_paired	Actinobacteriota	615	P	13454	12	13466	0.00204
ERR2560649_1_kneaddata_paired	Cyanobacteria	9876	P	1103	6	1109	0.00017
ERR2560649_1_kneaddata_paired	Proteobacteria	22518	P	474	1	475	0.00007
ERR2560649_1_kneaddata_paired	Spirochaetota	32587	P	259	0	259	0.00004
ERR2560649_1_kneaddata_paired	Desulfobacterota_A	11509	P	91	1	92	0.00001
ERR2560649_1_kneaddata_paired	Firmicutes_B	17289	P	62	2	64	0.00001
ERR2560649_1_kneaddata_paired	Firmicutes_I	18140	P	47	0	47	0.00001
ERR2560649_1_kneaddata_paired	Campylobacterota	8700	P	36	0	36	0.00001
ERR2560649_1_kneaddata_paired	Deferribacterota	10822	P	8	0	8	0.00000
ERR2560649_1_kneaddata_paired	Elusimicrobiota	11888	P	4	0	4	0.00000
ERR2560649_1_kneaddata_paired	Firmicutes_C	17613	P	1	0	1	0.00000
ERR2560650_1_kneaddata_paired	Firmicutes	12188	P	5710194	56269	5766463	0.89767
ERR2560650_1_kneaddata_paired	Bacteroidota	4587	P	351987	684	352671	0.05490
ERR2560650_1_kneaddata_paired	Verrucomicrobiota	33333	P	159421	10164	169585	0.02640
ERR2560650_1_kneaddata_paired	Firmicutes_A	14608	P	118692	830	119522	0.01861
ERR2560650_1_kneaddata_paired	Actinobacteriota	615	P	13490	12	13502	0.00210
ERR2560650_1_kneaddata_paired	Cyanobacteria	9876	P	1038	5	1043	0.00016
ERR2560650_1_kneaddata_paired	Proteobacteria	22518	P	526	2	528	0.00008
ERR2560650_1_kneaddata_paired	Spirochaetota	32587	P	257	0	257	0.00004
ERR2560650_1_kneaddata_paired	Desulfobacterota_A	11509	P	95	1	96	0.00002
ERR2560650_1_kneaddata_paired	Firmicutes_B	17289	P	49	2	51	0.00001
ERR2560650_1_kneaddata_paired	Campylobacterota	8700	P	43	0	43	0.00001
ERR2560650_1_kneaddata_paired	Firmicutes_I	18140	P	40	0	40	0.00001
ERR2560650_1_kneaddata_paired	Deferribacterota	10822	P	14	0	14	0.00000
ERR2560650_1_kneaddata_paired	Thermotogota	33086	P	4	0	4	0.00000
ERR2560650_1_kneaddata_paired	Elusimicrobiota	11888	P	2	0	2	0.00000
ERR2560651_1_kneaddata_paired	Firmicutes	12188	P	1617614	7370	1624984	0.31362
ERR2560651_1_kneaddata_paired	Firmicutes_A	14608	P	1481260	4207	1485467	0.28669
ERR2560651_1_kneaddata_paired	Verrucomicrobiota	33333	P	1473858	39007	1512865	0.29198
ERR2560651_1_kneaddata_paired	Actinobacteriota	615	P	313819	28	313847	0.06057
ERR2560651_1_kneaddata_paired	Bacteroidota	4587	P	241017	271	241288	0.04657
ERR2560651_1_kneaddata_paired	Cyanobacteria	9876	P	1229	2	1231	0.00024
ERR2560651_1_kneaddata_paired	Proteobacteria	22518	P	677	3	680	0.00013
ERR2560651_1_kneaddata_paired	Desulfobacterota_A	11509	P	381	2	383	0.00007
ERR2560651_1_kneaddata_paired	Spirochaetota	32587	P	350	0	350	0.00007
ERR2560651_1_kneaddata_paired	Firmicutes_B	17289	P	229	3	232	0.00004
ERR2560651_1_kneaddata_paired	Firmicutes_I	18140	P	46	0	46	0.00001
ERR2560651_1_kneaddata_paired	Campylobacterota	8700	P	29	0	29	0.00001
ERR2560651_1_kneaddata_paired	Firmicutes_C	17613	P	23	0	23	0.00000
ERR2560651_1_kneaddata_paired	Deferribacterota	10822	P	16	0	16	0.00000
ERR2560651_1_kneaddata_paired	Thermotogota	33086	P	8	0	8	0.00000
ERR2560651_1_kneaddata_paired	Elusimicrobiota	11888	P	1	0	1	0.00000
ERR2560652_1_kneaddata_paired	Firmicutes	12188	P	1804086	8455	1812541	0.31654
ERR2560652_1_kneaddata_paired	Firmicutes_A	14608	P	1649224	4815	1654039	0.28886
ERR2560652_1_kneaddata_paired	Verrucomicrobiota	33333	P	1605802	43738	1649540	0.28807
ERR2560652_1_kneaddata_paired	Actinobacteriota	615	P	339452	32	339484	0.05929
ERR2560652_1_kneaddata_paired	Bacteroidota	4587	P	266612	311	266923	0.04661
ERR2560652_1_kneaddata_paired	Cyanobacteria	9876	P	1491	2	1493	0.00026
ERR2560652_1_kneaddata_paired	Proteobacteria	22518	P	832	4	836	0.00015
ERR2560652_1_kneaddata_paired	Desulfobacterota_A	11509	P	424	4	428	0.00007
ERR2560652_1_kneaddata_paired	Spirochaetota	32587	P	417	0	417	0.00007
ERR2560652_1_kneaddata_paired	Firmicutes_B	17289	P	296	5	301	0.00005
ERR2560652_1_kneaddata_paired	Firmicutes_I	18140	P	60	0	60	0.00001
ERR2560652_1_kneaddata_paired	Deferribacterota	10822	P	24	0	24	0.00000
ERR2560652_1_kneaddata_paired	Campylobacterota	8700	P	22	0	22	0.00000
ERR2560652_1_kneaddata_paired	Firmicutes_C	17613	P	15	0	15	0.00000
ERR2560652_1_kneaddata_paired	Thermotogota	33086	P	5	0	5	0.00000
ERR2560652_1_kneaddata_paired	Elusimicrobiota	11888	P	4	0	4	0.00000
ERR2560653_1_kneaddata_paired	Firmicutes	12188	P	1765374	8399	1773773	0.31213
ERR2560653_1_kneaddata_paired	Firmicutes_A	14608	P	1662881	4943	1667824	0.29348
ERR2560653_1_kneaddata_paired	Verrucomicrobiota	33333	P	1572632	43539	1616171	0.28439
ERR2560653_1_kneaddata_paired	Actinobacteriota	615	P	348558	32	348590	0.06134
ERR2560653_1_kneaddata_paired	Bacteroidota	4587	P	272718	320	273038	0.04805
ERR2560653_1_kneaddata_paired	Cyanobacteria	9876	P	1428	2	1430	0.00025
ERR2560653_1_kneaddata_paired	Proteobacteria	22518	P	856	4	860	0.00015
ERR2560653_1_kneaddata_paired	Spirochaetota	32587	P	441	0	441	0.00008
ERR2560653_1_kneaddata_paired	Desulfobacterota_A	11509	P	386	4	390	0.00007
ERR2560653_1_kneaddata_paired	Firmicutes_B	17289	P	231	4	235	0.00004
ERR2560653_1_kneaddata_paired	Firmicutes_I	18140	P	44	0	44	0.00001
ERR2560653_1_kneaddata_paired	Campylobacterota	8700	P	25	0	25	0.00000
ERR2560653_1_kneaddata_paired	Deferribacterota	10822	P	25	0	25	0.00000
ERR2560653_1_kneaddata_paired	Firmicutes_C	17613	P	17	0	17	0.00000
ERR2560653_1_kneaddata_paired	Thermotogota	33086	P	4	0	4	0.00000
ERR2560653_1_kneaddata_paired	Elusimicrobiota	11888	P	2	0	2	0.00000
ERR2560654_1_kneaddata_paired	Firmicutes	12188	P	2797626	15807	2813433	0.49402
ERR2560654_1_kneaddata_paired	Bacteroidota	4587	P	1565957	4670	1570627	0.27579
ERR2560654_1_kneaddata_paired	Verrucomicrobiota	33333	P	656074	28840	684914	0.12027
ERR2560654_1_kneaddata_paired	Firmicutes_A	14608	P	469235	5506	474741	0.08336
ERR2560654_1_kneaddata_paired	Actinobacteriota	615	P	146474	128	146602	0.02574
ERR2560654_1_kneaddata_paired	Proteobacteria	22518	P	1872	8	1880	0.00033
ERR2560654_1_kneaddata_paired	Cyanobacteria	9876	P	1642	10	1652	0.00029
ERR2560654_1_kneaddata_paired	Spirochaetota	32587	P	466	0	466	0.00008
ERR2560654_1_kneaddata_paired	Desulfobacterota_A	11509	P	270	5	275	0.00005
ERR2560654_1_kneaddata_paired	Firmicutes_B	17289	P	188	5	193	0.00003
ERR2560654_1_kneaddata_paired	Campylobacterota	8700	P	111	0	111	0.00002
ERR2560654_1_kneaddata_paired	Firmicutes_I	18140	P	57	0	57	0.00001
ERR2560654_1_kneaddata_paired	Deferribacterota	10822	P	46	0	46	0.00001
ERR2560654_1_kneaddata_paired	Firmicutes_C	17613	P	16	0	16	0.00000
ERR2560654_1_kneaddata_paired	Elusimicrobiota	11888	P	5	0	5	0.00000
ERR2560655_1_kneaddata_paired	Firmicutes	12188	P	3088956	18136	3107092	0.49603
ERR2560655_1_kneaddata_paired	Bacteroidota	4587	P	1719079	5334	1724413	0.27529
ERR2560655_1_kneaddata_paired	Verrucomicrobiota	33333	P	708597	32309	740906	0.11828
ERR2560655_1_kneaddata_paired	Firmicutes_A	14608	P	521927	6319	528246	0.08433
ERR2560655_1_kneaddata_paired	Actinobacteriota	615	P	157922	143	158065	0.02523
ERR2560655_1_kneaddata_paired	Proteobacteria	22518	P	2090	8	2098	0.00034
ERR2560655_1_kneaddata_paired	Cyanobacteria	9876	P	1837	12	1849	0.00030
ERR2560655_1_kneaddata_paired	Spirochaetota	32587	P	571	0	571	0.00009
ERR2560655_1_kneaddata_paired	Desulfobacterota_A	11509	P	272	3	275	0.00004
ERR2560655_1_kneaddata_paired	Firmicutes_B	17289	P	182	5	187	0.00003
ERR2560655_1_kneaddata_paired	Campylobacterota	8700	P	114	0	114	0.00002
ERR2560655_1_kneaddata_paired	Firmicutes_I	18140	P	76	0	76	0.00001
ERR2560655_1_kneaddata_paired	Deferribacterota	10822	P	41	0	41	0.00001
ERR2560655_1_kneaddata_paired	Firmicutes_C	17613	P	20	0	20	0.00000
ERR2560655_1_kneaddata_paired	Elusimicrobiota	11888	P	7	0	7	0.00000
ERR2560655_1_kneaddata_paired	Thermotogota	33086	P	1	0	1	0.00000
ERR2560656_1_kneaddata_paired	Firmicutes	12188	P	2994313	17922	3012235	0.49189
ERR2560656_1_kneaddata_paired	Bacteroidota	4587	P	1697660	5369	1703029	0.27810
ERR2560656_1_kneaddata_paired	Verrucomicrobiota	33333	P	688918	32168	721086	0.11775
ERR2560656_1_kneaddata_paired	Firmicutes_A	14608	P	519376	6467	525843	0.08587
ERR2560656_1_kneaddata_paired	Actinobacteriota	615	P	156391	143	156534	0.02556
ERR2560656_1_kneaddata_paired	Proteobacteria	22518	P	2110	10	2120	0.00035
ERR2560656_1_kneaddata_paired	Cyanobacteria	9876	P	1823	12	1835	0.00030
ERR2560656_1_kneaddata_paired	Spirochaetota	32587	P	540	0	540	0.00009
ERR2560656_1_kneaddata_paired	Desulfobacterota_A	11509	P	236	5	241	0.00004
ERR2560656_1_kneaddata_paired	Firmicutes_B	17289	P	177	5	182	0.00003
ERR2560656_1_kneaddata_paired	Campylobacterota	8700	P	74	0	74	0.00001
ERR2560656_1_kneaddata_paired	Firmicutes_I	18140	P	65	0	65	0.00001
ERR2560656_1_kneaddata_paired	Deferribacterota	10822	P	43	0	43	0.00001
ERR2560656_1_kneaddata_paired	Firmicutes_C	17613	P	12	0	12	0.00000
ERR2560656_1_kneaddata_paired	Elusimicrobiota	11888	P	8	0	8	0.00000
ERR2560656_1_kneaddata_paired	Thermotogota	33086	P	1	0	1	0.00000
ERR2560657_1_kneaddata_paired	Firmicutes	12188	P	2740775	53914	2794689	0.53124
ERR2560657_1_kneaddata_paired	Bacteroidota	4587	P	1498352	5051	1503403	0.28578
ERR2560657_1_kneaddata_paired	Firmicutes_A	14608	P	462975	4275	467250	0.08882
ERR2560657_1_kneaddata_paired	Actinobacteriota	615	P	447129	831	447960	0.08515
ERR2560657_1_kneaddata_paired	Verrucomicrobiota	33333	P	39399	3548	42947	0.00816
ERR2560657_1_kneaddata_paired	Cyanobacteria	9876	P	1804	62	1866	0.00035
ERR2560657_1_kneaddata_paired	Proteobacteria	22518	P	1019	4	1023	0.00019
ERR2560657_1_kneaddata_paired	Desulfobacterota_A	11509	P	970	9	979	0.00019
ERR2560657_1_kneaddata_paired	Campylobacterota	8700	P	225	0	225	0.00004
ERR2560657_1_kneaddata_paired	Spirochaetota	32587	P	215	0	215	0.00004
ERR2560657_1_kneaddata_paired	Firmicutes_B	17289	P	65	3	68	0.00001
ERR2560657_1_kneaddata_paired	Firmicutes_I	18140	P	50	0	50	0.00001
ERR2560657_1_kneaddata_paired	Deferribacterota	10822	P	21	0	21	0.00000
ERR2560657_1_kneaddata_paired	Elusimicrobiota	11888	P	19	0	19	0.00000
ERR2560657_1_kneaddata_paired	Thermotogota	33086	P	14	0	14	0.00000
ERR2560657_1_kneaddata_paired	Firmicutes_C	17613	P	3	0	3	0.00000
ERR2560658_1_kneaddata_paired	Firmicutes	12188	P	3029041	60699	3089740	0.53389
ERR2560658_1_kneaddata_paired	Bacteroidota	4587	P	1644691	5666	1650357	0.28517
ERR2560658_1_kneaddata_paired	Firmicutes_A	14608	P	508161	4796	512957	0.08864
ERR2560658_1_kneaddata_paired	Actinobacteriota	615	P	482224	913	483137	0.08348
ERR2560658_1_kneaddata_paired	Verrucomicrobiota	33333	P	42156	3885	46041	0.00796
ERR2560658_1_kneaddata_paired	Cyanobacteria	9876	P	2072	73	2145	0.00037
ERR2560658_1_kneaddata_paired	Proteobacteria	22518	P	1105	4	1109	0.00019
ERR2560658_1_kneaddata_paired	Desulfobacterota_A	11509	P	1037	8	1045	0.00018
ERR2560658_1_kneaddata_paired	Campylobacterota	8700	P	264	0	264	0.00005
ERR2560658_1_kneaddata_paired	Spirochaetota	32587	P	246	0	246	0.00004
ERR2560658_1_kneaddata_paired	Firmicutes_B	17289	P	69	4	73	0.00001
ERR2560658_1_kneaddata_paired	Firmicutes_I	18140	P	40	0	40	0.00001
ERR2560658_1_kneaddata_paired	Deferribacterota	10822	P	18	0	18	0.00000
ERR2560658_1_kneaddata_paired	Elusimicrobiota	11888	P	17	0	17	0.00000
ERR2560658_1_kneaddata_paired	Firmicutes_C	17613	P	10	0	10	0.00000
ERR2560658_1_kneaddata_paired	Thermotogota	33086	P	10	0	10	0.00000
ERR2560659_1_kneaddata_paired	Firmicutes	12188	P	2918346	58548	2976894	0.52775
ERR2560659_1_kneaddata_paired	Bacteroidota	4587	P	1624463	5585	1630048	0.28898
ERR2560659_1_kneaddata_paired	Firmicutes_A	14608	P	503667	4715	508382	0.09013
ERR2560659_1_kneaddata_paired	Actinobacteriota	615	P	473944	899	474843	0.08418
ERR2560659_1_kneaddata_paired	Verrucomicrobiota	33333	P	41690	3852	45542	0.00807
ERR2560659_1_kneaddata_paired	Cyanobacteria	9876	P	1993	66	2059	0.00037
ERR2560659_1_kneaddata_paired	Proteobacteria	22518	P	1161	6	1167	0.00021
ERR2560659_1_kneaddata_paired	Desulfobacterota_A	11509	P	1049	9	1058	0.00019
ERR2560659_1_kneaddata_paired	Spirochaetota	32587	P	301	0	301	0.00005
ERR2560659_1_kneaddata_paired	Campylobacterota	8700	P	243	0	243	0.00004
ERR2560659_1_kneaddata_paired	Firmicutes_B	17289	P	69	4	73	0.00001
ERR2560659_1_kneaddata_paired	Firmicutes_I	18140	P	52	0	52	0.00001
ERR2560659_1_kneaddata_paired	Deferribacterota	10822	P	26	0	26	0.00000
ERR2560659_1_kneaddata_paired	Elusimicrobiota	11888	P	26	0	26	0.00000
ERR2560659_1_kneaddata_paired	Thermotogota	33086	P	4	0	4	0.00000
ERR2560659_1_kneaddata_paired	Firmicutes_C	17613	P	1	0	1	0.00000
ERR2560660_1_kneaddata_paired	Bacteroidota	4587	P	1957419	1893	1959312	0.34211
ERR2560660_1_kneaddata_paired	Firmicutes	12188	P	1681496	12403	1693899	0.29577
ERR2560660_1_kneaddata_paired	Verrucomicrobiota	33333	P	1170192	35928	1206120	0.21060
ERR2560660_1_kneaddata_paired	Firmicutes_A	14608	P	663895	2789	666684	0.11641
ERR2560660_1_kneaddata_paired	Actinobacteriota	615	P	146196	80	146276	0.02554
ERR2560660_1_kneaddata_paired	Desulfobacterota_A	11509	P	42080	14	42094	0.00735
ERR2560660_1_kneaddata_paired	Proteobacteria	22518	P	10888	24	10912	0.00191
ERR2560660_1_kneaddata_paired	Cyanobacteria	9876	P	1223	16	1239	0.00022
ERR2560660_1_kneaddata_paired	Spirochaetota	32587	P	279	0	279	0.00005
ERR2560660_1_kneaddata_paired	Firmicutes_B	17289	P	151	3	154	0.00003
ERR2560660_1_kneaddata_paired	Campylobacterota	8700	P	65	0	65	0.00001
ERR2560660_1_kneaddata_paired	Firmicutes_I	18140	P	19	0	19	0.00000
ERR2560660_1_kneaddata_paired	Deferribacterota	10822	P	8	0	8	0.00000
ERR2560660_1_kneaddata_paired	Firmicutes_C	17613	P	5	0	5	0.00000
ERR2560660_1_kneaddata_paired	Elusimicrobiota	11888	P	4	0	4	0.00000
ERR2560660_1_kneaddata_paired	Thermotogota	33086	P	3	0	3	0.00000
ERR2560661_1_kneaddata_paired	Bacteroidota	4587	P	2167409	2129	2169538	0.34252
ERR2560661_1_kneaddata_paired	Firmicutes	12188	P	1877984	14014	1891998	0.29870
ERR2560661_1_kneaddata_paired	Verrucomicrobiota	33333	P	1275114	39664	1314778	0.20757
ERR2560661_1_kneaddata_paired	Firmicutes_A	14608	P	736487	3142	739629	0.11677
ERR2560661_1_kneaddata_paired	Actinobacteriota	615	P	158090	88	158178	0.02497
ERR2560661_1_kneaddata_paired	Desulfobacterota_A	11509	P	46068	17	46085	0.00728
ERR2560661_1_kneaddata_paired	Proteobacteria	22518	P	11888	27	11915	0.00188
ERR2560661_1_kneaddata_paired	Cyanobacteria	9876	P	1340	17	1357	0.00021
ERR2560661_1_kneaddata_paired	Spirochaetota	32587	P	333	0	333	0.00005
ERR2560661_1_kneaddata_paired	Firmicutes_B	17289	P	165	3	168	0.00003
ERR2560661_1_kneaddata_paired	Campylobacterota	8700	P	66	0	66	0.00001
ERR2560661_1_kneaddata_paired	Firmicutes_I	18140	P	30	0	30	0.00000
ERR2560661_1_kneaddata_paired	Deferribacterota	10822	P	17	0	17	0.00000
ERR2560661_1_kneaddata_paired	Elusimicrobiota	11888	P	6	0	6	0.00000
ERR2560661_1_kneaddata_paired	Firmicutes_C	17613	P	6	0	6	0.00000
ERR2560661_1_kneaddata_paired	Thermotogota	33086	P	3	0	3	0.00000
ERR2560662_1_kneaddata_paired	Bacteroidota	4587	P	2178054	2138	2180192	0.34809
ERR2560662_1_kneaddata_paired	Firmicutes	12188	P	1826607	13833	1840440	0.29385
ERR2560662_1_kneaddata_paired	Verrucomicrobiota	33333	P	1248340	39377	1287717	0.20560
ERR2560662_1_kneaddata_paired	Firmicutes_A	14608	P	732165	3166	735331	0.11740
ERR2560662_1_kneaddata_paired	Actinobacteriota	615	P	159949	89	160038	0.02555
ERR2560662_1_kneaddata_paired	Desulfobacterota_A	11509	P	45338	14	45352	0.00724
ERR2560662_1_kneaddata_paired	Proteobacteria	22518	P	12226	28	12254	0.00196
ERR2560662_1_kneaddata_paired	Cyanobacteria	9876	P	1302	14	1316	0.00021
ERR2560662_1_kneaddata_paired	Spirochaetota	32587	P	331	0	331	0.00005
ERR2560662_1_kneaddata_paired	Firmicutes_B	17289	P	140	2	142	0.00002
ERR2560662_1_kneaddata_paired	Campylobacterota	8700	P	58	0	58	0.00001
ERR2560662_1_kneaddata_paired	Deferribacterota	10822	P	28	0	28	0.00000
ERR2560662_1_kneaddata_paired	Firmicutes_I	18140	P	21	0	21	0.00000
ERR2560662_1_kneaddata_paired	Thermotogota	33086	P	6	0	6	0.00000
ERR2560662_1_kneaddata_paired	Elusimicrobiota	11888	P	4	0	4	0.00000
ERR2560662_1_kneaddata_paired	Firmicutes_C	17613	P	1	0	1	0.00000
ERR2560663_1_kneaddata_paired	Bacteroidota	4587	P	2526549	8921	2535470	0.46102
ERR2560663_1_kneaddata_paired	Firmicutes	12188	P	2385370	59560	2444930	0.44456
ERR2560663_1_kneaddata_paired	Firmicutes_A	14608	P	391714	4797	396511	0.07210
ERR2560663_1_kneaddata_paired	Actinobacteriota	615	P	111681	242	111923	0.02035
ERR2560663_1_kneaddata_paired	Verrucomicrobiota	33333	P	6136	640	6776	0.00123
ERR2560663_1_kneaddata_paired	Cyanobacteria	9876	P	2302	116	2418	0.00044
ERR2560663_1_kneaddata_paired	Proteobacteria	22518	P	982	6	988	0.00018
ERR2560663_1_kneaddata_paired	Spirochaetota	32587	P	424	0	424	0.00008
ERR2560663_1_kneaddata_paired	Firmicutes_B	17289	P	105	7	112	0.00002
ERR2560663_1_kneaddata_paired	Desulfobacterota_A	11509	P	69	3	72	0.00001
ERR2560663_1_kneaddata_paired	Firmicutes_I	18140	P	25	0	25	0.00000
ERR2560663_1_kneaddata_paired	Deferribacterota	10822	P	13	0	13	0.00000
ERR2560663_1_kneaddata_paired	Campylobacterota	8700	P	12	0	12	0.00000
ERR2560663_1_kneaddata_paired	Firmicutes_C	17613	P	5	0	5	0.00000
ERR2560663_1_kneaddata_paired	Elusimicrobiota	11888	P	3	0	3	0.00000
ERR2560663_1_kneaddata_paired	Thermotogota	33086	P	1	0	1	0.00000
ERR2560664_1_kneaddata_paired	Bacteroidota	4587	P	2787743	9956	2797699	0.45906
ERR2560664_1_kneaddata_paired	Firmicutes	12188	P	2656154	66974	2723128	0.44683
ERR2560664_1_kneaddata_paired	Firmicutes_A	14608	P	434871	5389	440260	0.07224
ERR2560664_1_kneaddata_paired	Actinobacteriota	615	P	121227	267	121494	0.01994
ERR2560664_1_kneaddata_paired	Verrucomicrobiota	33333	P	6525	684	7209	0.00118
ERR2560664_1_kneaddata_paired	Cyanobacteria	9876	P	2575	127	2702	0.00044
ERR2560664_1_kneaddata_paired	Proteobacteria	22518	P	1070	7	1077	0.00018
ERR2560664_1_kneaddata_paired	Spirochaetota	32587	P	503	0	503	0.00008
ERR2560664_1_kneaddata_paired	Firmicutes_B	17289	P	114	7	121	0.00002
ERR2560664_1_kneaddata_paired	Desulfobacterota_A	11509	P	71	5	76	0.00001
ERR2560664_1_kneaddata_paired	Firmicutes_I	18140	P	40	0	40	0.00001
ERR2560664_1_kneaddata_paired	Deferribacterota	10822	P	15	0	15	0.00000
ERR2560664_1_kneaddata_paired	Campylobacterota	8700	P	9	0	9	0.00000
ERR2560664_1_kneaddata_paired	Elusimicrobiota	11888	P	6	0	6	0.00000
ERR2560664_1_kneaddata_paired	Firmicutes_C	17613	P	1	0	1	0.00000
ERR2560665_1_kneaddata_paired	Bacteroidota	4587	P	2776804	10045	2786849	0.46350
ERR2560665_1_kneaddata_paired	Firmicutes	12188	P	2589717	66305	2656022	0.44174
ERR2560665_1_kneaddata_paired	Firmicutes_A	14608	P	432044	5465	437509	0.07276
ERR2560665_1_kneaddata_paired	Actinobacteriota	615	P	119947	266	120213	0.01999
ERR2560665_1_kneaddata_paired	Verrucomicrobiota	33333	P	6563	704	7267	0.00121
ERR2560665_1_kneaddata_paired	Cyanobacteria	9876	P	2689	137	2826	0.00047
ERR2560665_1_kneaddata_paired	Proteobacteria	22518	P	1154	7	1161	0.00019
ERR2560665_1_kneaddata_paired	Spirochaetota	32587	P	547	0	547	0.00009
ERR2560665_1_kneaddata_paired	Firmicutes_B	17289	P	101	7	108	0.00002
ERR2560665_1_kneaddata_paired	Desulfobacterota_A	11509	P	82	10	92	0.00002
ERR2560665_1_kneaddata_paired	Firmicutes_I	18140	P	19	0	19	0.00000
ERR2560665_1_kneaddata_paired	Campylobacterota	8700	P	18	0	18	0.00000
ERR2560665_1_kneaddata_paired	Deferribacterota	10822	P	6	0	6	0.00000
ERR2560665_1_kneaddata_paired	Elusimicrobiota	11888	P	6	0	6	0.00000
ERR2560665_1_kneaddata_paired	Firmicutes_C	17613	P	1	0	1	0.00000
ERR2560666_1_kneaddata_paired	Bacteroidota	4587	P	1839402	1440	1840842	0.34042
ERR2560666_1_kneaddata_paired	Verrucomicrobiota	33333	P	1607708	48282	1655990	0.30624
ERR2560666_1_kneaddata_paired	Firmicutes	12188	P	1401313	6633	1407946	0.26037
ERR2560666_1_kneaddata_paired	Firmicutes_A	14608	P	418904	1431	420335	0.07773
ERR2560666_1_kneaddata_paired	Actinobacteriota	615	P	71572	462	72034	0.01332
ERR2560666_1_kneaddata_paired	Desulfobacterota_A	11509	P	4804	4	4808	0.00089
ERR2560666_1_kneaddata_paired	Cyanobacteria	9876	P	2080	7	2087	0.00039
ERR2560666_1_kneaddata_paired	Proteobacteria	22518	P	1229	2	1231	0.00023
ERR2560666_1_kneaddata_paired	Campylobacterota	8700	P	1015	0	1015	0.00019
ERR2560666_1_kneaddata_paired	Spirochaetota	32587	P	599	0	599	0.00011
ERR2560666_1_kneaddata_paired	Firmicutes_B	17289	P	309	6	315	0.00006
ERR2560666_1_kneaddata_paired	Firmicutes_I	18140	P	231	0	231	0.00004
ERR2560666_1_kneaddata_paired	Deferribacterota	10822	P	49	0	49	0.00001
ERR2560666_1_kneaddata_paired	Thermotogota	33086	P	7	0	7	0.00000
ERR2560666_1_kneaddata_paired	Firmicutes_C	17613	P	5	0	5	0.00000
ERR2560667_1_kneaddata_paired	Bacteroidota	4587	P	2021691	1631	2023322	0.34133
ERR2560667_1_kneaddata_paired	Verrucomicrobiota	33333	P	1741395	53414	1794809	0.30278
ERR2560667_1_kneaddata_paired	Firmicutes	12188	P	1550086	7504	1557590	0.26277
ERR2560667_1_kneaddata_paired	Firmicutes_A	14608	P	460932	1610	462542	0.07803
ERR2560667_1_kneaddata_paired	Actinobacteriota	615	P	77569	511	78080	0.01317
ERR2560667_1_kneaddata_paired	Desulfobacterota_A	11509	P	5198	3	5201	0.00088
ERR2560667_1_kneaddata_paired	Cyanobacteria	9876	P	2290	9	2299	0.00039
ERR2560667_1_kneaddata_paired	Proteobacteria	22518	P	1410	3	1413	0.00024
ERR2560667_1_kneaddata_paired	Campylobacterota	8700	P	1106	0	1106	0.00019
ERR2560667_1_kneaddata_paired	Spirochaetota	32587	P	731	0	731	0.00012
ERR2560667_1_kneaddata_paired	Firmicutes_B	17289	P	282	5	287	0.00005
ERR2560667_1_kneaddata_paired	Firmicutes_I	18140	P	230	0	230	0.00004
ERR2560667_1_kneaddata_paired	Deferribacterota	10822	P	49	0	49	0.00001
ERR2560667_1_kneaddata_paired	Thermotogota	33086	P	13	0	13	0.00000
ERR2560667_1_kneaddata_paired	Firmicutes_C	17613	P	4	0	4	0.00000
ERR2560667_1_kneaddata_paired	Elusimicrobiota	11888	P	1	0	1	0.00000
ERR2560668_1_kneaddata_paired	Bacteroidota	4587	P	2031428	1670	2033098	0.34510
ERR2560668_1_kneaddata_paired	Verrucomicrobiota	33333	P	1715686	53832	1769518	0.30036
ERR2560668_1_kneaddata_paired	Firmicutes	12188	P	1526695	7562	1534257	0.26043
ERR2560668_1_kneaddata_paired	Firmicutes_A	14608	P	463469	1649	465118	0.07895
ERR2560668_1_kneaddata_paired	Actinobacteriota	615	P	77138	518	77656	0.01318
ERR2560668_1_kneaddata_paired	Desulfobacterota_A	11509	P	5138	4	5142	0.00087
ERR2560668_1_kneaddata_paired	Cyanobacteria	9876	P	2439	11	2450	0.00042
ERR2560668_1_kneaddata_paired	Proteobacteria	22518	P	1477	3	1480	0.00025
ERR2560668_1_kneaddata_paired	Campylobacterota	8700	P	1130	0	1130	0.00019
ERR2560668_1_kneaddata_paired	Spirochaetota	32587	P	789	0	789	0.00013
ERR2560668_1_kneaddata_paired	Firmicutes_B	17289	P	303	6	309	0.00005
ERR2560668_1_kneaddata_paired	Firmicutes_I	18140	P	261	0	261	0.00004
ERR2560668_1_kneaddata_paired	Deferribacterota	10822	P	55	0	55	0.00001
ERR2560668_1_kneaddata_paired	Elusimicrobiota	11888	P	5	0	5	0.00000
ERR2560668_1_kneaddata_paired	Thermotogota	33086	P	5	0	5	0.00000
ERR2560668_1_kneaddata_paired	Firmicutes_C	17613	P	2	0	2	0.00000
ERR2560669_1_kneaddata_paired	Firmicutes	12188	P	2425940	21674	2447614	0.47904
ERR2560669_1_kneaddata_paired	Verrucomicrobiota	33333	P	1416409	55759	1472168	0.28813
ERR2560669_1_kneaddata_paired	Firmicutes_A	14608	P	675632	2327	677959	0.13269
ERR2560669_1_kneaddata_paired	Actinobacteriota	615	P	337861	281	338142	0.06618
ERR2560669_1_kneaddata_paired	Bacteroidota	4587	P	169611	521	170132	0.03330
ERR2560669_1_kneaddata_paired	Cyanobacteria	9876	P	1501	10	1511	0.00030
ERR2560669_1_kneaddata_paired	Proteobacteria	22518	P	628	1	629	0.00012
ERR2560669_1_kneaddata_paired	Desulfobacterota_A	11509	P	325	6	331	0.00006
ERR2560669_1_kneaddata_paired	Campylobacterota	8700	P	296	0	296	0.00006
ERR2560669_1_kneaddata_paired	Spirochaetota	32587	P	251	0	251	0.00005
ERR2560669_1_kneaddata_paired	Firmicutes_B	17289	P	195	4	199	0.00004
ERR2560669_1_kneaddata_paired	Firmicutes_I	18140	P	153	0	153	0.00003
ERR2560669_1_kneaddata_paired	Deferribacterota	10822	P	48	0	48	0.00001
ERR2560669_1_kneaddata_paired	Elusimicrobiota	11888	P	20	0	20	0.00000
ERR2560669_1_kneaddata_paired	Firmicutes_C	17613	P	3	0	3	0.00000
ERR2560669_1_kneaddata_paired	Thermotogota	33086	P	1	0	1	0.00000
ERR2560670_1_kneaddata_paired	Firmicutes	12188	P	2729358	24401	2753759	0.48508
ERR2560670_1_kneaddata_paired	Verrucomicrobiota	33333	P	1550827	61138	1611965	0.28395
ERR2560670_1_kneaddata_paired	Firmicutes_A	14608	P	749989	2586	752575	0.13257
ERR2560670_1_kneaddata_paired	Actinobacteriota	615	P	366801	305	367106	0.06467
ERR2560670_1_kneaddata_paired	Bacteroidota	4587	P	187177	577	187754	0.03307
ERR2560670_1_kneaddata_paired	Cyanobacteria	9876	P	1712	9	1721	0.00030
ERR2560670_1_kneaddata_paired	Proteobacteria	22518	P	606	2	608	0.00011
ERR2560670_1_kneaddata_paired	Campylobacterota	8700	P	320	0	320	0.00006
ERR2560670_1_kneaddata_paired	Spirochaetota	32587	P	313	0	313	0.00006
ERR2560670_1_kneaddata_paired	Desulfobacterota_A	11509	P	304	5	309	0.00005
ERR2560670_1_kneaddata_paired	Firmicutes_B	17289	P	219	5	224	0.00004
ERR2560670_1_kneaddata_paired	Firmicutes_I	18140	P	200	0	200	0.00004
ERR2560670_1_kneaddata_paired	Deferribacterota	10822	P	22	0	22	0.00000
ERR2560670_1_kneaddata_paired	Elusimicrobiota	11888	P	16	0	16	0.00000
ERR2560670_1_kneaddata_paired	Firmicutes_C	17613	P	5	0	5	0.00000
ERR2560670_1_kneaddata_paired	Thermotogota	33086	P	1	0	1	0.00000
ERR2560671_1_kneaddata_paired	Firmicutes	12188	P	2696222	24904	2721126	0.48303
ERR2560671_1_kneaddata_paired	Verrucomicrobiota	33333	P	1535160	62596	1597756	0.28362
ERR2560671_1_kneaddata_paired	Firmicutes_A	14608	P	751610	2682	754292	0.13390
ERR2560671_1_kneaddata_paired	Actinobacteriota	615	P	366076	317	366393	0.06504
ERR2560671_1_kneaddata_paired	Bacteroidota	4587	P	189416	598	190014	0.03373
ERR2560671_1_kneaddata_paired	Cyanobacteria	9876	P	1698	10	1708	0.00030
ERR2560671_1_kneaddata_paired	Proteobacteria	22518	P	708	2	710	0.00013
ERR2560671_1_kneaddata_paired	Campylobacterota	8700	P	346	0	346	0.00006
ERR2560671_1_kneaddata_paired	Spirochaetota	32587	P	344	0	344	0.00006
ERR2560671_1_kneaddata_paired	Desulfobacterota_A	11509	P	312	6	318	0.00006
ERR2560671_1_kneaddata_paired	Firmicutes_B	17289	P	188	4	192	0.00003
ERR2560671_1_kneaddata_paired	Firmicutes_I	18140	P	145	0	145	0.00003
ERR2560671_1_kneaddata_paired	Deferribacterota	10822	P	40	0	40	0.00001
ERR2560671_1_kneaddata_paired	Elusimicrobiota	11888	P	11	0	11	0.00000
ERR2560671_1_kneaddata_paired	Firmicutes_C	17613	P	5	0	5	0.00000
ERR2560671_1_kneaddata_paired	Thermotogota	33086	P	2	0	2	0.00000
ERR2560672_1_kneaddata_paired	Bacteroidota	4587	P	5157800	10718	5168518	0.79996
ERR2560672_1_kneaddata_paired	Firmicutes	12188	P	631564	5182	636746	0.09855
ERR2560672_1_kneaddata_paired	Firmicutes_A	14608	P	419847	3157	423004	0.06547
ERR2560672_1_kneaddata_paired	Actinobacteriota	615	P	77343	604	77947	0.01206
ERR2560672_1_kneaddata_paired	Verrucomicrobiota	33333	P	73984	5532	79516	0.01231
ERR2560672_1_kneaddata_paired	Desulfobacterota_A	11509	P	72655	57	72712	0.01125
ERR2560672_1_kneaddata_paired	Cyanobacteria	9876	P	921	9	930	0.00014
ERR2560672_1_kneaddata_paired	Proteobacteria	22518	P	836	3	839	0.00013
ERR2560672_1_kneaddata_paired	Spirochaetota	32587	P	364	0	364	0.00006
ERR2560672_1_kneaddata_paired	Campylobacterota	8700	P	274	0	274	0.00004
ERR2560672_1_kneaddata_paired	Firmicutes_B	17289	P	74	3	77	0.00001
ERR2560672_1_kneaddata_paired	Deferribacterota	10822	P	34	0	34	0.00001
ERR2560672_1_kneaddata_paired	Firmicutes_I	18140	P	27	0	27	0.00000
ERR2560672_1_kneaddata_paired	Firmicutes_C	17613	P	7	0	7	0.00000
ERR2560672_1_kneaddata_paired	Elusimicrobiota	11888	P	3	0	3	0.00000
ERR2560673_1_kneaddata_paired	Bacteroidota	4587	P	5662140	11986	5674126	0.79869
ERR2560673_1_kneaddata_paired	Firmicutes	12188	P	700770	5831	706601	0.09946
ERR2560673_1_kneaddata_paired	Firmicutes_A	14608	P	466936	3560	470496	0.06623
ERR2560673_1_kneaddata_paired	Actinobacteriota	615	P	84209	669	84878	0.01195
ERR2560673_1_kneaddata_paired	Verrucomicrobiota	33333	P	80102	6069	86171	0.01213
ERR2560673_1_kneaddata_paired	Desulfobacterota_A	11509	P	79135	62	79197	0.01115
ERR2560673_1_kneaddata_paired	Cyanobacteria	9876	P	1064	11	1075	0.00015
ERR2560673_1_kneaddata_paired	Proteobacteria	22518	P	876	3	879	0.00012
ERR2560673_1_kneaddata_paired	Spirochaetota	32587	P	418	0	418	0.00006
ERR2560673_1_kneaddata_paired	Campylobacterota	8700	P	296	0	296	0.00004
ERR2560673_1_kneaddata_paired	Firmicutes_B	17289	P	83	4	87	0.00001
ERR2560673_1_kneaddata_paired	Deferribacterota	10822	P	45	0	45	0.00001
ERR2560673_1_kneaddata_paired	Firmicutes_I	18140	P	30	0	30	0.00000
ERR2560673_1_kneaddata_paired	Firmicutes_C	17613	P	3	0	3	0.00000
ERR2560674_1_kneaddata_paired	Bacteroidota	4587	P	5598947	12283	5611230	0.80040
ERR2560674_1_kneaddata_paired	Firmicutes	12188	P	681583	5926	687509	0.09807
ERR2560674_1_kneaddata_paired	Firmicutes_A	14608	P	460972	3670	464642	0.06628
ERR2560674_1_kneaddata_paired	Actinobacteriota	615	P	83600	692	84292	0.01202
ERR2560674_1_kneaddata_paired	Verrucomicrobiota	33333	P	77726	6143	83869	0.01196
ERR2560674_1_kneaddata_paired	Desulfobacterota_A	11509	P	76006	57	76063	0.01085
ERR2560674_1_kneaddata_paired	Cyanobacteria	9876	P	1064	12	1076	0.00015
ERR2560674_1_kneaddata_paired	Proteobacteria	22518	P	929	4	933	0.00013
ERR2560674_1_kneaddata_paired	Spirochaetota	32587	P	460	0	460	0.00007
ERR2560674_1_kneaddata_paired	Campylobacterota	8700	P	298	0	298	0.00004
ERR2560674_1_kneaddata_paired	Firmicutes_B	17289	P	88	4	92	0.00001
ERR2560674_1_kneaddata_paired	Firmicutes_I	18140	P	35	0	35	0.00000
ERR2560674_1_kneaddata_paired	Deferribacterota	10822	P	29	0	29	0.00000
ERR2560674_1_kneaddata_paired	Elusimicrobiota	11888	P	4	0	4	0.00000
ERR2560674_1_kneaddata_paired	Firmicutes_C	17613	P	4	0	4	0.00000
ERR2560674_1_kneaddata_paired	Thermotogota	33086	P	2	0	2	0.00000
ERR2560675_1_kneaddata_paired	Bacteroidota	4587	P	2532795	4942	2537737	0.46641
ERR2560675_1_kneaddata_paired	Firmicutes	12188	P	1749736	18020	1767756	0.32489
ERR2560675_1_kneaddata_paired	Firmicutes_A	14608	P	708964	6166	715130	0.13143
ERR2560675_1_kneaddata_paired	Verrucomicrobiota	33333	P	239209	20438	259647	0.04772
ERR2560675_1_kneaddata_paired	Actinobacteriota	615	P	137934	237	138171	0.02539
ERR2560675_1_kneaddata_paired	Desulfobacterota_A	11509	P	18364	22	18386	0.00338
ERR2560675_1_kneaddata_paired	Proteobacteria	22518	P	1446	7	1453	0.00027
ERR2560675_1_kneaddata_paired	Cyanobacteria	9876	P	1284	4	1288	0.00024
ERR2560675_1_kneaddata_paired	Campylobacterota	8700	P	997	2	999	0.00018
ERR2560675_1_kneaddata_paired	Spirochaetota	32587	P	292	0	292	0.00005
ERR2560675_1_kneaddata_paired	Firmicutes_B	17289	P	73	4	77	0.00001
ERR2560675_1_kneaddata_paired	Firmicutes_I	18140	P	33	0	33	0.00001
ERR2560675_1_kneaddata_paired	Deferribacterota	10822	P	16	0	16	0.00000
ERR2560675_1_kneaddata_paired	Firmicutes_C	17613	P	13	0	13	0.00000
ERR2560675_1_kneaddata_paired	Elusimicrobiota	11888	P	9	0	9	0.00000
ERR2560676_1_kneaddata_paired	Bacteroidota	4587	P	2780040	5524	2785564	0.46620
ERR2560676_1_kneaddata_paired	Firmicutes	12188	P	1926671	20329	1947000	0.32585
ERR2560676_1_kneaddata_paired	Firmicutes_A	14608	P	778103	6938	785041	0.13139
ERR2560676_1_kneaddata_paired	Verrucomicrobiota	33333	P	259639	22705	282344	0.04725
ERR2560676_1_kneaddata_paired	Actinobacteriota	615	P	150072	269	150341	0.02516
ERR2560676_1_kneaddata_paired	Desulfobacterota_A	11509	P	20092	19	20111	0.00337
ERR2560676_1_kneaddata_paired	Proteobacteria	22518	P	1569	7	1576	0.00026
ERR2560676_1_kneaddata_paired	Cyanobacteria	9876	P	1537	6	1543	0.00026
ERR2560676_1_kneaddata_paired	Campylobacterota	8700	P	1035	2	1037	0.00017
ERR2560676_1_kneaddata_paired	Spirochaetota	32587	P	338	0	338	0.00006
ERR2560676_1_kneaddata_paired	Firmicutes_B	17289	P	73	4	77	0.00001
ERR2560676_1_kneaddata_paired	Firmicutes_I	18140	P	42	0	42	0.00001
ERR2560676_1_kneaddata_paired	Firmicutes_C	17613	P	20	0	20	0.00000
ERR2560676_1_kneaddata_paired	Deferribacterota	10822	P	19	0	19	0.00000
ERR2560676_1_kneaddata_paired	Elusimicrobiota	11888	P	8	0	8	0.00000
ERR2560676_1_kneaddata_paired	Thermotogota	33086	P	4	0	4	0.00000
ERR2560677_1_kneaddata_paired	Bacteroidota	4587	P	2732544	5472	2738016	0.46854
ERR2560677_1_kneaddata_paired	Firmicutes	12188	P	1862043	19877	1881920	0.32204
ERR2560677_1_kneaddata_paired	Firmicutes_A	14608	P	769533	6902	776435	0.13287
ERR2560677_1_kneaddata_paired	Verrucomicrobiota	33333	P	252880	22393	275273	0.04711
ERR2560677_1_kneaddata_paired	Actinobacteriota	615	P	148033	266	148299	0.02538
ERR2560677_1_kneaddata_paired	Desulfobacterota_A	11509	P	19209	17	19226	0.00329
ERR2560677_1_kneaddata_paired	Proteobacteria	22518	P	1627	8	1635	0.00028
ERR2560677_1_kneaddata_paired	Cyanobacteria	9876	P	1482	5	1487	0.00025
ERR2560677_1_kneaddata_paired	Campylobacterota	8700	P	1027	2	1029	0.00018
ERR2560677_1_kneaddata_paired	Spirochaetota	32587	P	298	0	298	0.00005
ERR2560677_1_kneaddata_paired	Firmicutes_B	17289	P	74	4	78	0.00001
ERR2560677_1_kneaddata_paired	Firmicutes_I	18140	P	32	0	32	0.00001
ERR2560677_1_kneaddata_paired	Firmicutes_C	17613	P	22	0	22	0.00000
ERR2560677_1_kneaddata_paired	Deferribacterota	10822	P	15	0	15	0.00000
ERR2560677_1_kneaddata_paired	Elusimicrobiota	11888	P	5	0	5	0.00000
ERR2560677_1_kneaddata_paired	Thermotogota	33086	P	1	0	1	0.00000
ERR2560678_1_kneaddata_paired	Verrucomicrobiota	33333	P	3962465	56597	4019062	0.65393
ERR2560678_1_kneaddata_paired	Firmicutes	12188	P	1065792	1798	1067590	0.17370
ERR2560678_1_kneaddata_paired	Firmicutes_A	14608	P	1008396	2548	1010944	0.16449
ERR2560678_1_kneaddata_paired	Bacteroidota	4587	P	40087	61	40148	0.00653
ERR2560678_1_kneaddata_paired	Actinobacteriota	615	P	3107	1	3108	0.00051
ERR2560678_1_kneaddata_paired	Proteobacteria	22518	P	1636	1	1637	0.00027
ERR2560678_1_kneaddata_paired	Cyanobacteria	9876	P	1416	0	1416	0.00023
ERR2560678_1_kneaddata_paired	Desulfobacterota_A	11509	P	659	0	659	0.00011
ERR2560678_1_kneaddata_paired	Campylobacterota	8700	P	594	0	594	0.00010
ERR2560678_1_kneaddata_paired	Spirochaetota	32587	P	454	0	454	0.00007
ERR2560678_1_kneaddata_paired	Firmicutes_B	17289	P	407	3	410	0.00007
ERR2560678_1_kneaddata_paired	Thermotogota	33086	P	9	0	9	0.00000
ERR2560678_1_kneaddata_paired	Firmicutes_I	18140	P	8	0	8	0.00000
ERR2560679_1_kneaddata_paired	Verrucomicrobiota	33333	P	4275560	61880	4337440	0.64834
ERR2560679_1_kneaddata_paired	Firmicutes	12188	P	1182329	2022	1184351	0.17703
ERR2560679_1_kneaddata_paired	Firmicutes_A	14608	P	1112508	2854	1115362	0.16672
ERR2560679_1_kneaddata_paired	Bacteroidota	4587	P	43563	69	43632	0.00652
ERR2560679_1_kneaddata_paired	Actinobacteriota	615	P	3402	1	3403	0.00051
ERR2560679_1_kneaddata_paired	Proteobacteria	22518	P	1919	1	1920	0.00029
ERR2560679_1_kneaddata_paired	Cyanobacteria	9876	P	1511	0	1511	0.00023
ERR2560679_1_kneaddata_paired	Desulfobacterota_A	11509	P	723	0	723	0.00011
ERR2560679_1_kneaddata_paired	Campylobacterota	8700	P	721	0	721	0.00011
ERR2560679_1_kneaddata_paired	Spirochaetota	32587	P	493	0	493	0.00007
ERR2560679_1_kneaddata_paired	Firmicutes_B	17289	P	445	4	449	0.00007
ERR2560679_1_kneaddata_paired	Thermotogota	33086	P	13	0	13	0.00000
ERR2560679_1_kneaddata_paired	Firmicutes_I	18140	P	9	0	9	0.00000
ERR2560680_1_kneaddata_paired	Verrucomicrobiota	33333	P	4138358	62108	4200466	0.64442
ERR2560680_1_kneaddata_paired	Firmicutes	12188	P	1152748	2043	1154791	0.17716
ERR2560680_1_kneaddata_paired	Firmicutes_A	14608	P	1107917	2947	1110864	0.17042
ERR2560680_1_kneaddata_paired	Bacteroidota	4587	P	42598	69	42667	0.00655
ERR2560680_1_kneaddata_paired	Actinobacteriota	615	P	3503	1	3504	0.00054
ERR2560680_1_kneaddata_paired	Proteobacteria	22518	P	1923	1	1924	0.00030
ERR2560680_1_kneaddata_paired	Cyanobacteria	9876	P	1639	0	1639	0.00025
ERR2560680_1_kneaddata_paired	Desulfobacterota_A	11509	P	751	0	751	0.00012
ERR2560680_1_kneaddata_paired	Campylobacterota	8700	P	598	0	598	0.00009
ERR2560680_1_kneaddata_paired	Spirochaetota	32587	P	524	0	524	0.00008
ERR2560680_1_kneaddata_paired	Firmicutes_B	17289	P	458	4	462	0.00007
ERR2560680_1_kneaddata_paired	Firmicutes_I	18140	P	12	0	12	0.00000
ERR2560680_1_kneaddata_paired	Thermotogota	33086	P	10	0	10	0.00000
ERR2560681_1_kneaddata_paired	Verrucomicrobiota	33333	P	2748493	27603	2776096	0.60187
ERR2560681_1_kneaddata_paired	Firmicutes_A	14608	P	1357350	1841	1359191	0.29468
ERR2560681_1_kneaddata_paired	Firmicutes	12188	P	404403	737	405140	0.08784
ERR2560681_1_kneaddata_paired	Bacteroidota	4587	P	66922	35	66957	0.01452
ERR2560681_1_kneaddata_paired	Actinobacteriota	615	P	2059	0	2059	0.00045
ERR2560681_1_kneaddata_paired	Proteobacteria	22518	P	1128	1	1129	0.00024
ERR2560681_1_kneaddata_paired	Cyanobacteria	9876	P	827	0	827	0.00018
ERR2560681_1_kneaddata_paired	Desulfobacterota_A	11509	P	314	0	314	0.00007
ERR2560681_1_kneaddata_paired	Spirochaetota	32587	P	306	0	306	0.00007
ERR2560681_1_kneaddata_paired	Firmicutes_B	17289	P	209	1	210	0.00005
ERR2560681_1_kneaddata_paired	Campylobacterota	8700	P	178	0	178	0.00004
ERR2560681_1_kneaddata_paired	Thermotogota	33086	P	11	0	11	0.00000
ERR2560681_1_kneaddata_paired	Firmicutes_I	18140	P	7	0	7	0.00000
ERR2560681_1_kneaddata_paired	Firmicutes_C	17613	P	1	0	1	0.00000
ERR2560682_1_kneaddata_paired	Verrucomicrobiota	33333	P	3060814	31342	3092156	0.59978
ERR2560682_1_kneaddata_paired	Firmicutes_A	14608	P	1524072	2109	1526181	0.29603
ERR2560682_1_kneaddata_paired	Firmicutes	12188	P	456015	850	456865	0.08862
ERR2560682_1_kneaddata_paired	Bacteroidota	4587	P	74563	40	74603	0.01447
ERR2560682_1_kneaddata_paired	Actinobacteriota	615	P	2255	0	2255	0.00044
ERR2560682_1_kneaddata_paired	Proteobacteria	22518	P	1268	1	1269	0.00025
ERR2560682_1_kneaddata_paired	Cyanobacteria	9876	P	885	0	885	0.00017
ERR2560682_1_kneaddata_paired	Desulfobacterota_A	11509	P	405	0	405	0.00008
ERR2560682_1_kneaddata_paired	Spirochaetota	32587	P	350	0	350	0.00007
ERR2560682_1_kneaddata_paired	Firmicutes_B	17289	P	273	1	274	0.00005
ERR2560682_1_kneaddata_paired	Campylobacterota	8700	P	232	0	232	0.00005
ERR2560682_1_kneaddata_paired	Thermotogota	33086	P	15	0	15	0.00000
ERR2560682_1_kneaddata_paired	Firmicutes_I	18140	P	10	0	10	0.00000
ERR2560682_1_kneaddata_paired	Deferribacterota	10822	P	1	0	1	0.00000
ERR2560682_1_kneaddata_paired	Firmicutes_C	17613	P	1	0	1	0.00000
ERR2560683_1_kneaddata_paired	Verrucomicrobiota	33333	P	3044106	31785	3075891	0.59841
ERR2560683_1_kneaddata_paired	Firmicutes_A	14608	P	1526750	2159	1528909	0.29745
ERR2560683_1_kneaddata_paired	Firmicutes	12188	P	452523	861	453384	0.08821
ERR2560683_1_kneaddata_paired	Bacteroidota	4587	P	76044	41	76085	0.01480
ERR2560683_1_kneaddata_paired	Actinobacteriota	615	P	2374	0	2374	0.00046
ERR2560683_1_kneaddata_paired	Proteobacteria	22518	P	1285	1	1286	0.00025
ERR2560683_1_kneaddata_paired	Cyanobacteria	9876	P	914	0	914	0.00018
ERR2560683_1_kneaddata_paired	Desulfobacterota_A	11509	P	423	0	423	0.00008
ERR2560683_1_kneaddata_paired	Spirochaetota	32587	P	365	0	365	0.00007
ERR2560683_1_kneaddata_paired	Firmicutes_B	17289	P	224	1	225	0.00004
ERR2560683_1_kneaddata_paired	Campylobacterota	8700	P	206	0	206	0.00004
ERR2560683_1_kneaddata_paired	Thermotogota	33086	P	10	0	10	0.00000
ERR2560683_1_kneaddata_paired	Firmicutes_I	18140	P	5	0	5	0.00000
ERR2560684_1_kneaddata_paired	Firmicutes	12188	P	2793709	50823	2844532	0.46647
ERR2560684_1_kneaddata_paired	Bacteroidota	4587	P	2703413	13250	2716663	0.44550
ERR2560684_1_kneaddata_paired	Firmicutes_A	14608	P	293366	5847	299213	0.04907
ERR2560684_1_kneaddata_paired	Actinobacteriota	615	P	143148	520	143668	0.02356
ERR2560684_1_kneaddata_paired	Verrucomicrobiota	33333	P	56237	7720	63957	0.01049
ERR2560684_1_kneaddata_paired	Desulfobacterota_A	11509	P	23517	49	23566	0.00386
ERR2560684_1_kneaddata_paired	Cyanobacteria	9876	P	2507	52	2559	0.00042
ERR2560684_1_kneaddata_paired	Proteobacteria	22518	P	2007	11	2018	0.00033
ERR2560684_1_kneaddata_paired	Campylobacterota	8700	P	826	3	829	0.00014
ERR2560684_1_kneaddata_paired	Spirochaetota	32587	P	675	1	676	0.00011
ERR2560684_1_kneaddata_paired	Firmicutes_B	17289	P	136	12	148	0.00002
ERR2560684_1_kneaddata_paired	Thermotogota	33086	P	64	0	64	0.00001
ERR2560684_1_kneaddata_paired	Firmicutes_I	18140	P	54	0	54	0.00001
ERR2560684_1_kneaddata_paired	Deferribacterota	10822	P	25	0	25	0.00000
ERR2560684_1_kneaddata_paired	Firmicutes_C	17613	P	3	0	3	0.00000
ERR2560684_1_kneaddata_paired	Elusimicrobiota	11888	P	2	0	2	0.00000
ERR2560685_1_kneaddata_paired	Firmicutes	12188	P	3071462	56784	3128246	0.46796
ERR2560685_1_kneaddata_paired	Bacteroidota	4587	P	2957539	14803	2972342	0.44464
ERR2560685_1_kneaddata_paired	Firmicutes_A	14608	P	321498	6431	327929	0.04906
ERR2560685_1_kneaddata_paired	Actinobacteriota	615	P	155048	581	155629	0.02328
ERR2560685_1_kneaddata_paired	Verrucomicrobiota	33333	P	60146	8378	68524	0.01025
ERR2560685_1_kneaddata_paired	Desulfobacterota_A	11509	P	25056	51	25107	0.00376
ERR2560685_1_kneaddata_paired	Cyanobacteria	9876	P	2883	56	2939	0.00044
ERR2560685_1_kneaddata_paired	Proteobacteria	22518	P	2092	13	2105	0.00031
ERR2560685_1_kneaddata_paired	Campylobacterota	8700	P	916	3	919	0.00014
ERR2560685_1_kneaddata_paired	Spirochaetota	32587	P	818	1	819	0.00012
ERR2560685_1_kneaddata_paired	Firmicutes_B	17289	P	165	14	179	0.00003
ERR2560685_1_kneaddata_paired	Thermotogota	33086	P	57	0	57	0.00001
ERR2560685_1_kneaddata_paired	Firmicutes_I	18140	P	40	0	40	0.00001
ERR2560685_1_kneaddata_paired	Deferribacterota	10822	P	26	0	26	0.00000
ERR2560685_1_kneaddata_paired	Firmicutes_C	17613	P	3	0	3	0.00000
ERR2560685_1_kneaddata_paired	Elusimicrobiota	11888	P	2	0	2	0.00000
ERR2560686_1_kneaddata_paired	Firmicutes	12188	P	2965438	56523	3021961	0.46220
ERR2560686_1_kneaddata_paired	Bacteroidota	4587	P	2926521	14995	2941516	0.44990
ERR2560686_1_kneaddata_paired	Firmicutes_A	14608	P	316291	6498	322789	0.04937
ERR2560686_1_kneaddata_paired	Actinobacteriota	615	P	152378	586	152964	0.02340
ERR2560686_1_kneaddata_paired	Verrucomicrobiota	33333	P	58756	8437	67193	0.01028
ERR2560686_1_kneaddata_paired	Desulfobacterota_A	11509	P	24445	56	24501	0.00375
ERR2560686_1_kneaddata_paired	Cyanobacteria	9876	P	2919	58	2977	0.00046
ERR2560686_1_kneaddata_paired	Proteobacteria	22518	P	2200	13	2213	0.00034
ERR2560686_1_kneaddata_paired	Campylobacterota	8700	P	905	3	908	0.00014
ERR2560686_1_kneaddata_paired	Spirochaetota	32587	P	825	1	826	0.00013
ERR2560686_1_kneaddata_paired	Firmicutes_B	17289	P	148	13	161	0.00002
ERR2560686_1_kneaddata_paired	Firmicutes_I	18140	P	50	0	50	0.00001
ERR2560686_1_kneaddata_paired	Thermotogota	33086	P	48	0	48	0.00001
ERR2560686_1_kneaddata_paired	Deferribacterota	10822	P	22	0	22	0.00000
ERR2560686_1_kneaddata_paired	Elusimicrobiota	11888	P	11	0	11	0.00000
ERR2560686_1_kneaddata_paired	Firmicutes_C	17613	P	6	0	6	0.00000
ERR2560687_1_kneaddata_paired	Firmicutes	12188	P	2497260	13783	2511043	0.46351
ERR2560687_1_kneaddata_paired	Verrucomicrobiota	33333	P	1071622	37267	1108889	0.20469
ERR2560687_1_kneaddata_paired	Firmicutes_A	14608	P	874210	3406	877616	0.16200
ERR2560687_1_kneaddata_paired	Bacteroidota	4587	P	461187	505	461692	0.08522
ERR2560687_1_kneaddata_paired	Actinobacteriota	615	P	385075	1113	386188	0.07129
ERR2560687_1_kneaddata_paired	Desulfobacterota_A	11509	P	64568	25	64593	0.01192
ERR2560687_1_kneaddata_paired	Cyanobacteria	9876	P	5241	11	5252	0.00097
ERR2560687_1_kneaddata_paired	Proteobacteria	22518	P	1192	2	1194	0.00022
ERR2560687_1_kneaddata_paired	Campylobacterota	8700	P	452	0	452	0.00008
ERR2560687_1_kneaddata_paired	Spirochaetota	32587	P	355	0	355	0.00007
ERR2560687_1_kneaddata_paired	Firmicutes_B	17289	P	132	2	134	0.00002
ERR2560687_1_kneaddata_paired	Firmicutes_I	18140	P	46	0	46	0.00001
ERR2560687_1_kneaddata_paired	Elusimicrobiota	11888	P	24	0	24	0.00000
ERR2560687_1_kneaddata_paired	Deferribacterota	10822	P	11	0	11	0.00000
ERR2560687_1_kneaddata_paired	Thermotogota	33086	P	7	0	7	0.00000
ERR2560687_1_kneaddata_paired	Firmicutes_C	17613	P	3	0	3	0.00000
ERR2560688_1_kneaddata_paired	Firmicutes	12188	P	2739296	15339	2754635	0.46566
ERR2560688_1_kneaddata_paired	Verrucomicrobiota	33333	P	1158545	40844	1199389	0.20275
ERR2560688_1_kneaddata_paired	Firmicutes_A	14608	P	956394	3782	960176	0.16231
ERR2560688_1_kneaddata_paired	Bacteroidota	4587	P	504498	566	505064	0.08538
ERR2560688_1_kneaddata_paired	Actinobacteriota	615	P	415881	1221	417102	0.07051
ERR2560688_1_kneaddata_paired	Desulfobacterota_A	11509	P	70764	28	70792	0.01197
ERR2560688_1_kneaddata_paired	Cyanobacteria	9876	P	6069	13	6082	0.00103
ERR2560688_1_kneaddata_paired	Proteobacteria	22518	P	1193	2	1195	0.00020
ERR2560688_1_kneaddata_paired	Campylobacterota	8700	P	461	0	461	0.00008
ERR2560688_1_kneaddata_paired	Spirochaetota	32587	P	438	0	438	0.00007
ERR2560688_1_kneaddata_paired	Firmicutes_B	17289	P	175	4	179	0.00003
ERR2560688_1_kneaddata_paired	Firmicutes_I	18140	P	38	0	38	0.00001
ERR2560688_1_kneaddata_paired	Elusimicrobiota	11888	P	24	0	24	0.00000
ERR2560688_1_kneaddata_paired	Deferribacterota	10822	P	16	0	16	0.00000
ERR2560688_1_kneaddata_paired	Firmicutes_C	17613	P	7	0	7	0.00000
ERR2560688_1_kneaddata_paired	Thermotogota	33086	P	4	0	4	0.00000
ERR2560689_1_kneaddata_paired	Firmicutes	12188	P	2645153	15194	2660347	0.46177
ERR2560689_1_kneaddata_paired	Verrucomicrobiota	33333	P	1123098	40632	1163730	0.20200
ERR2560689_1_kneaddata_paired	Firmicutes_A	14608	P	947125	3831	950956	0.16506
ERR2560689_1_kneaddata_paired	Bacteroidota	4587	P	497539	563	498102	0.08646
ERR2560689_1_kneaddata_paired	Actinobacteriota	615	P	410555	1250	411805	0.07148
ERR2560689_1_kneaddata_paired	Desulfobacterota_A	11509	P	68284	29	68313	0.01186
ERR2560689_1_kneaddata_paired	Cyanobacteria	9876	P	5600	12	5612	0.00097
ERR2560689_1_kneaddata_paired	Proteobacteria	22518	P	1238	3	1241	0.00022
ERR2560689_1_kneaddata_paired	Campylobacterota	8700	P	444	0	444	0.00008
ERR2560689_1_kneaddata_paired	Spirochaetota	32587	P	375	0	375	0.00007
ERR2560689_1_kneaddata_paired	Firmicutes_B	17289	P	137	3	140	0.00002
ERR2560689_1_kneaddata_paired	Firmicutes_I	18140	P	36	0	36	0.00001
ERR2560689_1_kneaddata_paired	Elusimicrobiota	11888	P	15	0	15	0.00000
ERR2560689_1_kneaddata_paired	Deferribacterota	10822	P	8	0	8	0.00000
ERR2560689_1_kneaddata_paired	Thermotogota	33086	P	7	0	7	0.00000
ERR2560689_1_kneaddata_paired	Firmicutes_C	17613	P	3	0	3	0.00000
ERR3199521_1_kneaddata_paired	Bacteroidota	4587	P	19972020	83446	20055466	0.72557
ERR3199521_1_kneaddata_paired	Firmicutes_A	14608	P	4294545	56614	4351159	0.15742
ERR3199521_1_kneaddata_paired	Verrucomicrobiota	33333	P	920697	10278	930975	0.03368
ERR3199521_1_kneaddata_paired	Firmicutes	12188	P	698719	8607	707326	0.02559
ERR3199521_1_kneaddata_paired	Actinobacteriota	615	P	411478	812	412290	0.01492
ERR3199521_1_kneaddata_paired	Proteobacteria	22518	P	357720	6928	364648	0.01319
ERR3199521_1_kneaddata_paired	Spirochaetota	32587	P	211937	142	212079	0.00767
ERR3199521_1_kneaddata_paired	Desulfobacterota_A	11509	P	162755	2091	164846	0.00596
ERR3199521_1_kneaddata_paired	Campylobacterota	8700	P	154579	31	154610	0.00559
ERR3199521_1_kneaddata_paired	Cyanobacteria	9876	P	108071	8151	116222	0.00420
ERR3199521_1_kneaddata_paired	Elusimicrobiota	11888	P	103390	0	103390	0.00374
ERR3199521_1_kneaddata_paired	Deferribacterota	10822	P	66593	317	66910	0.00242
ERR3199521_1_kneaddata_paired	Firmicutes_B	17289	P	595	27	622	0.00002
ERR3199521_1_kneaddata_paired	Firmicutes_I	18140	P	257	0	257	0.00001
ERR3199521_1_kneaddata_paired	Firmicutes_C	17613	P	97	0	97	0.00000
ERR3199521_1_kneaddata_paired	Thermotogota	33086	P	14	0	14	0.00000
ERR3199522_1_kneaddata_paired	Bacteroidota	4587	P	20859766	84693	20944459	0.68109
ERR3199522_1_kneaddata_paired	Firmicutes_A	14608	P	5417168	57880	5475048	0.17804
ERR3199522_1_kneaddata_paired	Firmicutes	12188	P	1068228	10948	1079176	0.03509
ERR3199522_1_kneaddata_paired	Verrucomicrobiota	33333	P	1020920	8889	1029809	0.03349
ERR3199522_1_kneaddata_paired	Proteobacteria	22518	P	595883	3548	599431	0.01949
ERR3199522_1_kneaddata_paired	Spirochaetota	32587	P	461516	237	461753	0.01502
ERR3199522_1_kneaddata_paired	Actinobacteriota	615	P	445808	840	446648	0.01452
ERR3199522_1_kneaddata_paired	Cyanobacteria	9876	P	358970	23372	382342	0.01243
ERR3199522_1_kneaddata_paired	Campylobacterota	8700	P	140045	2	140047	0.00455
ERR3199522_1_kneaddata_paired	Desulfobacterota_A	11509	P	92080	956	93036	0.00303
ERR3199522_1_kneaddata_paired	Elusimicrobiota	11888	P	65185	0	65185	0.00212
ERR3199522_1_kneaddata_paired	Deferribacterota	10822	P	32754	119	32873	0.00107
ERR3199522_1_kneaddata_paired	Firmicutes_B	17289	P	733	25	758	0.00002
ERR3199522_1_kneaddata_paired	Firmicutes_I	18140	P	520	0	520	0.00002
ERR3199522_1_kneaddata_paired	Firmicutes_C	17613	P	145	0	145	0.00000
ERR3199522_1_kneaddata_paired	Thermotogota	33086	P	23	0	23	0.00000
ERR3199523_1_kneaddata_paired	Bacteroidota	4587	P	17951170	70446	18021616	0.64498
ERR3199523_1_kneaddata_paired	Firmicutes_A	14608	P	5588224	46820	5635044	0.20167
ERR3199523_1_kneaddata_paired	Verrucomicrobiota	33333	P	2015972	23509	2039481	0.07299
ERR3199523_1_kneaddata_paired	Firmicutes	12188	P	869495	11654	881149	0.03154
ERR3199523_1_kneaddata_paired	Actinobacteriota	615	P	862600	1456	864056	0.03092
ERR3199523_1_kneaddata_paired	Proteobacteria	22518	P	185266	388	185654	0.00664
ERR3199523_1_kneaddata_paired	Spirochaetota	32587	P	85833	61	85894	0.00307
ERR3199523_1_kneaddata_paired	Cyanobacteria	9876	P	78456	6624	85080	0.00304
ERR3199523_1_kneaddata_paired	Desulfobacterota_A	11509	P	69347	1205	70552	0.00253
ERR3199523_1_kneaddata_paired	Campylobacterota	8700	P	46715	3	46718	0.00167
ERR3199523_1_kneaddata_paired	Deferribacterota	10822	P	13876	69	13945	0.00050
ERR3199523_1_kneaddata_paired	Elusimicrobiota	11888	P	11337	0	11337	0.00041
ERR3199523_1_kneaddata_paired	Firmicutes_B	17289	P	404	19	423	0.00002
ERR3199523_1_kneaddata_paired	Firmicutes_I	18140	P	339	0	339	0.00001
ERR3199523_1_kneaddata_paired	Firmicutes_C	17613	P	80	0	80	0.00000
ERR3199523_1_kneaddata_paired	Thermotogota	33086	P	14	0	14	0.00000
ERR3199524_1_kneaddata_paired	Bacteroidota	4587	P	1731443	10105	1741548	0.38491
ERR3199524_1_kneaddata_paired	Verrucomicrobiota	33333	P	1570768	8391	1579159	0.34902
ERR3199524_1_kneaddata_paired	Firmicutes_A	14608	P	634461	2700	637161	0.14082
ERR3199524_1_kneaddata_paired	Proteobacteria	22518	P	318878	289	319167	0.07054
ERR3199524_1_kneaddata_paired	Firmicutes	12188	P	142615	393	143008	0.03161
ERR3199524_1_kneaddata_paired	Deferribacterota	10822	P	22584	51	22635	0.00500
ERR3199524_1_kneaddata_paired	Desulfobacterota_A	11509	P	21369	107	21476	0.00475
ERR3199524_1_kneaddata_paired	Actinobacteriota	615	P	20446	75	20521	0.00454
ERR3199524_1_kneaddata_paired	Campylobacterota	8700	P	17791	0	17791	0.00393
ERR3199524_1_kneaddata_paired	Cyanobacteria	9876	P	13240	284	13524	0.00299
ERR3199524_1_kneaddata_paired	Elusimicrobiota	11888	P	5160	0	5160	0.00114
ERR3199524_1_kneaddata_paired	Spirochaetota	32587	P	3206	1	3207	0.00071
ERR3199524_1_kneaddata_paired	Firmicutes_B	17289	P	106	2	108	0.00002
ERR3199524_1_kneaddata_paired	Firmicutes_I	18140	P	31	0	31	0.00001
ERR3199524_1_kneaddata_paired	Firmicutes_C	17613	P	10	0	10	0.00000
ERR3199524_1_kneaddata_paired	Thermotogota	33086	P	3	0	3	0.00000
ERR3199525_1_kneaddata_paired	Bacteroidota	4587	P	14899470	69796	14969266	0.53937
ERR3199525_1_kneaddata_paired	Firmicutes_A	14608	P	8811107	34858	8845965	0.31874
ERR3199525_1_kneaddata_paired	Firmicutes	12188	P	1993530	20344	2013874	0.07256
ERR3199525_1_kneaddata_paired	Verrucomicrobiota	33333	P	733206	5511	738717	0.02662
ERR3199525_1_kneaddata_paired	Actinobacteriota	615	P	383465	429	383894	0.01383
ERR3199525_1_kneaddata_paired	Desulfobacterota_A	11509	P	265235	2281	267516	0.00964
ERR3199525_1_kneaddata_paired	Proteobacteria	22518	P	181195	1544	182739	0.00658
ERR3199525_1_kneaddata_paired	Cyanobacteria	9876	P	122224	6745	128969	0.00465
ERR3199525_1_kneaddata_paired	Elusimicrobiota	11888	P	117198	0	117198	0.00422
ERR3199525_1_kneaddata_paired	Campylobacterota	8700	P	73991	6	73997	0.00267
ERR3199525_1_kneaddata_paired	Deferribacterota	10822	P	27078	86	27164	0.00098
ERR3199525_1_kneaddata_paired	Spirochaetota	32587	P	2464	2	2466	0.00009
ERR3199525_1_kneaddata_paired	Firmicutes_B	17289	P	921	28	949	0.00003
ERR3199525_1_kneaddata_paired	Firmicutes_I	18140	P	350	0	350	0.00001
ERR3199525_1_kneaddata_paired	Firmicutes_C	17613	P	229	0	229	0.00001
ERR3199525_1_kneaddata_paired	Thermotogota	33086	P	20	0	20	0.00000
ERR3199526_1_kneaddata_paired	Bacteroidota	4587	P	14916896	59195	14976091	0.53908
ERR3199526_1_kneaddata_paired	Firmicutes_A	14608	P	9398329	39505	9437834	0.33973
ERR3199526_1_kneaddata_paired	Verrucomicrobiota	33333	P	995338	8949	1004287	0.03615
ERR3199526_1_kneaddata_paired	Firmicutes	12188	P	671423	4176	675599	0.02432
ERR3199526_1_kneaddata_paired	Cyanobacteria	9876	P	467597	33973	501570	0.01805
ERR3199526_1_kneaddata_paired	Desulfobacterota_A	11509	P	298513	3045	301558	0.01085
ERR3199526_1_kneaddata_paired	Proteobacteria	22518	P	270560	2368	272928	0.00982
ERR3199526_1_kneaddata_paired	Campylobacterota	8700	P	241695	36	241731	0.00870
ERR3199526_1_kneaddata_paired	Elusimicrobiota	11888	P	197653	0	197653	0.00711
ERR3199526_1_kneaddata_paired	Actinobacteriota	615	P	100007	200	100207	0.00361
ERR3199526_1_kneaddata_paired	Deferribacterota	10822	P	68328	261	68589	0.00247
ERR3199526_1_kneaddata_paired	Spirochaetota	32587	P	1154	1	1155	0.00004
ERR3199526_1_kneaddata_paired	Firmicutes_B	17289	P	868	31	899	0.00003
ERR3199526_1_kneaddata_paired	Firmicutes_I	18140	P	345	0	345	0.00001
ERR3199526_1_kneaddata_paired	Firmicutes_C	17613	P	169	0	169	0.00001
ERR3199526_1_kneaddata_paired	Thermotogota	33086	P	96	0	96	0.00000
ERR3199527_1_kneaddata_paired	Bacteroidota	4587	P	17797878	66710	17864588	0.67297
ERR3199527_1_kneaddata_paired	Firmicutes_A	14608	P	5882262	27125	5909387	0.22261
ERR3199527_1_kneaddata_paired	Firmicutes	12188	P	906212	52934	959146	0.03613
ERR3199527_1_kneaddata_paired	Verrucomicrobiota	33333	P	819164	7354	826518	0.03114
ERR3199527_1_kneaddata_paired	Actinobacteriota	615	P	303494	594	304088	0.01146
ERR3199527_1_kneaddata_paired	Spirochaetota	32587	P	218609	116	218725	0.00824
ERR3199527_1_kneaddata_paired	Desulfobacterota_A	11509	P	207761	1925	209686	0.00790
ERR3199527_1_kneaddata_paired	Proteobacteria	22518	P	91646	651	92297	0.00348
ERR3199527_1_kneaddata_paired	Campylobacterota	8700	P	74138	25	74163	0.00279
ERR3199527_1_kneaddata_paired	Elusimicrobiota	11888	P	35538	0	35538	0.00134
ERR3199527_1_kneaddata_paired	Deferribacterota	10822	P	28477	106	28583	0.00108
ERR3199527_1_kneaddata_paired	Cyanobacteria	9876	P	21251	1026	22277	0.00084
ERR3199527_1_kneaddata_paired	Firmicutes_B	17289	P	517	18	535	0.00002
ERR3199527_1_kneaddata_paired	Firmicutes_I	18140	P	349	0	349	0.00001
ERR3199527_1_kneaddata_paired	Firmicutes_C	17613	P	99	0	99	0.00000
ERR3199527_1_kneaddata_paired	Thermotogota	33086	P	15	0	15	0.00000
ERR3199528_1_kneaddata_paired	Bacteroidota	4587	P	21020848	88371	21109219	0.78046
ERR3199528_1_kneaddata_paired	Firmicutes_A	14608	P	2065437	25066	2090503	0.07729
ERR3199528_1_kneaddata_paired	Verrucomicrobiota	33333	P	1823782	15581	1839363	0.06801
ERR3199528_1_kneaddata_paired	Proteobacteria	22518	P	564018	3081	567099	0.02097
ERR3199528_1_kneaddata_paired	Actinobacteriota	615	P	352966	561	353527	0.01307
ERR3199528_1_kneaddata_paired	Firmicutes	12188	P	334515	22505	357020	0.01320
ERR3199528_1_kneaddata_paired	Spirochaetota	32587	P	207015	106	207121	0.00766
ERR3199528_1_kneaddata_paired	Elusimicrobiota	11888	P	171855	0	171855	0.00635
ERR3199528_1_kneaddata_paired	Cyanobacteria	9876	P	133404	7503	140907	0.00521
ERR3199528_1_kneaddata_paired	Desulfobacterota_A	11509	P	96503	1081	97584	0.00361
ERR3199528_1_kneaddata_paired	Campylobacterota	8700	P	82993	6	82999	0.00307
ERR3199528_1_kneaddata_paired	Deferribacterota	10822	P	29249	106	29355	0.00109
ERR3199528_1_kneaddata_paired	Firmicutes_B	17289	P	353	12	365	0.00001
ERR3199528_1_kneaddata_paired	Firmicutes_I	18140	P	147	0	147	0.00001
ERR3199528_1_kneaddata_paired	Firmicutes_C	17613	P	81	0	81	0.00000
ERR3199528_1_kneaddata_paired	Thermotogota	33086	P	17	0	17	0.00000
ERR3199529_1_kneaddata_paired	Bacteroidota	4587	P	20437025	93916	20530941	0.78861
ERR3199529_1_kneaddata_paired	Firmicutes_A	14608	P	2746652	23201	2769853	0.10639
ERR3199529_1_kneaddata_paired	Firmicutes	12188	P	731369	15533	746902	0.02869
ERR3199529_1_kneaddata_paired	Spirochaetota	32587	P	388579	243	388822	0.01493
ERR3199529_1_kneaddata_paired	Proteobacteria	22518	P	307436	463	307899	0.01183
ERR3199529_1_kneaddata_paired	Verrucomicrobiota	33333	P	297695	3110	300805	0.01155
ERR3199529_1_kneaddata_paired	Actinobacteriota	615	P	266318	479	266797	0.01025
ERR3199529_1_kneaddata_paired	Cyanobacteria	9876	P	266036	22884	288920	0.01110
ERR3199529_1_kneaddata_paired	Campylobacterota	8700	P	241488	61	241549	0.00928
ERR3199529_1_kneaddata_paired	Elusimicrobiota	11888	P	89427	0	89427	0.00343
ERR3199529_1_kneaddata_paired	Desulfobacterota_A	11509	P	74160	1020	75180	0.00289
ERR3199529_1_kneaddata_paired	Deferribacterota	10822	P	26406	116	26522	0.00102
ERR3199529_1_kneaddata_paired	Firmicutes_I	18140	P	420	0	420	0.00002
ERR3199529_1_kneaddata_paired	Firmicutes_B	17289	P	314	13	327	0.00001
ERR3199529_1_kneaddata_paired	Firmicutes_C	17613	P	43	0	43	0.00000
ERR3199529_1_kneaddata_paired	Thermotogota	33086	P	9	0	9	0.00000
ERR3199530_1_kneaddata_paired	Bacteroidota	4587	P	13382056	42019	13424075	0.45471
ERR3199530_1_kneaddata_paired	Firmicutes_A	14608	P	13123723	123847	13247570	0.44874
ERR3199530_1_kneaddata_paired	Firmicutes	12188	P	618784	7007	625791	0.02120
ERR3199530_1_kneaddata_paired	Desulfobacterota_A	11509	P	496961	4623	501584	0.01699
ERR3199530_1_kneaddata_paired	Campylobacterota	8700	P	359573	16	359589	0.01218
ERR3199530_1_kneaddata_paired	Spirochaetota	32587	P	351595	179	351774	0.01192
ERR3199530_1_kneaddata_paired	Verrucomicrobiota	33333	P	350847	3006	353853	0.01199
ERR3199530_1_kneaddata_paired	Deferribacterota	10822	P	234091	850	234941	0.00796
ERR3199530_1_kneaddata_paired	Actinobacteriota	615	P	212634	406	213040	0.00722
ERR3199530_1_kneaddata_paired	Proteobacteria	22518	P	125256	519	125775	0.00426
ERR3199530_1_kneaddata_paired	Cyanobacteria	9876	P	73856	5086	78942	0.00267
ERR3199530_1_kneaddata_paired	Elusimicrobiota	11888	P	3656	0	3656	0.00012
ERR3199530_1_kneaddata_paired	Firmicutes_B	17289	P	921	31	952	0.00003
ERR3199530_1_kneaddata_paired	Firmicutes_I	18140	P	318	0	318	0.00001
ERR3199530_1_kneaddata_paired	Firmicutes_C	17613	P	97	0	97	0.00000
ERR3199530_1_kneaddata_paired	Thermotogota	33086	P	7	0	7	0.00000
ERR3199531_1_kneaddata_paired	Bacteroidota	4587	P	17153430	71364	17224794	0.62557
ERR3199531_1_kneaddata_paired	Firmicutes_A	14608	P	6621424	81763	6703187	0.24345
ERR3199531_1_kneaddata_paired	Verrucomicrobiota	33333	P	982477	9365	991842	0.03602
ERR3199531_1_kneaddata_paired	Spirochaetota	32587	P	521816	299	522115	0.01896
ERR3199531_1_kneaddata_paired	Elusimicrobiota	11888	P	457618	0	457618	0.01662
ERR3199531_1_kneaddata_paired	Firmicutes	12188	P	452507	5816	458323	0.01665
ERR3199531_1_kneaddata_paired	Actinobacteriota	615	P	394624	831	395455	0.01436
ERR3199531_1_kneaddata_paired	Desulfobacterota_A	11509	P	266969	3234	270203	0.00981
ERR3199531_1_kneaddata_paired	Proteobacteria	22518	P	218276	1176	219452	0.00797
ERR3199531_1_kneaddata_paired	Campylobacterota	8700	P	216293	16	216309	0.00786
ERR3199531_1_kneaddata_paired	Cyanobacteria	9876	P	48538	3309	51847	0.00188
ERR3199531_1_kneaddata_paired	Deferribacterota	10822	P	22314	90	22404	0.00081
ERR3199531_1_kneaddata_paired	Firmicutes_B	17289	P	590	23	613	0.00002
ERR3199531_1_kneaddata_paired	Firmicutes_I	18140	P	255	0	255	0.00001
ERR3199531_1_kneaddata_paired	Firmicutes_C	17613	P	101	0	101	0.00000
ERR3199531_1_kneaddata_paired	Thermotogota	33086	P	9	0	9	0.00000
ERR3199532_1_kneaddata_paired	Bacteroidota	4587	P	12074737	59175	12133912	0.41797
ERR3199532_1_kneaddata_paired	Firmicutes_A	14608	P	11971916	61443	12033359	0.41451
ERR3199532_1_kneaddata_paired	Verrucomicrobiota	33333	P	1486462	11956	1498418	0.05162
ERR3199532_1_kneaddata_paired	Spirochaetota	32587	P	758919	367	759286	0.02615
ERR3199532_1_kneaddata_paired	Campylobacterota	8700	P	720647	11	720658	0.02482
ERR3199532_1_kneaddata_paired	Firmicutes	12188	P	673554	3299	676853	0.02332
ERR3199532_1_kneaddata_paired	Desulfobacterota_A	11509	P	422776	4137	426913	0.01471
ERR3199532_1_kneaddata_paired	Proteobacteria	22518	P	354666	441	355107	0.01223
ERR3199532_1_kneaddata_paired	Deferribacterota	10822	P	271294	934	272228	0.00938
ERR3199532_1_kneaddata_paired	Actinobacteriota	615	P	96412	190	96602	0.00333
ERR3199532_1_kneaddata_paired	Cyanobacteria	9876	P	51861	2685	54546	0.00188
ERR3199532_1_kneaddata_paired	Firmicutes_B	17289	P	1291	42	1333	0.00005
ERR3199532_1_kneaddata_paired	Elusimicrobiota	11888	P	943	0	943	0.00003
ERR3199532_1_kneaddata_paired	Firmicutes_I	18140	P	216	0	216	0.00001
ERR3199532_1_kneaddata_paired	Firmicutes_C	17613	P	191	0	191	0.00001
ERR3199532_1_kneaddata_paired	Thermotogota	33086	P	15	0	15	0.00000
ERR3199533_1_kneaddata_paired	Bacteroidota	4587	P	22306282	123963	22430245	0.73816
ERR3199533_1_kneaddata_paired	Firmicutes_A	14608	P	4455885	26615	4482500	0.14751
ERR3199533_1_kneaddata_paired	Firmicutes	12188	P	1515862	18562	1534424	0.05050
ERR3199533_1_kneaddata_paired	Verrucomicrobiota	33333	P	942443	9050	951493	0.03131
ERR3199533_1_kneaddata_paired	Actinobacteriota	615	P	383204	317	383521	0.01262
ERR3199533_1_kneaddata_paired	Cyanobacteria	9876	P	179568	13353	192921	0.00635
ERR3199533_1_kneaddata_paired	Proteobacteria	22518	P	135965	363	136328	0.00449
ERR3199533_1_kneaddata_paired	Desulfobacterota_A	11509	P	92044	1131	93175	0.00307
ERR3199533_1_kneaddata_paired	Spirochaetota	32587	P	71406	42	71448	0.00235
ERR3199533_1_kneaddata_paired	Campylobacterota	8700	P	61691	5	61696	0.00203
ERR3199533_1_kneaddata_paired	Elusimicrobiota	11888	P	37827	0	37827	0.00124
ERR3199533_1_kneaddata_paired	Deferribacterota	10822	P	9568	38	9606	0.00032
ERR3199533_1_kneaddata_paired	Firmicutes_I	18140	P	807	0	807	0.00003
ERR3199533_1_kneaddata_paired	Firmicutes_B	17289	P	659	25	684	0.00002
ERR3199533_1_kneaddata_paired	Firmicutes_C	17613	P	126	0	126	0.00000
ERR3199533_1_kneaddata_paired	Thermotogota	33086	P	23	0	23	0.00000
ERR3199534_1_kneaddata_paired	Bacteroidota	4587	P	11673393	69542	11742935	0.50228
ERR3199534_1_kneaddata_paired	Firmicutes_A	14608	P	5520900	33071	5553971	0.23756
ERR3199534_1_kneaddata_paired	Verrucomicrobiota	33333	P	2711431	28391	2739822	0.11719
ERR3199534_1_kneaddata_paired	Campylobacterota	8700	P	859614	131	859745	0.03677
ERR3199534_1_kneaddata_paired	Proteobacteria	22518	P	553295	412	553707	0.02368
ERR3199534_1_kneaddata_paired	Desulfobacterota_A	11509	P	543387	5726	549113	0.02349
ERR3199534_1_kneaddata_paired	Firmicutes	12188	P	474028	6981	481009	0.02057
ERR3199534_1_kneaddata_paired	Elusimicrobiota	11888	P	356679	0	356679	0.01526
ERR3199534_1_kneaddata_paired	Actinobacteriota	615	P	271205	1622	272827	0.01167
ERR3199534_1_kneaddata_paired	Spirochaetota	32587	P	129668	82	129750	0.00555
ERR3199534_1_kneaddata_paired	Deferribacterota	10822	P	108025	482	108507	0.00464
ERR3199534_1_kneaddata_paired	Cyanobacteria	9876	P	28252	1353	29605	0.00127
ERR3199534_1_kneaddata_paired	Firmicutes_B	17289	P	918	39	957	0.00004
ERR3199534_1_kneaddata_paired	Firmicutes_I	18140	P	390	0	390	0.00002
ERR3199534_1_kneaddata_paired	Firmicutes_C	17613	P	179	0	179	0.00001
ERR3199534_1_kneaddata_paired	Thermotogota	33086	P	18	0	18	0.00000
ERR3199535_1_kneaddata_paired	Bacteroidota	4587	P	11133658	40463	11174121	0.47548
ERR3199535_1_kneaddata_paired	Firmicutes_A	14608	P	5731860	36259	5768119	0.24544
ERR3199535_1_kneaddata_paired	Verrucomicrobiota	33333	P	1913941	14174	1928115	0.08205
ERR3199535_1_kneaddata_paired	Elusimicrobiota	11888	P	1599379	0	1599379	0.06806
ERR3199535_1_kneaddata_paired	Firmicutes	12188	P	644096	11320	655416	0.02789
ERR3199535_1_kneaddata_paired	Proteobacteria	22518	P	599689	4307	603996	0.02570
ERR3199535_1_kneaddata_paired	Spirochaetota	32587	P	595882	268	596150	0.02537
ERR3199535_1_kneaddata_paired	Campylobacterota	8700	P	375500	31	375531	0.01598
ERR3199535_1_kneaddata_paired	Desulfobacterota_A	11509	P	322842	2732	325574	0.01385
ERR3199535_1_kneaddata_paired	Cyanobacteria	9876	P	250038	14175	264213	0.01124
ERR3199535_1_kneaddata_paired	Actinobacteriota	615	P	170859	318	171177	0.00728
ERR3199535_1_kneaddata_paired	Deferribacterota	10822	P	37585	120	37705	0.00160
ERR3199535_1_kneaddata_paired	Firmicutes_B	17289	P	548	16	564	0.00002
ERR3199535_1_kneaddata_paired	Firmicutes_I	18140	P	381	0	381	0.00002
ERR3199535_1_kneaddata_paired	Firmicutes_C	17613	P	133	0	133	0.00001
ERR3199535_1_kneaddata_paired	Thermotogota	33086	P	85	0	85	0.00000
ERR3199536_1_kneaddata_paired	Bacteroidota	4587	P	20130666	77614	20208280	0.70158
ERR3199536_1_kneaddata_paired	Firmicutes_A	14608	P	5100093	32480	5132573	0.17819
ERR3199536_1_kneaddata_paired	Firmicutes	12188	P	1430255	52720	1482975	0.05148
ERR3199536_1_kneaddata_paired	Actinobacteriota	615	P	794264	1495	795759	0.02763
ERR3199536_1_kneaddata_paired	Proteobacteria	22518	P	360957	501	361458	0.01255
ERR3199536_1_kneaddata_paired	Verrucomicrobiota	33333	P	257602	2845	260447	0.00904
ERR3199536_1_kneaddata_paired	Desulfobacterota_A	11509	P	152881	1766	154647	0.00537
ERR3199536_1_kneaddata_paired	Elusimicrobiota	11888	P	136577	0	136577	0.00474
ERR3199536_1_kneaddata_paired	Spirochaetota	32587	P	119157	77	119234	0.00414
ERR3199536_1_kneaddata_paired	Cyanobacteria	9876	P	92760	7966	100726	0.00350
ERR3199536_1_kneaddata_paired	Campylobacterota	8700	P	28714	4	28718	0.00100
ERR3199536_1_kneaddata_paired	Deferribacterota	10822	P	21461	98	21559	0.00075
ERR3199536_1_kneaddata_paired	Firmicutes_I	18140	P	768	0	768	0.00003
ERR3199536_1_kneaddata_paired	Firmicutes_B	17289	P	323	14	337	0.00001
ERR3199536_1_kneaddata_paired	Firmicutes_C	17613	P	55	0	55	0.00000
ERR3199536_1_kneaddata_paired	Thermotogota	33086	P	17	0	17	0.00000
ERR3199537_1_kneaddata_paired	Bacteroidota	4587	P	6621492	25203	6646695	0.37737
ERR3199537_1_kneaddata_paired	Firmicutes_A	14608	P	4612227	19449	4631676	0.26297
ERR3199537_1_kneaddata_paired	Verrucomicrobiota	33333	P	2201101	12241	2213342	0.12566
ERR3199537_1_kneaddata_paired	Firmicutes	12188	P	1069693	23684	1093377	0.06208
ERR3199537_1_kneaddata_paired	Proteobacteria	22518	P	684056	512	684568	0.03887
ERR3199537_1_kneaddata_paired	Desulfobacterota_A	11509	P	584842	2164	587006	0.03333
ERR3199537_1_kneaddata_paired	Actinobacteriota	615	P	580342	933	581275	0.03300
ERR3199537_1_kneaddata_paired	Campylobacterota	8700	P	465515	76	465591	0.02643
ERR3199537_1_kneaddata_paired	Deferribacterota	10822	P	322245	765	323010	0.01834
ERR3199537_1_kneaddata_paired	Cyanobacteria	9876	P	168931	7572	176503	0.01002
ERR3199537_1_kneaddata_paired	Spirochaetota	32587	P	104525	35	104560	0.00594
ERR3199537_1_kneaddata_paired	Elusimicrobiota	11888	P	103837	0	103837	0.00590
ERR3199537_1_kneaddata_paired	Firmicutes_B	17289	P	1003	22	1025	0.00006
ERR3199537_1_kneaddata_paired	Firmicutes_I	18140	P	418	0	418	0.00002
ERR3199537_1_kneaddata_paired	Firmicutes_C	17613	P	133	0	133	0.00001
ERR3199537_1_kneaddata_paired	Thermotogota	33086	P	18	0	18	0.00000
ERR3199538_1_kneaddata_paired	Bacteroidota	4587	P	16391393	88173	16479566	0.63533
ERR3199538_1_kneaddata_paired	Firmicutes_A	14608	P	6305883	49504	6355387	0.24502
ERR3199538_1_kneaddata_paired	Verrucomicrobiota	33333	P	922482	8602	931084	0.03590
ERR3199538_1_kneaddata_paired	Spirochaetota	32587	P	699269	390	699659	0.02697
ERR3199538_1_kneaddata_paired	Firmicutes	12188	P	565081	6332	571413	0.02203
ERR3199538_1_kneaddata_paired	Campylobacterota	8700	P	233975	14	233989	0.00902
ERR3199538_1_kneaddata_paired	Proteobacteria	22518	P	192969	863	193832	0.00747
ERR3199538_1_kneaddata_paired	Elusimicrobiota	11888	P	133719	0	133719	0.00516
ERR3199538_1_kneaddata_paired	Desulfobacterota_A	11509	P	108690	1169	109859	0.00424
ERR3199538_1_kneaddata_paired	Cyanobacteria	9876	P	97645	6949	104594	0.00403
ERR3199538_1_kneaddata_paired	Actinobacteriota	615	P	81569	295	81864	0.00316
ERR3199538_1_kneaddata_paired	Deferribacterota	10822	P	41492	164	41656	0.00161
ERR3199538_1_kneaddata_paired	Firmicutes_B	17289	P	1504	57	1561	0.00006
ERR3199538_1_kneaddata_paired	Firmicutes_I	18140	P	266	0	266	0.00001
ERR3199538_1_kneaddata_paired	Firmicutes_C	17613	P	105	0	105	0.00000
ERR3199538_1_kneaddata_paired	Thermotogota	33086	P	12	0	12	0.00000
ERR3199539_1_kneaddata_paired	Bacteroidota	4587	P	19673827	103919	19777746	0.65049
ERR3199539_1_kneaddata_paired	Firmicutes_A	14608	P	7011473	38242	7049715	0.23187
ERR3199539_1_kneaddata_paired	Firmicutes	12188	P	1000769	15199	1015968	0.03342
ERR3199539_1_kneaddata_paired	Verrucomicrobiota	33333	P	876981	11314	888295	0.02922
ERR3199539_1_kneaddata_paired	Spirochaetota	32587	P	451196	352	451548	0.01485
ERR3199539_1_kneaddata_paired	Actinobacteriota	615	P	309168	670	309838	0.01019
ERR3199539_1_kneaddata_paired	Proteobacteria	22518	P	306732	4038	310770	0.01022
ERR3199539_1_kneaddata_paired	Desulfobacterota_A	11509	P	184334	2528	186862	0.00615
ERR3199539_1_kneaddata_paired	Cyanobacteria	9876	P	139470	13494	152964	0.00503
ERR3199539_1_kneaddata_paired	Campylobacterota	8700	P	127594	11	127605	0.00420
ERR3199539_1_kneaddata_paired	Elusimicrobiota	11888	P	119721	0	119721	0.00394
ERR3199539_1_kneaddata_paired	Deferribacterota	10822	P	11860	64	11924	0.00039
ERR3199539_1_kneaddata_paired	Firmicutes_B	17289	P	808	42	850	0.00003
ERR3199539_1_kneaddata_paired	Firmicutes_I	18140	P	417	0	417	0.00001
ERR3199539_1_kneaddata_paired	Firmicutes_C	17613	P	93	0	93	0.00000
ERR3199539_1_kneaddata_paired	Thermotogota	33086	P	31	0	31	0.00000
ERR3199540_1_kneaddata_paired	Bacteroidota	4587	P	15415818	74039	15489857	0.54155
ERR3199540_1_kneaddata_paired	Firmicutes_A	14608	P	10082254	69894	10152148	0.35494
ERR3199540_1_kneaddata_paired	Firmicutes	12188	P	1008040	14134	1022174	0.03574
ERR3199540_1_kneaddata_paired	Spirochaetota	32587	P	822292	495	822787	0.02877
ERR3199540_1_kneaddata_paired	Verrucomicrobiota	33333	P	314792	3228	318020	0.01112
ERR3199540_1_kneaddata_paired	Desulfobacterota_A	11509	P	237242	3009	240251	0.00840
ERR3199540_1_kneaddata_paired	Campylobacterota	8700	P	208372	32	208404	0.00729
ERR3199540_1_kneaddata_paired	Actinobacteriota	615	P	163136	323	163459	0.00571
ERR3199540_1_kneaddata_paired	Cyanobacteria	9876	P	67684	3005	70689	0.00247
ERR3199540_1_kneaddata_paired	Proteobacteria	22518	P	56820	225	57045	0.00199
ERR3199540_1_kneaddata_paired	Deferribacterota	10822	P	32688	139	32827	0.00115
ERR3199540_1_kneaddata_paired	Elusimicrobiota	11888	P	22105	0	22105	0.00077
ERR3199540_1_kneaddata_paired	Firmicutes_B	17289	P	2224	91	2315	0.00008
ERR3199540_1_kneaddata_paired	Firmicutes_I	18140	P	433	0	433	0.00002
ERR3199540_1_kneaddata_paired	Firmicutes_C	17613	P	211	0	211	0.00001
ERR3199540_1_kneaddata_paired	Thermotogota	33086	P	11	0	11	0.00000
ERR3199541_1_kneaddata_paired	Bacteroidota	4587	P	12470397	49453	12519850	0.46727
ERR3199541_1_kneaddata_paired	Firmicutes_A	14608	P	6560309	31684	6591993	0.24603
ERR3199541_1_kneaddata_paired	Verrucomicrobiota	33333	P	3115232	22225	3137457	0.11710
ERR3199541_1_kneaddata_paired	Elusimicrobiota	11888	P	1134307	0	1134307	0.04233
ERR3199541_1_kneaddata_paired	Firmicutes	12188	P	781011	6106	787117	0.02938
ERR3199541_1_kneaddata_paired	Spirochaetota	32587	P	744141	322	744463	0.02779
ERR3199541_1_kneaddata_paired	Proteobacteria	22518	P	614379	505	614884	0.02295
ERR3199541_1_kneaddata_paired	Campylobacterota	8700	P	433457	47	433504	0.01618
ERR3199541_1_kneaddata_paired	Actinobacteriota	615	P	310042	427	310469	0.01159
ERR3199541_1_kneaddata_paired	Desulfobacterota_A	11509	P	302000	2506	304506	0.01136
ERR3199541_1_kneaddata_paired	Cyanobacteria	9876	P	174599	8804	183403	0.00685
ERR3199541_1_kneaddata_paired	Deferribacterota	10822	P	24816	74	24890	0.00093
ERR3199541_1_kneaddata_paired	Firmicutes_B	17289	P	5930	173	6103	0.00023
ERR3199541_1_kneaddata_paired	Firmicutes_I	18140	P	547	0	547	0.00002
ERR3199541_1_kneaddata_paired	Firmicutes_C	17613	P	152	0	152	0.00001
ERR3199541_1_kneaddata_paired	Thermotogota	33086	P	22	0	22	0.00000
ERR3199542_1_kneaddata_paired	Bacteroidota	4587	P	23625422	134184	23759606	0.76010
ERR3199542_1_kneaddata_paired	Firmicutes_A	14608	P	3728355	31121	3759476	0.12027
ERR3199542_1_kneaddata_paired	Firmicutes	12188	P	946007	20774	966781	0.03093
ERR3199542_1_kneaddata_paired	Actinobacteriota	615	P	934852	2090	936942	0.02997
ERR3199542_1_kneaddata_paired	Verrucomicrobiota	33333	P	829416	12261	841677	0.02693
ERR3199542_1_kneaddata_paired	Spirochaetota	32587	P	275049	241	275290	0.00881
ERR3199542_1_kneaddata_paired	Proteobacteria	22518	P	213748	3261	217009	0.00694
ERR3199542_1_kneaddata_paired	Desulfobacterota_A	11509	P	127061	2161	129222	0.00413
ERR3199542_1_kneaddata_paired	Cyanobacteria	9876	P	126869	14645	141514	0.00453
ERR3199542_1_kneaddata_paired	Campylobacterota	8700	P	112352	67	112419	0.00360
ERR3199542_1_kneaddata_paired	Elusimicrobiota	11888	P	106577	0	106577	0.00341
ERR3199542_1_kneaddata_paired	Deferribacterota	10822	P	10573	64	10637	0.00034
ERR3199542_1_kneaddata_paired	Firmicutes_I	18140	P	838	0	838	0.00003
ERR3199542_1_kneaddata_paired	Firmicutes_B	17289	P	479	28	507	0.00002
ERR3199542_1_kneaddata_paired	Firmicutes_C	17613	P	61	0	61	0.00000
ERR3199542_1_kneaddata_paired	Thermotogota	33086	P	19	0	19	0.00000
ERR3199543_1_kneaddata_paired	Bacteroidota	4587	P	11927241	34208	11961449	0.46391
ERR3199543_1_kneaddata_paired	Firmicutes_A	14608	P	10199761	46931	10246692	0.39741
ERR3199543_1_kneaddata_paired	Firmicutes	12188	P	1751251	41852	1793103	0.06954
ERR3199543_1_kneaddata_paired	Actinobacteriota	615	P	538377	502	538879	0.02090
ERR3199543_1_kneaddata_paired	Campylobacterota	8700	P	328882	30	328912	0.01276
ERR3199543_1_kneaddata_paired	Deferribacterota	10822	P	320556	961	321517	0.01247
ERR3199543_1_kneaddata_paired	Verrucomicrobiota	33333	P	268233	1929	270162	0.01048
ERR3199543_1_kneaddata_paired	Desulfobacterota_A	11509	P	129439	1322	130761	0.00507
ERR3199543_1_kneaddata_paired	Proteobacteria	22518	P	106566	147	106713	0.00414
ERR3199543_1_kneaddata_paired	Spirochaetota	32587	P	58055	24	58079	0.00225
ERR3199543_1_kneaddata_paired	Cyanobacteria	9876	P	12824	464	13288	0.00052
ERR3199543_1_kneaddata_paired	Elusimicrobiota	11888	P	12818	0	12818	0.00050
ERR3199543_1_kneaddata_paired	Firmicutes_B	17289	P	889	25	914	0.00004
ERR3199543_1_kneaddata_paired	Firmicutes_I	18140	P	449	0	449	0.00002
ERR3199543_1_kneaddata_paired	Firmicutes_C	17613	P	126	0	126	0.00000
ERR3199543_1_kneaddata_paired	Thermotogota	33086	P	19	0	19	0.00000
ERR3199544_1_kneaddata_paired	Bacteroidota	4587	P	19986167	73077	20059244	0.64192
ERR3199544_1_kneaddata_paired	Firmicutes_A	14608	P	5409691	78206	5487897	0.17562
ERR3199544_1_kneaddata_paired	Actinobacteriota	615	P	2151431	2889	2154320	0.06894
ERR3199544_1_kneaddata_paired	Firmicutes	12188	P	2141018	22880	2163898	0.06925
ERR3199544_1_kneaddata_paired	Verrucomicrobiota	33333	P	696986	7402	704388	0.02254
ERR3199544_1_kneaddata_paired	Campylobacterota	8700	P	199984	50	200034	0.00640
ERR3199544_1_kneaddata_paired	Proteobacteria	22518	P	190471	499	190970	0.00611
ERR3199544_1_kneaddata_paired	Desulfobacterota_A	11509	P	113729	1303	115032	0.00368
ERR3199544_1_kneaddata_paired	Spirochaetota	32587	P	63391	41	63432	0.00203
ERR3199544_1_kneaddata_paired	Deferribacterota	10822	P	62571	282	62853	0.00201
ERR3199544_1_kneaddata_paired	Cyanobacteria	9876	P	41281	3444	44725	0.00143
ERR3199544_1_kneaddata_paired	Elusimicrobiota	11888	P	1479	0	1479	0.00005
ERR3199544_1_kneaddata_paired	Firmicutes_I	18140	P	327	0	327	0.00001
ERR3199544_1_kneaddata_paired	Firmicutes_B	17289	P	313	13	326	0.00001
ERR3199544_1_kneaddata_paired	Firmicutes_C	17613	P	76	0	76	0.00000
ERR3199544_1_kneaddata_paired	Thermotogota	33086	P	10	0	10	0.00000
ERR3199545_1_kneaddata_paired	Bacteroidota	4587	P	20791588	81187	20872775	0.71022
ERR3199545_1_kneaddata_paired	Firmicutes_A	14608	P	4298018	33037	4331055	0.14737
ERR3199545_1_kneaddata_paired	Firmicutes	12188	P	1648879	43068	1691947	0.05757
ERR3199545_1_kneaddata_paired	Verrucomicrobiota	33333	P	984519	12205	996724	0.03391
ERR3199545_1_kneaddata_paired	Actinobacteriota	615	P	773336	1419	774755	0.02636
ERR3199545_1_kneaddata_paired	Campylobacterota	8700	P	208289	54	208343	0.00709
ERR3199545_1_kneaddata_paired	Proteobacteria	22518	P	191277	538	191815	0.00653
ERR3199545_1_kneaddata_paired	Desulfobacterota_A	11509	P	88033	1502	89535	0.00305
ERR3199545_1_kneaddata_paired	Elusimicrobiota	11888	P	70429	0	70429	0.00240
ERR3199545_1_kneaddata_paired	Cyanobacteria	9876	P	69896	6621	76517	0.00260
ERR3199545_1_kneaddata_paired	Spirochaetota	32587	P	54511	40	54551	0.00186
ERR3199545_1_kneaddata_paired	Deferribacterota	10822	P	29493	152	29645	0.00101
ERR3199545_1_kneaddata_paired	Firmicutes_I	18140	P	449	0	449	0.00002
ERR3199545_1_kneaddata_paired	Firmicutes_B	17289	P	440	21	461	0.00002
ERR3199545_1_kneaddata_paired	Firmicutes_C	17613	P	61	0	61	0.00000
ERR3199545_1_kneaddata_paired	Thermotogota	33086	P	14	0	14	0.00000
ERR3199546_1_kneaddata_paired	Firmicutes_A	14608	P	16781702	61356	16843058	0.58299
ERR3199546_1_kneaddata_paired	Bacteroidota	4587	P	9310509	35404	9345913	0.32349
ERR3199546_1_kneaddata_paired	Desulfobacterota_A	11509	P	719285	5554	724839	0.02509
ERR3199546_1_kneaddata_paired	Campylobacterota	8700	P	541381	25	541406	0.01874
ERR3199546_1_kneaddata_paired	Spirochaetota	32587	P	468955	218	469173	0.01624
ERR3199546_1_kneaddata_paired	Firmicutes	12188	P	348456	4218	352674	0.01221
ERR3199546_1_kneaddata_paired	Verrucomicrobiota	33333	P	153265	1220	154485	0.00535
ERR3199546_1_kneaddata_paired	Deferribacterota	10822	P	143542	475	144017	0.00498
ERR3199546_1_kneaddata_paired	Cyanobacteria	9876	P	115358	7019	122377	0.00424
ERR3199546_1_kneaddata_paired	Actinobacteriota	615	P	91077	249	91326	0.00316
ERR3199546_1_kneaddata_paired	Elusimicrobiota	11888	P	53889	0	53889	0.00187
ERR3199546_1_kneaddata_paired	Proteobacteria	22518	P	44386	101	44487	0.00154
ERR3199546_1_kneaddata_paired	Firmicutes_B	17289	P	2181	69	2250	0.00008
ERR3199546_1_kneaddata_paired	Firmicutes_I	18140	P	447	0	447	0.00002
ERR3199546_1_kneaddata_paired	Firmicutes_C	17613	P	240	0	240	0.00001
ERR3199546_1_kneaddata_paired	Thermotogota	33086	P	12	0	12	0.00000
ERR3199547_1_kneaddata_paired	Bacteroidota	4587	P	17658988	72315	17731303	0.62290
ERR3199547_1_kneaddata_paired	Firmicutes_A	14608	P	7448751	48397	7497148	0.26337
ERR3199547_1_kneaddata_paired	Firmicutes	12188	P	934749	10469	945218	0.03321
ERR3199547_1_kneaddata_paired	Verrucomicrobiota	33333	P	914276	9214	923490	0.03244
ERR3199547_1_kneaddata_paired	Actinobacteriota	615	P	491233	812	492045	0.01729
ERR3199547_1_kneaddata_paired	Proteobacteria	22518	P	278551	3275	281826	0.00990
ERR3199547_1_kneaddata_paired	Desulfobacterota_A	11509	P	216792	2612	219404	0.00771
ERR3199547_1_kneaddata_paired	Spirochaetota	32587	P	105824	65	105889	0.00372
ERR3199547_1_kneaddata_paired	Campylobacterota	8700	P	84386	3	84389	0.00296
ERR3199547_1_kneaddata_paired	Elusimicrobiota	11888	P	78707	0	78707	0.00276
ERR3199547_1_kneaddata_paired	Cyanobacteria	9876	P	75404	5724	81128	0.00285
ERR3199547_1_kneaddata_paired	Deferribacterota	10822	P	23652	100	23752	0.00083
ERR3199547_1_kneaddata_paired	Firmicutes_B	17289	P	688	28	716	0.00003
ERR3199547_1_kneaddata_paired	Firmicutes_I	18140	P	619	0	619	0.00002
ERR3199547_1_kneaddata_paired	Firmicutes_C	17613	P	148	0	148	0.00001
ERR3199547_1_kneaddata_paired	Thermotogota	33086	P	29	0	29	0.00000
ERR3199548_1_kneaddata_paired	Bacteroidota	4587	P	17532457	66055	17598512	0.62900
ERR3199548_1_kneaddata_paired	Firmicutes_A	14608	P	6510621	65691	6576312	0.23505
ERR3199548_1_kneaddata_paired	Verrucomicrobiota	33333	P	1100513	10433	1110946	0.03971
ERR3199548_1_kneaddata_paired	Spirochaetota	32587	P	586769	332	587101	0.02098
ERR3199548_1_kneaddata_paired	Firmicutes	12188	P	583815	18261	602076	0.02152
ERR3199548_1_kneaddata_paired	Actinobacteriota	615	P	492617	971	493588	0.01764
ERR3199548_1_kneaddata_paired	Proteobacteria	22518	P	302974	2419	305393	0.01092
ERR3199548_1_kneaddata_paired	Cyanobacteria	9876	P	201833	14753	216586	0.00774
ERR3199548_1_kneaddata_paired	Desulfobacterota_A	11509	P	168433	1768	170201	0.00608
ERR3199548_1_kneaddata_paired	Elusimicrobiota	11888	P	164171	0	164171	0.00587
ERR3199548_1_kneaddata_paired	Campylobacterota	8700	P	119924	2	119926	0.00429
ERR3199548_1_kneaddata_paired	Deferribacterota	10822	P	31918	128	32046	0.00115
ERR3199548_1_kneaddata_paired	Firmicutes_B	17289	P	896	34	930	0.00003
ERR3199548_1_kneaddata_paired	Firmicutes_I	18140	P	442	0	442	0.00002
ERR3199548_1_kneaddata_paired	Firmicutes_C	17613	P	175	0	175	0.00001
ERR3199548_1_kneaddata_paired	Thermotogota	33086	P	25	0	25	0.00000
ERR3199549_1_kneaddata_paired	Bacteroidota	4587	P	18785554	85497	18871051	0.67924
ERR3199549_1_kneaddata_paired	Firmicutes_A	14608	P	6339222	43229	6382451	0.22973
ERR3199549_1_kneaddata_paired	Firmicutes	12188	P	1117548	19055	1136603	0.04091
ERR3199549_1_kneaddata_paired	Actinobacteriota	615	P	554518	982	555500	0.01999
ERR3199549_1_kneaddata_paired	Campylobacterota	8700	P	270951	17	270968	0.00975
ERR3199549_1_kneaddata_paired	Proteobacteria	22518	P	196081	348	196429	0.00707
ERR3199549_1_kneaddata_paired	Desulfobacterota_A	11509	P	143287	1726	145013	0.00522
ERR3199549_1_kneaddata_paired	Deferribacterota	10822	P	101425	430	101855	0.00367
ERR3199549_1_kneaddata_paired	Spirochaetota	32587	P	69874	42	69916	0.00252
ERR3199549_1_kneaddata_paired	Cyanobacteria	9876	P	34045	2467	36512	0.00131
ERR3199549_1_kneaddata_paired	Elusimicrobiota	11888	P	10977	0	10977	0.00040
ERR3199549_1_kneaddata_paired	Verrucomicrobiota	33333	P	3298	89	3387	0.00012
ERR3199549_1_kneaddata_paired	Firmicutes_B	17289	P	1368	55	1423	0.00005
ERR3199549_1_kneaddata_paired	Firmicutes_I	18140	P	559	0	559	0.00002
ERR3199549_1_kneaddata_paired	Firmicutes_C	17613	P	53	0	53	0.00000
ERR3199549_1_kneaddata_paired	Thermotogota	33086	P	7	0	7	0.00000
ERR3199550_1_kneaddata_paired	Bacteroidota	4587	P	15001846	71880	15073726	0.57578
ERR3199550_1_kneaddata_paired	Firmicutes_A	14608	P	3864630	14839	3879469	0.14819
ERR3199550_1_kneaddata_paired	Verrucomicrobiota	33333	P	3622707	21434	3644141	0.13920
ERR3199550_1_kneaddata_paired	Elusimicrobiota	11888	P	1490602	0	1490602	0.05694
ERR3199550_1_kneaddata_paired	Firmicutes	12188	P	630627	3963	634590	0.02424
ERR3199550_1_kneaddata_paired	Proteobacteria	22518	P	461990	3011	465001	0.01776
ERR3199550_1_kneaddata_paired	Cyanobacteria	9876	P	345085	12203	357288	0.01365
ERR3199550_1_kneaddata_paired	Spirochaetota	32587	P	250849	91	250940	0.00959
ERR3199550_1_kneaddata_paired	Actinobacteriota	615	P	170187	209	170396	0.00651
ERR3199550_1_kneaddata_paired	Campylobacterota	8700	P	106961	12	106973	0.00409
ERR3199550_1_kneaddata_paired	Desulfobacterota_A	11509	P	72404	543	72947	0.00279
ERR3199550_1_kneaddata_paired	Deferribacterota	10822	P	26664	66	26730	0.00102
ERR3199550_1_kneaddata_paired	Firmicutes_B	17289	P	5865	141	6006	0.00023
ERR3199550_1_kneaddata_paired	Firmicutes_I	18140	P	786	0	786	0.00003
ERR3199550_1_kneaddata_paired	Firmicutes_C	17613	P	163	0	163	0.00001
ERR3199550_1_kneaddata_paired	Thermotogota	33086	P	57	0	57	0.00000
ERR3199551_1_kneaddata_paired	Bacteroidota	4587	P	21961109	84856	22045965	0.71034
ERR3199551_1_kneaddata_paired	Firmicutes_A	14608	P	5190747	66616	5257363	0.16940
ERR3199551_1_kneaddata_paired	Firmicutes	12188	P	1078874	13562	1092436	0.03520
ERR3199551_1_kneaddata_paired	Verrucomicrobiota	33333	P	748701	8996	757697	0.02441
ERR3199551_1_kneaddata_paired	Actinobacteriota	615	P	745558	1256	746814	0.02406
ERR3199551_1_kneaddata_paired	Campylobacterota	8700	P	563726	44	563770	0.01817
ERR3199551_1_kneaddata_paired	Desulfobacterota_A	11509	P	171734	2326	174060	0.00561
ERR3199551_1_kneaddata_paired	Proteobacteria	22518	P	166710	611	167321	0.00539
ERR3199551_1_kneaddata_paired	Spirochaetota	32587	P	89459	65	89524	0.00288
ERR3199551_1_kneaddata_paired	Deferribacterota	10822	P	82868	426	83294	0.00268
ERR3199551_1_kneaddata_paired	Cyanobacteria	9876	P	47580	4102	51682	0.00167
ERR3199551_1_kneaddata_paired	Elusimicrobiota	11888	P	4537	0	4537	0.00015
ERR3199551_1_kneaddata_paired	Firmicutes_B	17289	P	720	35	755	0.00002
ERR3199551_1_kneaddata_paired	Firmicutes_I	18140	P	351	0	351	0.00001
ERR3199551_1_kneaddata_paired	Firmicutes_C	17613	P	89	0	89	0.00000
ERR3199551_1_kneaddata_paired	Thermotogota	33086	P	7	0	7	0.00000
ERR3199552_1_kneaddata_paired	Firmicutes_A	14608	P	12931161	117452	13048613	0.45878
ERR3199552_1_kneaddata_paired	Bacteroidota	4587	P	12470866	34018	12504884	0.43966
ERR3199552_1_kneaddata_paired	Firmicutes	12188	P	838050	12207	850257	0.02989
ERR3199552_1_kneaddata_paired	Actinobacteriota	615	P	454283	749	455032	0.01600
ERR3199552_1_kneaddata_paired	Desulfobacterota_A	11509	P	425530	3943	429473	0.01510
ERR3199552_1_kneaddata_paired	Spirochaetota	32587	P	387098	180	387278	0.01362
ERR3199552_1_kneaddata_paired	Campylobacterota	8700	P	266259	39	266298	0.00936
ERR3199552_1_kneaddata_paired	Proteobacteria	22518	P	168123	184	168307	0.00592
ERR3199552_1_kneaddata_paired	Verrucomicrobiota	33333	P	134864	1069	135933	0.00478
ERR3199552_1_kneaddata_paired	Deferribacterota	10822	P	105142	349	105491	0.00371
ERR3199552_1_kneaddata_paired	Cyanobacteria	9876	P	79015	4990	84005	0.00295
ERR3199552_1_kneaddata_paired	Firmicutes_B	17289	P	3052	96	3148	0.00011
ERR3199552_1_kneaddata_paired	Elusimicrobiota	11888	P	2900	0	2900	0.00010
ERR3199552_1_kneaddata_paired	Firmicutes_I	18140	P	416	0	416	0.00001
ERR3199552_1_kneaddata_paired	Firmicutes_C	17613	P	149	0	149	0.00001
ERR3199552_1_kneaddata_paired	Thermotogota	33086	P	16	0	16	0.00000
ERR3199553_1_kneaddata_paired	Bacteroidota	4587	P	21856081	81083	21937164	0.75485
ERR3199553_1_kneaddata_paired	Firmicutes_A	14608	P	3749994	52985	3802979	0.13086
ERR3199553_1_kneaddata_paired	Firmicutes	12188	P	1318374	29636	1348010	0.04638
ERR3199553_1_kneaddata_paired	Actinobacteriota	615	P	849686	1525	851211	0.02929
ERR3199553_1_kneaddata_paired	Campylobacterota	8700	P	317016	191	317207	0.01092
ERR3199553_1_kneaddata_paired	Proteobacteria	22518	P	269572	390	269962	0.00929
ERR3199553_1_kneaddata_paired	Verrucomicrobiota	33333	P	207163	2259	209422	0.00721
ERR3199553_1_kneaddata_paired	Deferribacterota	10822	P	91246	418	91664	0.00315
ERR3199553_1_kneaddata_paired	Spirochaetota	32587	P	81599	52	81651	0.00281
ERR3199553_1_kneaddata_paired	Desulfobacterota_A	11509	P	75205	957	76162	0.00262
ERR3199553_1_kneaddata_paired	Cyanobacteria	9876	P	66066	5469	71535	0.00246
ERR3199553_1_kneaddata_paired	Elusimicrobiota	11888	P	3471	0	3471	0.00012
ERR3199553_1_kneaddata_paired	Firmicutes_B	17289	P	675	29	704	0.00002
ERR3199553_1_kneaddata_paired	Firmicutes_I	18140	P	373	0	373	0.00001
ERR3199553_1_kneaddata_paired	Firmicutes_C	17613	P	45	0	45	0.00000
ERR3199553_1_kneaddata_paired	Thermotogota	33086	P	10	0	10	0.00000
ERR3199554_1_kneaddata_paired	Bacteroidota	4587	P	16994484	68503	17062987	0.63240
ERR3199554_1_kneaddata_paired	Firmicutes_A	14608	P	4396326	26535	4422861	0.16392
ERR3199554_1_kneaddata_paired	Verrucomicrobiota	33333	P	1464105	13521	1477626	0.05477
ERR3199554_1_kneaddata_paired	Firmicutes	12188	P	1322888	15010	1337898	0.04959
ERR3199554_1_kneaddata_paired	Actinobacteriota	615	P	954545	1109	955654	0.03542
ERR3199554_1_kneaddata_paired	Proteobacteria	22518	P	692175	2764	694939	0.02576
ERR3199554_1_kneaddata_paired	Elusimicrobiota	11888	P	329179	0	329179	0.01220
ERR3199554_1_kneaddata_paired	Cyanobacteria	9876	P	326187	23196	349383	0.01295
ERR3199554_1_kneaddata_paired	Spirochaetota	32587	P	196290	108	196398	0.00728
ERR3199554_1_kneaddata_paired	Desulfobacterota_A	11509	P	98892	1125	100017	0.00371
ERR3199554_1_kneaddata_paired	Campylobacterota	8700	P	41600	3	41603	0.00154
ERR3199554_1_kneaddata_paired	Deferribacterota	10822	P	10996	41	11037	0.00041
ERR3199554_1_kneaddata_paired	Firmicutes_B	17289	P	739	27	766	0.00003
ERR3199554_1_kneaddata_paired	Firmicutes_I	18140	P	656	0	656	0.00002
ERR3199554_1_kneaddata_paired	Firmicutes_C	17613	P	104	0	104	0.00000
ERR3199554_1_kneaddata_paired	Thermotogota	33086	P	25	0	25	0.00000
ERR3199555_1_kneaddata_paired	Bacteroidota	4587	P	9729319	47611	9776930	0.67881
ERR3199555_1_kneaddata_paired	Firmicutes_A	14608	P	2794619	32980	2827599	0.19632
ERR3199555_1_kneaddata_paired	Verrucomicrobiota	33333	P	483260	6184	489444	0.03398
ERR3199555_1_kneaddata_paired	Proteobacteria	22518	P	294135	441	294576	0.02045
ERR3199555_1_kneaddata_paired	Firmicutes	12188	P	180152	3666	183818	0.01276
ERR3199555_1_kneaddata_paired	Actinobacteriota	615	P	161885	506	162391	0.01127
ERR3199555_1_kneaddata_paired	Elusimicrobiota	11888	P	136390	0	136390	0.00947
ERR3199555_1_kneaddata_paired	Desulfobacterota_A	11509	P	135464	1954	137418	0.00954
ERR3199555_1_kneaddata_paired	Campylobacterota	8700	P	126339	51	126390	0.00878
ERR3199555_1_kneaddata_paired	Spirochaetota	32587	P	116193	89	116282	0.00807
ERR3199555_1_kneaddata_paired	Cyanobacteria	9876	P	98784	9982	108766	0.00755
ERR3199555_1_kneaddata_paired	Deferribacterota	10822	P	42166	230	42396	0.00294
ERR3199555_1_kneaddata_paired	Firmicutes_B	17289	P	380	19	399	0.00003
ERR3199555_1_kneaddata_paired	Firmicutes_I	18140	P	148	0	148	0.00001
ERR3199555_1_kneaddata_paired	Firmicutes_C	17613	P	41	0	41	0.00000
ERR3199555_1_kneaddata_paired	Thermotogota	33086	P	4	0	4	0.00000
ERR3199556_1_kneaddata_paired	Bacteroidota	4587	P	18398300	71497	18469797	0.59222
ERR3199556_1_kneaddata_paired	Firmicutes_A	14608	P	4568988	24637	4593625	0.14729
ERR3199556_1_kneaddata_paired	Verrucomicrobiota	33333	P	3138860	23602	3162462	0.10140
ERR3199556_1_kneaddata_paired	Actinobacteriota	615	P	2320689	2315	2323004	0.07449
ERR3199556_1_kneaddata_paired	Firmicutes	12188	P	1843417	11295	1854712	0.05947
ERR3199556_1_kneaddata_paired	Proteobacteria	22518	P	389199	371	389570	0.01249
ERR3199556_1_kneaddata_paired	Campylobacterota	8700	P	142216	71	142287	0.00456
ERR3199556_1_kneaddata_paired	Desulfobacterota_A	11509	P	137213	648	137861	0.00442
ERR3199556_1_kneaddata_paired	Spirochaetota	32587	P	80173	36	80209	0.00257
ERR3199556_1_kneaddata_paired	Cyanobacteria	9876	P	24535	1062	25597	0.00082
ERR3199556_1_kneaddata_paired	Deferribacterota	10822	P	7168	22	7190	0.00023
ERR3199556_1_kneaddata_paired	Elusimicrobiota	11888	P	470	0	470	0.00002
ERR3199556_1_kneaddata_paired	Firmicutes_B	17289	P	304	9	313	0.00001
ERR3199556_1_kneaddata_paired	Firmicutes_I	18140	P	94	0	94	0.00000
ERR3199556_1_kneaddata_paired	Firmicutes_C	17613	P	60	0	60	0.00000
ERR3199556_1_kneaddata_paired	Thermotogota	33086	P	19	0	19	0.00000
ERR3199557_1_kneaddata_paired	Bacteroidota	4587	P	17028628	83482	17112110	0.62637
ERR3199557_1_kneaddata_paired	Firmicutes_A	14608	P	7137211	43388	7180599	0.26284
ERR3199557_1_kneaddata_paired	Verrucomicrobiota	33333	P	707074	7931	715005	0.02617
ERR3199557_1_kneaddata_paired	Firmicutes	12188	P	664888	10461	675349	0.02472
ERR3199557_1_kneaddata_paired	Spirochaetota	32587	P	641562	431	641993	0.02350
ERR3199557_1_kneaddata_paired	Desulfobacterota_A	11509	P	255610	2648	258258	0.00945
ERR3199557_1_kneaddata_paired	Actinobacteriota	615	P	205559	673	206232	0.00755
ERR3199557_1_kneaddata_paired	Campylobacterota	8700	P	184079	7	184086	0.00674
ERR3199557_1_kneaddata_paired	Elusimicrobiota	11888	P	143619	0	143619	0.00526
ERR3199557_1_kneaddata_paired	Proteobacteria	22518	P	106304	260	106564	0.00390
ERR3199557_1_kneaddata_paired	Deferribacterota	10822	P	51284	245	51529	0.00189
ERR3199557_1_kneaddata_paired	Cyanobacteria	9876	P	39766	3365	43131	0.00158
ERR3199557_1_kneaddata_paired	Firmicutes_B	17289	P	527	24	551	0.00002
ERR3199557_1_kneaddata_paired	Firmicutes_I	18140	P	338	0	338	0.00001
ERR3199557_1_kneaddata_paired	Firmicutes_C	17613	P	89	0	89	0.00000
ERR3199557_1_kneaddata_paired	Thermotogota	33086	P	8	0	8	0.00000
ERR3199558_1_kneaddata_paired	Firmicutes_A	14608	P	13452341	53210	13505551	0.56497
ERR3199558_1_kneaddata_paired	Bacteroidota	4587	P	6529765	35141	6564906	0.27463
ERR3199558_1_kneaddata_paired	Campylobacterota	8700	P	933964	67	934031	0.03907
ERR3199558_1_kneaddata_paired	Firmicutes	12188	P	877350	8283	885633	0.03705
ERR3199558_1_kneaddata_paired	Desulfobacterota_A	11509	P	479211	4653	483864	0.02024
ERR3199558_1_kneaddata_paired	Verrucomicrobiota	33333	P	477611	4446	482057	0.02017
ERR3199558_1_kneaddata_paired	Deferribacterota	10822	P	380106	1511	381617	0.01596
ERR3199558_1_kneaddata_paired	Actinobacteriota	615	P	293552	489	294041	0.01230
ERR3199558_1_kneaddata_paired	Spirochaetota	32587	P	184848	104	184952	0.00774
ERR3199558_1_kneaddata_paired	Proteobacteria	22518	P	67224	826	68050	0.00285
ERR3199558_1_kneaddata_paired	Elusimicrobiota	11888	P	65404	0	65404	0.00274
ERR3199558_1_kneaddata_paired	Cyanobacteria	9876	P	49319	2995	52314	0.00219
ERR3199558_1_kneaddata_paired	Firmicutes_B	17289	P	1380	52	1432	0.00006
ERR3199558_1_kneaddata_paired	Firmicutes_C	17613	P	670	1	671	0.00003
ERR3199558_1_kneaddata_paired	Firmicutes_I	18140	P	252	0	252	0.00001
ERR3199558_1_kneaddata_paired	Thermotogota	33086	P	40	0	40	0.00000
ERR3199559_1_kneaddata_paired	Bacteroidota	4587	P	20059854	108841	20168695	0.72874
ERR3199559_1_kneaddata_paired	Firmicutes_A	14608	P	3399313	36186	3435499	0.12413
ERR3199559_1_kneaddata_paired	Verrucomicrobiota	33333	P	1563169	23112	1586281	0.05732
ERR3199559_1_kneaddata_paired	Firmicutes	12188	P	852956	12477	865433	0.03127
ERR3199559_1_kneaddata_paired	Proteobacteria	22518	P	470878	5482	476360	0.01721
ERR3199559_1_kneaddata_paired	Desulfobacterota_A	11509	P	337751	5174	342925	0.01239
ERR3199559_1_kneaddata_paired	Actinobacteriota	615	P	271610	1031	272641	0.00985
ERR3199559_1_kneaddata_paired	Campylobacterota	8700	P	179994	65	180059	0.00651
ERR3199559_1_kneaddata_paired	Spirochaetota	32587	P	111686	98	111784	0.00404
ERR3199559_1_kneaddata_paired	Elusimicrobiota	11888	P	100122	0	100122	0.00362
ERR3199559_1_kneaddata_paired	Cyanobacteria	9876	P	89803	5942	95745	0.00346
ERR3199559_1_kneaddata_paired	Deferribacterota	10822	P	39399	245	39644	0.00143
ERR3199559_1_kneaddata_paired	Firmicutes_B	17289	P	503	29	532	0.00002
ERR3199559_1_kneaddata_paired	Firmicutes_I	18140	P	228	0	228	0.00001
ERR3199559_1_kneaddata_paired	Firmicutes_C	17613	P	106	0	106	0.00000
ERR3199559_1_kneaddata_paired	Thermotogota	33086	P	10	0	10	0.00000
ERR3199560_1_kneaddata_paired	Bacteroidota	4587	P	21570353	102176	21672529	0.78230
ERR3199560_1_kneaddata_paired	Firmicutes_A	14608	P	2880332	28447	2908779	0.10500
ERR3199560_1_kneaddata_paired	Verrucomicrobiota	33333	P	781506	8018	789524	0.02850
ERR3199560_1_kneaddata_paired	Firmicutes	12188	P	628044	17914	645958	0.02332
ERR3199560_1_kneaddata_paired	Actinobacteriota	615	P	482472	724	483196	0.01744
ERR3199560_1_kneaddata_paired	Proteobacteria	22518	P	401328	715	402043	0.01451
ERR3199560_1_kneaddata_paired	Campylobacterota	8700	P	168812	2	168814	0.00609
ERR3199560_1_kneaddata_paired	Cyanobacteria	9876	P	166581	13266	179847	0.00649
ERR3199560_1_kneaddata_paired	Elusimicrobiota	11888	P	155211	0	155211	0.00560
ERR3199560_1_kneaddata_paired	Desulfobacterota_A	11509	P	107027	1199	108226	0.00391
ERR3199560_1_kneaddata_paired	Deferribacterota	10822	P	103093	440	103533	0.00374
ERR3199560_1_kneaddata_paired	Spirochaetota	32587	P	84994	51	85045	0.00307
ERR3199560_1_kneaddata_paired	Firmicutes_B	17289	P	343	13	356	0.00001
ERR3199560_1_kneaddata_paired	Firmicutes_I	18140	P	235	0	235	0.00001
ERR3199560_1_kneaddata_paired	Firmicutes_C	17613	P	113	0	113	0.00000
ERR3199560_1_kneaddata_paired	Thermotogota	33086	P	11	0	11	0.00000
ERR3199561_1_kneaddata_paired	Bacteroidota	4587	P	19264777	78166	19342943	0.71637
ERR3199561_1_kneaddata_paired	Firmicutes_A	14608	P	4710120	64816	4774936	0.17684
ERR3199561_1_kneaddata_paired	Firmicutes	12188	P	1071172	21585	1092757	0.04047
ERR3199561_1_kneaddata_paired	Actinobacteriota	615	P	833648	1345	834993	0.03092
ERR3199561_1_kneaddata_paired	Proteobacteria	22518	P	297992	670	298662	0.01106
ERR3199561_1_kneaddata_paired	Campylobacterota	8700	P	184395	68	184463	0.00683
ERR3199561_1_kneaddata_paired	Verrucomicrobiota	33333	P	172421	2022	174443	0.00646
ERR3199561_1_kneaddata_paired	Deferribacterota	10822	P	117798	570	118368	0.00438
ERR3199561_1_kneaddata_paired	Spirochaetota	32587	P	89782	61	89843	0.00333
ERR3199561_1_kneaddata_paired	Desulfobacterota_A	11509	P	48567	630	49197	0.00182
ERR3199561_1_kneaddata_paired	Cyanobacteria	9876	P	36344	3213	39557	0.00147
ERR3199561_1_kneaddata_paired	Elusimicrobiota	11888	P	495	0	495	0.00002
ERR3199561_1_kneaddata_paired	Firmicutes_B	17289	P	442	20	462	0.00002
ERR3199561_1_kneaddata_paired	Firmicutes_I	18140	P	137	0	137	0.00001
ERR3199561_1_kneaddata_paired	Firmicutes_C	17613	P	41	0	41	0.00000
ERR3199561_1_kneaddata_paired	Thermotogota	33086	P	12	0	12	0.00000
ERR3199562_1_kneaddata_paired	Bacteroidota	4587	P	18908835	63837	18972672	0.67665
ERR3199562_1_kneaddata_paired	Firmicutes_A	14608	P	3511077	62464	3573541	0.12745
ERR3199562_1_kneaddata_paired	Verrucomicrobiota	33333	P	1874704	16182	1890886	0.06744
ERR3199562_1_kneaddata_paired	Elusimicrobiota	11888	P	1273694	0	1273694	0.04543
ERR3199562_1_kneaddata_paired	Actinobacteriota	615	P	638623	729	639352	0.02280
ERR3199562_1_kneaddata_paired	Cyanobacteria	9876	P	551225	36945	588170	0.02098
ERR3199562_1_kneaddata_paired	Proteobacteria	22518	P	421903	4888	426791	0.01522
ERR3199562_1_kneaddata_paired	Firmicutes	12188	P	390074	5866	395940	0.01412
ERR3199562_1_kneaddata_paired	Spirochaetota	32587	P	107876	57	107933	0.00385
ERR3199562_1_kneaddata_paired	Desulfobacterota_A	11509	P	94910	987	95897	0.00342
ERR3199562_1_kneaddata_paired	Deferribacterota	10822	P	40881	150	41031	0.00146
ERR3199562_1_kneaddata_paired	Campylobacterota	8700	P	32152	6	32158	0.00115
ERR3199562_1_kneaddata_paired	Firmicutes_B	17289	P	385	13	398	0.00001
ERR3199562_1_kneaddata_paired	Firmicutes_I	18140	P	329	0	329	0.00001
ERR3199562_1_kneaddata_paired	Firmicutes_C	17613	P	204	0	204	0.00001
ERR3199562_1_kneaddata_paired	Thermotogota	33086	P	5	0	5	0.00000
ERR3199563_1_kneaddata_paired	Bacteroidota	4587	P	20358482	57253	20415735	0.73046
ERR3199563_1_kneaddata_paired	Firmicutes_A	14608	P	3279629	22865	3302494	0.11816
ERR3199563_1_kneaddata_paired	Firmicutes	12188	P	1828477	74772	1903249	0.06810
ERR3199563_1_kneaddata_paired	Verrucomicrobiota	33333	P	1106011	9156	1115167	0.03990
ERR3199563_1_kneaddata_paired	Actinobacteriota	615	P	636884	860	637744	0.02282
ERR3199563_1_kneaddata_paired	Proteobacteria	22518	P	230001	568	230569	0.00825
ERR3199563_1_kneaddata_paired	Spirochaetota	32587	P	106753	52	106805	0.00382
ERR3199563_1_kneaddata_paired	Desulfobacterota_A	11509	P	77662	951	78613	0.00281
ERR3199563_1_kneaddata_paired	Campylobacterota	8700	P	64634	3	64637	0.00231
ERR3199563_1_kneaddata_paired	Cyanobacteria	9876	P	47723	2415	50138	0.00179
ERR3199563_1_kneaddata_paired	Elusimicrobiota	11888	P	35486	0	35486	0.00127
ERR3199563_1_kneaddata_paired	Deferribacterota	10822	P	7853	26	7879	0.00028
ERR3199563_1_kneaddata_paired	Firmicutes_I	18140	P	411	0	411	0.00001
ERR3199563_1_kneaddata_paired	Firmicutes_B	17289	P	260	8	268	0.00001
ERR3199563_1_kneaddata_paired	Firmicutes_C	17613	P	34	0	34	0.00000
ERR3199563_1_kneaddata_paired	Thermotogota	33086	P	7	0	7	0.00000
ERR3199564_1_kneaddata_paired	Bacteroidota	4587	P	19061886	89867	19151753	0.65453
ERR3199564_1_kneaddata_paired	Firmicutes_A	14608	P	7908535	66109	7974644	0.27254
ERR3199564_1_kneaddata_paired	Firmicutes	12188	P	873425	10485	883910	0.03021
ERR3199564_1_kneaddata_paired	Verrucomicrobiota	33333	P	343178	3643	346821	0.01185
ERR3199564_1_kneaddata_paired	Actinobacteriota	615	P	327292	589	327881	0.01121
ERR3199564_1_kneaddata_paired	Campylobacterota	8700	P	239939	14	239953	0.00820
ERR3199564_1_kneaddata_paired	Desulfobacterota_A	11509	P	126934	2394	129328	0.00442
ERR3199564_1_kneaddata_paired	Proteobacteria	22518	P	95520	185	95705	0.00327
ERR3199564_1_kneaddata_paired	Cyanobacteria	9876	P	47982	2844	50826	0.00174
ERR3199564_1_kneaddata_paired	Deferribacterota	10822	P	43529	191	43720	0.00149
ERR3199564_1_kneaddata_paired	Spirochaetota	32587	P	11005	8	11013	0.00038
ERR3199564_1_kneaddata_paired	Elusimicrobiota	11888	P	2890	0	2890	0.00010
ERR3199564_1_kneaddata_paired	Firmicutes_B	17289	P	1149	48	1197	0.00004
ERR3199564_1_kneaddata_paired	Firmicutes_I	18140	P	201	0	201	0.00001
ERR3199564_1_kneaddata_paired	Firmicutes_C	17613	P	184	0	184	0.00001
ERR3199564_1_kneaddata_paired	Thermotogota	33086	P	108	0	108	0.00000
ERR3199565_1_kneaddata_paired	Bacteroidota	4587	P	16086493	68700	16155193	0.58759
ERR3199565_1_kneaddata_paired	Firmicutes_A	14608	P	7468322	48740	7517062	0.27341
ERR3199565_1_kneaddata_paired	Spirochaetota	32587	P	772006	421	772427	0.02809
ERR3199565_1_kneaddata_paired	Verrucomicrobiota	33333	P	741051	6749	747800	0.02720
ERR3199565_1_kneaddata_paired	Firmicutes	12188	P	674160	6401	680561	0.02475
ERR3199565_1_kneaddata_paired	Desulfobacterota_A	11509	P	351048	4165	355213	0.01292
ERR3199565_1_kneaddata_paired	Campylobacterota	8700	P	300645	26	300671	0.01094
ERR3199565_1_kneaddata_paired	Actinobacteriota	615	P	275435	474	275909	0.01004
ERR3199565_1_kneaddata_paired	Proteobacteria	22518	P	232343	1186	233529	0.00849
ERR3199565_1_kneaddata_paired	Elusimicrobiota	11888	P	193851	0	193851	0.00705
ERR3199565_1_kneaddata_paired	Cyanobacteria	9876	P	190886	13971	204857	0.00745
ERR3199565_1_kneaddata_paired	Deferribacterota	10822	P	55417	214	55631	0.00202
ERR3199565_1_kneaddata_paired	Firmicutes_B	17289	P	909	33	942	0.00003
ERR3199565_1_kneaddata_paired	Firmicutes_I	18140	P	325	0	325	0.00001
ERR3199565_1_kneaddata_paired	Firmicutes_C	17613	P	183	0	183	0.00001
ERR3199565_1_kneaddata_paired	Thermotogota	33086	P	25	0	25	0.00000
ERR3199566_1_kneaddata_paired	Firmicutes_A	14608	P	16466614	113682	16580296	0.56252
ERR3199566_1_kneaddata_paired	Bacteroidota	4587	P	10557847	30535	10588382	0.35923
ERR3199566_1_kneaddata_paired	Firmicutes	12188	P	490258	6108	496366	0.01684
ERR3199566_1_kneaddata_paired	Verrucomicrobiota	33333	P	451346	3477	454823	0.01543
ERR3199566_1_kneaddata_paired	Desulfobacterota_A	11509	P	343336	2830	346166	0.01174
ERR3199566_1_kneaddata_paired	Campylobacterota	8700	P	280953	9	280962	0.00953
ERR3199566_1_kneaddata_paired	Actinobacteriota	615	P	214772	663	215435	0.00731
ERR3199566_1_kneaddata_paired	Proteobacteria	22518	P	156840	551	157391	0.00534
ERR3199566_1_kneaddata_paired	Deferribacterota	10822	P	133047	427	133474	0.00453
ERR3199566_1_kneaddata_paired	Spirochaetota	32587	P	109220	49	109269	0.00371
ERR3199566_1_kneaddata_paired	Cyanobacteria	9876	P	85714	4135	89849	0.00305
ERR3199566_1_kneaddata_paired	Elusimicrobiota	11888	P	20632	0	20632	0.00070
ERR3199566_1_kneaddata_paired	Firmicutes_B	17289	P	1550	47	1597	0.00005
ERR3199566_1_kneaddata_paired	Firmicutes_I	18140	P	314	0	314	0.00001
ERR3199566_1_kneaddata_paired	Firmicutes_C	17613	P	132	0	132	0.00000
ERR3199566_1_kneaddata_paired	Thermotogota	33086	P	35	0	35	0.00000
ERR3199567_1_kneaddata_paired	Bacteroidota	4587	P	21219105	97355	21316460	0.71500
ERR3199567_1_kneaddata_paired	Firmicutes_A	14608	P	4908571	38843	4947414	0.16595
ERR3199567_1_kneaddata_paired	Firmicutes	12188	P	2008698	26602	2035300	0.06827
ERR3199567_1_kneaddata_paired	Actinobacteriota	615	P	725947	1335	727282	0.02439
ERR3199567_1_kneaddata_paired	Campylobacterota	8700	P	190982	27	191009	0.00641
ERR3199567_1_kneaddata_paired	Proteobacteria	22518	P	146546	286	146832	0.00493
ERR3199567_1_kneaddata_paired	Cyanobacteria	9876	P	125406	11084	136490	0.00458
ERR3199567_1_kneaddata_paired	Spirochaetota	32587	P	110205	74	110279	0.00370
ERR3199567_1_kneaddata_paired	Desulfobacterota_A	11509	P	109172	1566	110738	0.00371
ERR3199567_1_kneaddata_paired	Deferribacterota	10822	P	46094	216	46310	0.00155
ERR3199567_1_kneaddata_paired	Elusimicrobiota	11888	P	27651	0	27651	0.00093
ERR3199567_1_kneaddata_paired	Verrucomicrobiota	33333	P	15385	205	15590	0.00052
ERR3199567_1_kneaddata_paired	Firmicutes_I	18140	P	1354	0	1354	0.00005
ERR3199567_1_kneaddata_paired	Firmicutes_B	17289	P	384	17	401	0.00001
ERR3199567_1_kneaddata_paired	Firmicutes_C	17613	P	53	0	53	0.00000
ERR3199567_1_kneaddata_paired	Thermotogota	33086	P	6	0	6	0.00000
ERR3199568_1_kneaddata_paired	Bacteroidota	4587	P	20270946	119892	20390838	0.72445
ERR3199568_1_kneaddata_paired	Firmicutes_A	14608	P	4809850	29461	4839311	0.17193
ERR3199568_1_kneaddata_paired	Firmicutes	12188	P	1526865	24135	1551000	0.05510
ERR3199568_1_kneaddata_paired	Verrucomicrobiota	33333	P	495070	5358	500428	0.01778
ERR3199568_1_kneaddata_paired	Actinobacteriota	615	P	317492	756	318248	0.01131
ERR3199568_1_kneaddata_paired	Proteobacteria	22518	P	212944	2812	215756	0.00767
ERR3199568_1_kneaddata_paired	Campylobacterota	8700	P	129286	34	129320	0.00459
ERR3199568_1_kneaddata_paired	Desulfobacterota_A	11509	P	70430	1047	71477	0.00254
ERR3199568_1_kneaddata_paired	Cyanobacteria	9876	P	67158	4599	71757	0.00255
ERR3199568_1_kneaddata_paired	Spirochaetota	32587	P	27631	19	27650	0.00098
ERR3199568_1_kneaddata_paired	Elusimicrobiota	11888	P	17140	0	17140	0.00061
ERR3199568_1_kneaddata_paired	Deferribacterota	10822	P	12616	57	12673	0.00045
ERR3199568_1_kneaddata_paired	Firmicutes_I	18140	P	476	0	476	0.00002
ERR3199568_1_kneaddata_paired	Firmicutes_B	17289	P	274	12	286	0.00001
ERR3199568_1_kneaddata_paired	Firmicutes_C	17613	P	151	0	151	0.00001
ERR3199568_1_kneaddata_paired	Thermotogota	33086	P	23	0	23	0.00000
ERR3199569_1_kneaddata_paired	Bacteroidota	4587	P	19847569	90463	19938032	0.67479
ERR3199569_1_kneaddata_paired	Firmicutes_A	14608	P	6342984	47313	6390297	0.21628
ERR3199569_1_kneaddata_paired	Verrucomicrobiota	33333	P	1398449	13519	1411968	0.04779
ERR3199569_1_kneaddata_paired	Firmicutes	12188	P	606100	15000	621100	0.02102
ERR3199569_1_kneaddata_paired	Actinobacteriota	615	P	584515	1314	585829	0.01983
ERR3199569_1_kneaddata_paired	Proteobacteria	22518	P	132437	1418	133855	0.00453
ERR3199569_1_kneaddata_paired	Campylobacterota	8700	P	119838	20	119858	0.00406
ERR3199569_1_kneaddata_paired	Elusimicrobiota	11888	P	100797	0	100797	0.00341
ERR3199569_1_kneaddata_paired	Desulfobacterota_A	11509	P	91607	1167	92774	0.00314
ERR3199569_1_kneaddata_paired	Spirochaetota	32587	P	67847	40	67887	0.00230
ERR3199569_1_kneaddata_paired	Cyanobacteria	9876	P	59616	3873	63489	0.00215
ERR3199569_1_kneaddata_paired	Deferribacterota	10822	P	19771	81	19852	0.00067
ERR3199569_1_kneaddata_paired	Firmicutes_B	17289	P	459	18	477	0.00002
ERR3199569_1_kneaddata_paired	Firmicutes_I	18140	P	403	0	403	0.00001
ERR3199569_1_kneaddata_paired	Firmicutes_C	17613	P	114	0	114	0.00000
ERR3199569_1_kneaddata_paired	Thermotogota	33086	P	97	0	97	0.00000
ERR3199570_1_kneaddata_paired	Bacteroidota	4587	P	20354483	69448	20423931	0.71594
ERR3199570_1_kneaddata_paired	Firmicutes_A	14608	P	2308355	14702	2323057	0.08143
ERR3199570_1_kneaddata_paired	Firmicutes	12188	P	2202986	57212	2260198	0.07923
ERR3199570_1_kneaddata_paired	Verrucomicrobiota	33333	P	1740184	17359	1757543	0.06161
ERR3199570_1_kneaddata_paired	Actinobacteriota	615	P	540365	674	541039	0.01897
ERR3199570_1_kneaddata_paired	Proteobacteria	22518	P	525601	1257	526858	0.01847
ERR3199570_1_kneaddata_paired	Elusimicrobiota	11888	P	177060	0	177060	0.00621
ERR3199570_1_kneaddata_paired	Spirochaetota	32587	P	151044	88	151132	0.00530
ERR3199570_1_kneaddata_paired	Desulfobacterota_A	11509	P	145803	1979	147782	0.00518
ERR3199570_1_kneaddata_paired	Cyanobacteria	9876	P	133544	9908	143452	0.00503
ERR3199570_1_kneaddata_paired	Campylobacterota	8700	P	60212	9	60221	0.00211
ERR3199570_1_kneaddata_paired	Deferribacterota	10822	P	14082	57	14139	0.00050
ERR3199570_1_kneaddata_paired	Firmicutes_I	18140	P	500	0	500	0.00002
ERR3199570_1_kneaddata_paired	Firmicutes_B	17289	P	311	12	323	0.00001
ERR3199570_1_kneaddata_paired	Firmicutes_C	17613	P	81	0	81	0.00000
ERR3199570_1_kneaddata_paired	Thermotogota	33086	P	18	0	18	0.00000
ERR3199571_1_kneaddata_paired	Bacteroidota	4587	P	15171360	63553	15234913	0.53838
ERR3199571_1_kneaddata_paired	Firmicutes_A	14608	P	10323838	99843	10423681	0.36836
ERR3199571_1_kneaddata_paired	Firmicutes	12188	P	1007285	7602	1014887	0.03586
ERR3199571_1_kneaddata_paired	Campylobacterota	8700	P	407667	5	407672	0.01441
ERR3199571_1_kneaddata_paired	Deferribacterota	10822	P	340225	1221	341446	0.01207
ERR3199571_1_kneaddata_paired	Verrucomicrobiota	33333	P	258204	2183	260387	0.00920
ERR3199571_1_kneaddata_paired	Actinobacteriota	615	P	257796	534	258330	0.00913
ERR3199571_1_kneaddata_paired	Proteobacteria	22518	P	112242	237	112479	0.00397
ERR3199571_1_kneaddata_paired	Desulfobacterota_A	11509	P	105486	1303	106789	0.00377
ERR3199571_1_kneaddata_paired	Cyanobacteria	9876	P	78751	4321	83072	0.00294
ERR3199571_1_kneaddata_paired	Spirochaetota	32587	P	37815	19	37834	0.00134
ERR3199571_1_kneaddata_paired	Elusimicrobiota	11888	P	14854	0	14854	0.00052
ERR3199571_1_kneaddata_paired	Firmicutes_B	17289	P	597	20	617	0.00002
ERR3199571_1_kneaddata_paired	Firmicutes_I	18140	P	561	0	561	0.00002
ERR3199571_1_kneaddata_paired	Firmicutes_C	17613	P	148	0	148	0.00001
ERR3199571_1_kneaddata_paired	Thermotogota	33086	P	12	0	12	0.00000
ERR3199572_1_kneaddata_paired	Bacteroidota	4587	P	20309722	88177	20397899	0.71757
ERR3199572_1_kneaddata_paired	Firmicutes_A	14608	P	3323587	28051	3351638	0.11791
ERR3199572_1_kneaddata_paired	Verrucomicrobiota	33333	P	2064526	21728	2086254	0.07339
ERR3199572_1_kneaddata_paired	Firmicutes	12188	P	816553	36454	853007	0.03001
ERR3199572_1_kneaddata_paired	Actinobacteriota	615	P	664183	1040	665223	0.02340
ERR3199572_1_kneaddata_paired	Proteobacteria	22518	P	254303	440	254743	0.00896
ERR3199572_1_kneaddata_paired	Campylobacterota	8700	P	203827	25	203852	0.00717
ERR3199572_1_kneaddata_paired	Elusimicrobiota	11888	P	203320	0	203320	0.00715
ERR3199572_1_kneaddata_paired	Spirochaetota	32587	P	169841	107	169948	0.00598
ERR3199572_1_kneaddata_paired	Desulfobacterota_A	11509	P	127121	1645	128766	0.00453
ERR3199572_1_kneaddata_paired	Cyanobacteria	9876	P	84190	6894	91084	0.00320
ERR3199572_1_kneaddata_paired	Deferribacterota	10822	P	18850	84	18934	0.00067
ERR3199572_1_kneaddata_paired	Firmicutes_B	17289	P	871	37	908	0.00003
ERR3199572_1_kneaddata_paired	Firmicutes_I	18140	P	471	0	471	0.00002
ERR3199572_1_kneaddata_paired	Firmicutes_C	17613	P	130	0	130	0.00000
ERR3199572_1_kneaddata_paired	Thermotogota	33086	P	44	0	44	0.00000
ERR3199573_1_kneaddata_paired	Bacteroidota	4587	P	15282016	54654	15336670	0.58132
ERR3199573_1_kneaddata_paired	Firmicutes_A	14608	P	6586427	33272	6619699	0.25091
ERR3199573_1_kneaddata_paired	Verrucomicrobiota	33333	P	2037563	16891	2054454	0.07787
ERR3199573_1_kneaddata_paired	Firmicutes	12188	P	1107293	13278	1120571	0.04247
ERR3199573_1_kneaddata_paired	Cyanobacteria	9876	P	338315	20898	359213	0.01362
ERR3199573_1_kneaddata_paired	Proteobacteria	22518	P	327261	3311	330572	0.01253
ERR3199573_1_kneaddata_paired	Campylobacterota	8700	P	169173	80	169253	0.00642
ERR3199573_1_kneaddata_paired	Elusimicrobiota	11888	P	129575	0	129575	0.00491
ERR3199573_1_kneaddata_paired	Actinobacteriota	615	P	127969	303	128272	0.00486
ERR3199573_1_kneaddata_paired	Desulfobacterota_A	11509	P	113055	1183	114238	0.00433
ERR3199573_1_kneaddata_paired	Deferribacterota	10822	P	16483	58	16541	0.00063
ERR3199573_1_kneaddata_paired	Spirochaetota	32587	P	1807	2	1809	0.00007
ERR3199573_1_kneaddata_paired	Firmicutes_I	18140	P	838	0	838	0.00003
ERR3199573_1_kneaddata_paired	Firmicutes_B	17289	P	515	17	532	0.00002
ERR3199573_1_kneaddata_paired	Firmicutes_C	17613	P	159	0	159	0.00001
ERR3199573_1_kneaddata_paired	Thermotogota	33086	P	26	0	26	0.00000
ERR3199574_1_kneaddata_paired	Bacteroidota	4587	P	14266930	71694	14338624	0.58287
ERR3199574_1_kneaddata_paired	Firmicutes_A	14608	P	4830339	49345	4879684	0.19836
ERR3199574_1_kneaddata_paired	Verrucomicrobiota	33333	P	1507313	10436	1517749	0.06170
ERR3199574_1_kneaddata_paired	Proteobacteria	22518	P	1335182	428	1335610	0.05429
ERR3199574_1_kneaddata_paired	Elusimicrobiota	11888	P	1072200	0	1072200	0.04358
ERR3199574_1_kneaddata_paired	Desulfobacterota_A	11509	P	475791	3456	479247	0.01948
ERR3199574_1_kneaddata_paired	Firmicutes	12188	P	309426	3775	313201	0.01273
ERR3199574_1_kneaddata_paired	Actinobacteriota	615	P	227727	591	228318	0.00928
ERR3199574_1_kneaddata_paired	Cyanobacteria	9876	P	226307	12578	238885	0.00971
ERR3199574_1_kneaddata_paired	Campylobacterota	8700	P	89621	20	89641	0.00364
ERR3199574_1_kneaddata_paired	Deferribacterota	10822	P	81814	241	82055	0.00334
ERR3199574_1_kneaddata_paired	Spirochaetota	32587	P	23992	10	24002	0.00098
ERR3199574_1_kneaddata_paired	Firmicutes_B	17289	P	687	19	706	0.00003
ERR3199574_1_kneaddata_paired	Firmicutes_I	18140	P	195	0	195	0.00001
ERR3199574_1_kneaddata_paired	Firmicutes_C	17613	P	102	0	102	0.00000
ERR3199574_1_kneaddata_paired	Thermotogota	33086	P	9	0	9	0.00000
ERR3199575_1_kneaddata_paired	Bacteroidota	4587	P	15895912	64461	15960373	0.60049
ERR3199575_1_kneaddata_paired	Firmicutes_A	14608	P	8316469	33526	8349995	0.31416
ERR3199575_1_kneaddata_paired	Firmicutes	12188	P	996509	43247	1039756	0.03912
ERR3199575_1_kneaddata_paired	Actinobacteriota	615	P	316003	581	316584	0.01191
ERR3199575_1_kneaddata_paired	Desulfobacterota_A	11509	P	304434	3194	307628	0.01157
ERR3199575_1_kneaddata_paired	Proteobacteria	22518	P	204561	342	204903	0.00771
ERR3199575_1_kneaddata_paired	Spirochaetota	32587	P	176601	103	176704	0.00665
ERR3199575_1_kneaddata_paired	Campylobacterota	8700	P	94238	2	94240	0.00355
ERR3199575_1_kneaddata_paired	Verrucomicrobiota	33333	P	51601	577	52178	0.00196
ERR3199575_1_kneaddata_paired	Cyanobacteria	9876	P	40201	2684	42885	0.00161
ERR3199575_1_kneaddata_paired	Deferribacterota	10822	P	24336	101	24437	0.00092
ERR3199575_1_kneaddata_paired	Elusimicrobiota	11888	P	7943	0	7943	0.00030
ERR3199575_1_kneaddata_paired	Firmicutes_B	17289	P	688	27	715	0.00003
ERR3199575_1_kneaddata_paired	Firmicutes_I	18140	P	433	0	433	0.00002
ERR3199575_1_kneaddata_paired	Firmicutes_C	17613	P	130	0	130	0.00000
ERR3199575_1_kneaddata_paired	Thermotogota	33086	P	9	0	9	0.00000
ERR3199576_1_kneaddata_paired	Bacteroidota	4587	P	20336518	92136	20428654	0.73923
ERR3199576_1_kneaddata_paired	Firmicutes_A	14608	P	3281392	35486	3316878	0.12002
ERR3199576_1_kneaddata_paired	Firmicutes	12188	P	1283596	30695	1314291	0.04756
ERR3199576_1_kneaddata_paired	Verrucomicrobiota	33333	P	1104207	14147	1118354	0.04047
ERR3199576_1_kneaddata_paired	Actinobacteriota	615	P	612958	1533	614491	0.02224
ERR3199576_1_kneaddata_paired	Campylobacterota	8700	P	254676	169	254845	0.00922
ERR3199576_1_kneaddata_paired	Proteobacteria	22518	P	214426	528	214954	0.00778
ERR3199576_1_kneaddata_paired	Desulfobacterota_A	11509	P	102493	1449	103942	0.00376
ERR3199576_1_kneaddata_paired	Deferribacterota	10822	P	89917	483	90400	0.00327
ERR3199576_1_kneaddata_paired	Cyanobacteria	9876	P	83322	8322	91644	0.00332
ERR3199576_1_kneaddata_paired	Elusimicrobiota	11888	P	46372	0	46372	0.00168
ERR3199576_1_kneaddata_paired	Spirochaetota	32587	P	39187	30	39217	0.00142
ERR3199576_1_kneaddata_paired	Firmicutes_B	17289	P	444	22	466	0.00002
ERR3199576_1_kneaddata_paired	Firmicutes_I	18140	P	334	0	334	0.00001
ERR3199576_1_kneaddata_paired	Firmicutes_C	17613	P	64	0	64	0.00000
ERR3199576_1_kneaddata_paired	Thermotogota	33086	P	15	0	15	0.00000
ERR3199577_1_kneaddata_paired	Bacteroidota	4587	P	22568304	109569	22677873	0.75466
ERR3199577_1_kneaddata_paired	Firmicutes_A	14608	P	4042554	36636	4079190	0.13575
ERR3199577_1_kneaddata_paired	Firmicutes	12188	P	1086007	13818	1099825	0.03660
ERR3199577_1_kneaddata_paired	Spirochaetota	32587	P	663195	493	663688	0.02209
ERR3199577_1_kneaddata_paired	Actinobacteriota	615	P	399903	820	400723	0.01334
ERR3199577_1_kneaddata_paired	Verrucomicrobiota	33333	P	352809	4508	357317	0.01189
ERR3199577_1_kneaddata_paired	Campylobacterota	8700	P	254917	75	254992	0.00849
ERR3199577_1_kneaddata_paired	Proteobacteria	22518	P	162115	540	162655	0.00541
ERR3199577_1_kneaddata_paired	Desulfobacterota_A	11509	P	154855	4122	158977	0.00529
ERR3199577_1_kneaddata_paired	Cyanobacteria	9876	P	117773	11828	129601	0.00431
ERR3199577_1_kneaddata_paired	Elusimicrobiota	11888	P	46558	0	46558	0.00155
ERR3199577_1_kneaddata_paired	Deferribacterota	10822	P	17788	93	17881	0.00060
ERR3199577_1_kneaddata_paired	Firmicutes_I	18140	P	576	0	576	0.00002
ERR3199577_1_kneaddata_paired	Firmicutes_B	17289	P	419	21	440	0.00001
ERR3199577_1_kneaddata_paired	Firmicutes_C	17613	P	44	0	44	0.00000
ERR3199577_1_kneaddata_paired	Thermotogota	33086	P	6	0	6	0.00000
ERR3199578_1_kneaddata_paired	Bacteroidota	4587	P	19989818	128271	20118089	0.72948
ERR3199578_1_kneaddata_paired	Firmicutes_A	14608	P	5011214	39871	5051085	0.18315
ERR3199578_1_kneaddata_paired	Firmicutes	12188	P	913296	10533	923829	0.03350
ERR3199578_1_kneaddata_paired	Verrucomicrobiota	33333	P	493465	6314	499779	0.01812
ERR3199578_1_kneaddata_paired	Elusimicrobiota	11888	P	169039	0	169039	0.00613
ERR3199578_1_kneaddata_paired	Spirochaetota	32587	P	165958	128	166086	0.00602
ERR3199578_1_kneaddata_paired	Campylobacterota	8700	P	153059	13	153072	0.00555
ERR3199578_1_kneaddata_paired	Actinobacteriota	615	P	129405	488	129893	0.00471
ERR3199578_1_kneaddata_paired	Desulfobacterota_A	11509	P	121145	1781	122926	0.00446
ERR3199578_1_kneaddata_paired	Proteobacteria	22518	P	98081	404	98485	0.00357
ERR3199578_1_kneaddata_paired	Cyanobacteria	9876	P	86578	8399	94977	0.00344
ERR3199578_1_kneaddata_paired	Deferribacterota	10822	P	49303	269	49572	0.00180
ERR3199578_1_kneaddata_paired	Firmicutes_B	17289	P	1068	55	1123	0.00004
ERR3199578_1_kneaddata_paired	Firmicutes_I	18140	P	464	0	464	0.00002
ERR3199578_1_kneaddata_paired	Firmicutes_C	17613	P	102	0	102	0.00000
ERR3199578_1_kneaddata_paired	Thermotogota	33086	P	17	0	17	0.00000
ERR3199579_1_kneaddata_paired	Bacteroidota	4587	P	16814269	73318	16887587	0.64455
ERR3199579_1_kneaddata_paired	Firmicutes_A	14608	P	6536562	37061	6573623	0.25089
ERR3199579_1_kneaddata_paired	Firmicutes	12188	P	1023344	9172	1032516	0.03941
ERR3199579_1_kneaddata_paired	Verrucomicrobiota	33333	P	513872	4692	518564	0.01979
ERR3199579_1_kneaddata_paired	Spirochaetota	32587	P	318625	175	318800	0.01217
ERR3199579_1_kneaddata_paired	Actinobacteriota	615	P	207512	390	207902	0.00793
ERR3199579_1_kneaddata_paired	Campylobacterota	8700	P	182147	19	182166	0.00695
ERR3199579_1_kneaddata_paired	Proteobacteria	22518	P	174557	1572	176129	0.00672
ERR3199579_1_kneaddata_paired	Cyanobacteria	9876	P	126915	9263	136178	0.00520
ERR3199579_1_kneaddata_paired	Elusimicrobiota	11888	P	71842	0	71842	0.00274
ERR3199579_1_kneaddata_paired	Desulfobacterota_A	11509	P	69995	857	70852	0.00270
ERR3199579_1_kneaddata_paired	Deferribacterota	10822	P	23385	90	23475	0.00090
ERR3199579_1_kneaddata_paired	Firmicutes_B	17289	P	648	24	672	0.00003
ERR3199579_1_kneaddata_paired	Firmicutes_I	18140	P	309	0	309	0.00001
ERR3199579_1_kneaddata_paired	Firmicutes_C	17613	P	99	0	99	0.00000
ERR3199579_1_kneaddata_paired	Thermotogota	33086	P	9	0	9	0.00000
ERR3199580_1_kneaddata_paired	Bacteroidota	4587	P	16827782	82920	16910702	0.59961
ERR3199580_1_kneaddata_paired	Firmicutes_A	14608	P	6125553	39937	6165490	0.21861
ERR3199580_1_kneaddata_paired	Firmicutes	12188	P	1485397	13397	1498794	0.05314
ERR3199580_1_kneaddata_paired	Verrucomicrobiota	33333	P	1372612	12395	1385007	0.04911
ERR3199580_1_kneaddata_paired	Actinobacteriota	615	P	1026042	1120	1027162	0.03642
ERR3199580_1_kneaddata_paired	Proteobacteria	22518	P	387113	1109	388222	0.01377
ERR3199580_1_kneaddata_paired	Campylobacterota	8700	P	203988	35	204023	0.00723
ERR3199580_1_kneaddata_paired	Desulfobacterota_A	11509	P	198744	2287	201031	0.00713
ERR3199580_1_kneaddata_paired	Cyanobacteria	9876	P	160235	10848	171083	0.00607
ERR3199580_1_kneaddata_paired	Spirochaetota	32587	P	135266	73	135339	0.00480
ERR3199580_1_kneaddata_paired	Elusimicrobiota	11888	P	78356	0	78356	0.00278
ERR3199580_1_kneaddata_paired	Deferribacterota	10822	P	36168	137	36305	0.00129
ERR3199580_1_kneaddata_paired	Firmicutes_I	18140	P	674	0	674	0.00002
ERR3199580_1_kneaddata_paired	Firmicutes_B	17289	P	543	19	562	0.00002
ERR3199580_1_kneaddata_paired	Firmicutes_C	17613	P	197	0	197	0.00001
ERR3199580_1_kneaddata_paired	Thermotogota	33086	P	51	0	51	0.00000
ERR3199581_1_kneaddata_paired	Bacteroidota	4587	P	12194888	38961	12233849	0.43724
ERR3199581_1_kneaddata_paired	Firmicutes_A	14608	P	10422241	97204	10519445	0.37597
ERR3199581_1_kneaddata_paired	Spirochaetota	32587	P	2295835	1331	2297166	0.08210
ERR3199581_1_kneaddata_paired	Campylobacterota	8700	P	820666	66	820732	0.02933
ERR3199581_1_kneaddata_paired	Desulfobacterota_A	11509	P	547808	5963	553771	0.01979
ERR3199581_1_kneaddata_paired	Firmicutes	12188	P	496377	6200	502577	0.01796
ERR3199581_1_kneaddata_paired	Deferribacterota	10822	P	444378	1837	446215	0.01595
ERR3199581_1_kneaddata_paired	Verrucomicrobiota	33333	P	254152	2461	256613	0.00917
ERR3199581_1_kneaddata_paired	Actinobacteriota	615	P	174906	491	175397	0.00627
ERR3199581_1_kneaddata_paired	Proteobacteria	22518	P	93033	205	93238	0.00333
ERR3199581_1_kneaddata_paired	Cyanobacteria	9876	P	58490	4309	62799	0.00224
ERR3199581_1_kneaddata_paired	Elusimicrobiota	11888	P	15064	0	15064	0.00054
ERR3199581_1_kneaddata_paired	Firmicutes_B	17289	P	2065	81	2146	0.00008
ERR3199581_1_kneaddata_paired	Firmicutes_I	18140	P	369	0	369	0.00001
ERR3199581_1_kneaddata_paired	Firmicutes_C	17613	P	182	0	182	0.00001
ERR3199581_1_kneaddata_paired	Thermotogota	33086	P	23	0	23	0.00000
ERR3199582_1_kneaddata_paired	Bacteroidota	4587	P	15983254	79620	16062874	0.58472
ERR3199582_1_kneaddata_paired	Firmicutes_A	14608	P	8750617	74935	8825552	0.32127
ERR3199582_1_kneaddata_paired	Firmicutes	12188	P	752910	14537	767447	0.02794
ERR3199582_1_kneaddata_paired	Actinobacteriota	615	P	680402	1033	681435	0.02481
ERR3199582_1_kneaddata_paired	Spirochaetota	32587	P	329407	211	329618	0.01200
ERR3199582_1_kneaddata_paired	Campylobacterota	8700	P	266227	36	266263	0.00969
ERR3199582_1_kneaddata_paired	Desulfobacterota_A	11509	P	224148	2670	226818	0.00826
ERR3199582_1_kneaddata_paired	Verrucomicrobiota	33333	P	151933	1660	153593	0.00559
ERR3199582_1_kneaddata_paired	Proteobacteria	22518	P	99240	253	99493	0.00362
ERR3199582_1_kneaddata_paired	Deferribacterota	10822	P	26759	120	26879	0.00098
ERR3199582_1_kneaddata_paired	Cyanobacteria	9876	P	25391	1520	26911	0.00098
ERR3199582_1_kneaddata_paired	Elusimicrobiota	11888	P	2599	0	2599	0.00009
ERR3199582_1_kneaddata_paired	Firmicutes_B	17289	P	809	35	844	0.00003
ERR3199582_1_kneaddata_paired	Firmicutes_I	18140	P	314	0	314	0.00001
ERR3199582_1_kneaddata_paired	Firmicutes_C	17613	P	112	0	112	0.00000
ERR3199582_1_kneaddata_paired	Thermotogota	33086	P	101	0	101	0.00000
ERR3199583_1_kneaddata_paired	Bacteroidota	4587	P	14341950	41820	14383770	0.49992
ERR3199583_1_kneaddata_paired	Firmicutes_A	14608	P	9608040	109933	9717973	0.33775
ERR3199583_1_kneaddata_paired	Verrucomicrobiota	33333	P	1724535	13985	1738520	0.06042
ERR3199583_1_kneaddata_paired	Firmicutes	12188	P	589446	6345	595791	0.02071
ERR3199583_1_kneaddata_paired	Campylobacterota	8700	P	588894	77	588971	0.02047
ERR3199583_1_kneaddata_paired	Spirochaetota	32587	P	561268	274	561542	0.01952
ERR3199583_1_kneaddata_paired	Actinobacteriota	615	P	451732	635	452367	0.01572
ERR3199583_1_kneaddata_paired	Desulfobacterota_A	11509	P	309701	2876	312577	0.01086
ERR3199583_1_kneaddata_paired	Proteobacteria	22518	P	160876	453	161329	0.00561
ERR3199583_1_kneaddata_paired	Elusimicrobiota	11888	P	119296	0	119296	0.00415
ERR3199583_1_kneaddata_paired	Cyanobacteria	9876	P	69508	4274	73782	0.00256
ERR3199583_1_kneaddata_paired	Deferribacterota	10822	P	64973	225	65198	0.00227
ERR3199583_1_kneaddata_paired	Firmicutes_B	17289	P	670	22	692	0.00002
ERR3199583_1_kneaddata_paired	Firmicutes_I	18140	P	310	0	310	0.00001
ERR3199583_1_kneaddata_paired	Firmicutes_C	17613	P	124	0	124	0.00000
ERR3199583_1_kneaddata_paired	Thermotogota	33086	P	20	0	20	0.00000
ERR3199584_1_kneaddata_paired	Bacteroidota	4587	P	17888964	96705	17985669	0.68112
ERR3199584_1_kneaddata_paired	Firmicutes_A	14608	P	6435399	39528	6474927	0.24520
ERR3199584_1_kneaddata_paired	Firmicutes	12188	P	800843	13556	814399	0.03084
ERR3199584_1_kneaddata_paired	Verrucomicrobiota	33333	P	399870	4693	404563	0.01532
ERR3199584_1_kneaddata_paired	Actinobacteriota	615	P	163780	471	164251	0.00622
ERR3199584_1_kneaddata_paired	Proteobacteria	22518	P	162883	367	163250	0.00618
ERR3199584_1_kneaddata_paired	Spirochaetota	32587	P	123297	89	123386	0.00467
ERR3199584_1_kneaddata_paired	Desulfobacterota_A	11509	P	116277	1760	118037	0.00447
ERR3199584_1_kneaddata_paired	Cyanobacteria	9876	P	66943	3214	70157	0.00266
ERR3199584_1_kneaddata_paired	Campylobacterota	8700	P	51483	4	51487	0.00195
ERR3199584_1_kneaddata_paired	Elusimicrobiota	11888	P	18430	0	18430	0.00070
ERR3199584_1_kneaddata_paired	Deferribacterota	10822	P	16671	83	16754	0.00063
ERR3199584_1_kneaddata_paired	Firmicutes_B	17289	P	383	18	401	0.00002
ERR3199584_1_kneaddata_paired	Firmicutes_I	18140	P	356	0	356	0.00001
ERR3199584_1_kneaddata_paired	Firmicutes_C	17613	P	107	0	107	0.00000
ERR3199584_1_kneaddata_paired	Thermotogota	33086	P	8	0	8	0.00000
ERR3199585_1_kneaddata_paired	Bacteroidota	4587	P	22070527	84316	22154843	0.71646
ERR3199585_1_kneaddata_paired	Firmicutes_A	14608	P	5477417	58619	5536036	0.17903
ERR3199585_1_kneaddata_paired	Firmicutes	12188	P	1274418	21776	1296194	0.04192
ERR3199585_1_kneaddata_paired	Actinobacteriota	615	P	754505	1113	755618	0.02444
ERR3199585_1_kneaddata_paired	Verrucomicrobiota	33333	P	321119	3378	324497	0.01049
ERR3199585_1_kneaddata_paired	Spirochaetota	32587	P	265074	166	265240	0.00858
ERR3199585_1_kneaddata_paired	Proteobacteria	22518	P	219563	368	219931	0.00711
ERR3199585_1_kneaddata_paired	Campylobacterota	8700	P	118671	12	118683	0.00384
ERR3199585_1_kneaddata_paired	Desulfobacterota_A	11509	P	108185	1491	109676	0.00355
ERR3199585_1_kneaddata_paired	Cyanobacteria	9876	P	100946	8626	109572	0.00354
ERR3199585_1_kneaddata_paired	Elusimicrobiota	11888	P	17475	0	17475	0.00057
ERR3199585_1_kneaddata_paired	Deferribacterota	10822	P	13780	60	13840	0.00045
ERR3199585_1_kneaddata_paired	Firmicutes_B	17289	P	493	20	513	0.00002
ERR3199585_1_kneaddata_paired	Firmicutes_I	18140	P	281	0	281	0.00001
ERR3199585_1_kneaddata_paired	Firmicutes_C	17613	P	63	0	63	0.00000
ERR3199585_1_kneaddata_paired	Thermotogota	33086	P	35	0	35	0.00000
ERR3199586_1_kneaddata_paired	Bacteroidota	4587	P	21874775	113240	21988015	0.74630
ERR3199586_1_kneaddata_paired	Firmicutes_A	14608	P	4919554	49154	4968708	0.16864
ERR3199586_1_kneaddata_paired	Firmicutes	12188	P	1056935	17710	1074645	0.03647
ERR3199586_1_kneaddata_paired	Actinobacteriota	615	P	360093	859	360952	0.01225
ERR3199586_1_kneaddata_paired	Proteobacteria	22518	P	358261	14379	372640	0.01265
ERR3199586_1_kneaddata_paired	Spirochaetota	32587	P	195094	173	195267	0.00663
ERR3199586_1_kneaddata_paired	Campylobacterota	8700	P	146087	25	146112	0.00496
ERR3199586_1_kneaddata_paired	Verrucomicrobiota	33333	P	144151	2160	146311	0.00497
ERR3199586_1_kneaddata_paired	Desulfobacterota_A	11509	P	123228	2486	125714	0.00427
ERR3199586_1_kneaddata_paired	Deferribacterota	10822	P	40769	256	41025	0.00139
ERR3199586_1_kneaddata_paired	Cyanobacteria	9876	P	39751	2270	42021	0.00143
ERR3199586_1_kneaddata_paired	Firmicutes_B	17289	P	416	25	441	0.00001
ERR3199586_1_kneaddata_paired	Firmicutes_I	18140	P	387	0	387	0.00001
ERR3199586_1_kneaddata_paired	Elusimicrobiota	11888	P	311	0	311	0.00001
ERR3199586_1_kneaddata_paired	Firmicutes_C	17613	P	73	0	73	0.00000
ERR3199586_1_kneaddata_paired	Thermotogota	33086	P	7	0	7	0.00000
ERR3199587_1_kneaddata_paired	Bacteroidota	4587	P	20363193	75207	20438400	0.67415
ERR3199587_1_kneaddata_paired	Firmicutes_A	14608	P	5318937	54992	5373929	0.17726
ERR3199587_1_kneaddata_paired	Verrucomicrobiota	33333	P	2016555	19900	2036455	0.06717
ERR3199587_1_kneaddata_paired	Firmicutes	12188	P	789583	10157	799740	0.02638
ERR3199587_1_kneaddata_paired	Spirochaetota	32587	P	423647	248	423895	0.01398
ERR3199587_1_kneaddata_paired	Cyanobacteria	9876	P	310715	25012	335727	0.01107
ERR3199587_1_kneaddata_paired	Actinobacteriota	615	P	235767	504	236271	0.00779
ERR3199587_1_kneaddata_paired	Proteobacteria	22518	P	175793	754	176547	0.00582
ERR3199587_1_kneaddata_paired	Desulfobacterota_A	11509	P	174586	1798	176384	0.00582
ERR3199587_1_kneaddata_paired	Campylobacterota	8700	P	161733	3	161736	0.00533
ERR3199587_1_kneaddata_paired	Elusimicrobiota	11888	P	117900	0	117900	0.00389
ERR3199587_1_kneaddata_paired	Deferribacterota	10822	P	39016	162	39178	0.00129
ERR3199587_1_kneaddata_paired	Firmicutes_B	17289	P	706	28	734	0.00002
ERR3199587_1_kneaddata_paired	Firmicutes_I	18140	P	451	0	451	0.00001
ERR3199587_1_kneaddata_paired	Firmicutes_C	17613	P	99	0	99	0.00000
ERR3199587_1_kneaddata_paired	Thermotogota	33086	P	6	0	6	0.00000
ERR3199588_1_kneaddata_paired	Bacteroidota	4587	P	19874554	64378	19938932	0.66323
ERR3199588_1_kneaddata_paired	Firmicutes_A	14608	P	4543253	50087	4593340	0.15279
ERR3199588_1_kneaddata_paired	Actinobacteriota	615	P	1692393	2082	1694475	0.05636
ERR3199588_1_kneaddata_paired	Verrucomicrobiota	33333	P	1537921	15097	1553018	0.05166
ERR3199588_1_kneaddata_paired	Firmicutes	12188	P	818801	30387	849188	0.02825
ERR3199588_1_kneaddata_paired	Proteobacteria	22518	P	666687	4615	671302	0.02233
ERR3199588_1_kneaddata_paired	Elusimicrobiota	11888	P	229348	0	229348	0.00763
ERR3199588_1_kneaddata_paired	Cyanobacteria	9876	P	181477	12496	193973	0.00645
ERR3199588_1_kneaddata_paired	Campylobacterota	8700	P	160553	13	160566	0.00534
ERR3199588_1_kneaddata_paired	Desulfobacterota_A	11509	P	94838	1075	95913	0.00319
ERR3199588_1_kneaddata_paired	Spirochaetota	32587	P	54743	33	54776	0.00182
ERR3199588_1_kneaddata_paired	Deferribacterota	10822	P	27241	113	27354	0.00091
ERR3199588_1_kneaddata_paired	Firmicutes_B	17289	P	627	24	651	0.00002
ERR3199588_1_kneaddata_paired	Firmicutes_I	18140	P	342	0	342	0.00001
ERR3199588_1_kneaddata_paired	Firmicutes_C	17613	P	204	0	204	0.00001
ERR3199588_1_kneaddata_paired	Thermotogota	33086	P	18	0	18	0.00000
ERR3199589_1_kneaddata_paired	Firmicutes_A	14608	P	15773804	78676	15852480	0.51827
ERR3199589_1_kneaddata_paired	Bacteroidota	4587	P	10647368	35411	10682779	0.34926
ERR3199589_1_kneaddata_paired	Campylobacterota	8700	P	1494021	16	1494037	0.04885
ERR3199589_1_kneaddata_paired	Desulfobacterota_A	11509	P	744710	7903	752613	0.02461
ERR3199589_1_kneaddata_paired	Deferribacterota	10822	P	723856	2640	726496	0.02375
ERR3199589_1_kneaddata_paired	Spirochaetota	32587	P	373069	192	373261	0.01220
ERR3199589_1_kneaddata_paired	Firmicutes	12188	P	326861	3742	330603	0.01081
ERR3199589_1_kneaddata_paired	Actinobacteriota	615	P	169494	275	169769	0.00555
ERR3199589_1_kneaddata_paired	Proteobacteria	22518	P	133460	369	133829	0.00438
ERR3199589_1_kneaddata_paired	Cyanobacteria	9876	P	43524	2857	46381	0.00152
ERR3199589_1_kneaddata_paired	Verrucomicrobiota	33333	P	20698	226	20924	0.00068
ERR3199589_1_kneaddata_paired	Elusimicrobiota	11888	P	2380	0	2380	0.00008
ERR3199589_1_kneaddata_paired	Firmicutes_B	17289	P	923	32	955	0.00003
ERR3199589_1_kneaddata_paired	Firmicutes_I	18140	P	347	0	347	0.00001
ERR3199589_1_kneaddata_paired	Firmicutes_C	17613	P	127	0	127	0.00000
ERR3199589_1_kneaddata_paired	Thermotogota	33086	P	39	0	39	0.00000
ERR3199590_1_kneaddata_paired	Bacteroidota	4587	P	15216378	66643	15283021	0.53086
ERR3199590_1_kneaddata_paired	Firmicutes_A	14608	P	8162706	46811	8209517	0.28516
ERR3199590_1_kneaddata_paired	Verrucomicrobiota	33333	P	1869832	23874	1893706	0.06578
ERR3199590_1_kneaddata_paired	Spirochaetota	32587	P	1068897	816	1069713	0.03716
ERR3199590_1_kneaddata_paired	Firmicutes	12188	P	515836	7746	523582	0.01819
ERR3199590_1_kneaddata_paired	Campylobacterota	8700	P	443104	61	443165	0.01539
ERR3199590_1_kneaddata_paired	Desulfobacterota_A	11509	P	442508	5386	447894	0.01556
ERR3199590_1_kneaddata_paired	Actinobacteriota	615	P	394264	840	395104	0.01372
ERR3199590_1_kneaddata_paired	Deferribacterota	10822	P	187244	1017	188261	0.00654
ERR3199590_1_kneaddata_paired	Proteobacteria	22518	P	180845	2568	183413	0.00637
ERR3199590_1_kneaddata_paired	Elusimicrobiota	11888	P	98287	0	98287	0.00341
ERR3199590_1_kneaddata_paired	Cyanobacteria	9876	P	47125	4542	51667	0.00179
ERR3199590_1_kneaddata_paired	Firmicutes_B	17289	P	1194	62	1256	0.00004
ERR3199590_1_kneaddata_paired	Firmicutes_I	18140	P	213	0	213	0.00001
ERR3199590_1_kneaddata_paired	Firmicutes_C	17613	P	194	0	194	0.00001
ERR3199590_1_kneaddata_paired	Thermotogota	33086	P	31	0	31	0.00000
ERR3199591_1_kneaddata_paired	Bacteroidota	4587	P	22018736	88262	22106998	0.72970
ERR3199591_1_kneaddata_paired	Firmicutes_A	14608	P	4916534	47550	4964084	0.16385
ERR3199591_1_kneaddata_paired	Firmicutes	12188	P	856233	13043	869276	0.02869
ERR3199591_1_kneaddata_paired	Cyanobacteria	9876	P	708707	38340	747047	0.02466
ERR3199591_1_kneaddata_paired	Proteobacteria	22518	P	566526	3560	570086	0.01882
ERR3199591_1_kneaddata_paired	Actinobacteriota	615	P	264851	591	265442	0.00876
ERR3199591_1_kneaddata_paired	Verrucomicrobiota	33333	P	210874	1723	212597	0.00702
ERR3199591_1_kneaddata_paired	Campylobacterota	8700	P	177126	2	177128	0.00585
ERR3199591_1_kneaddata_paired	Elusimicrobiota	11888	P	164484	0	164484	0.00543
ERR3199591_1_kneaddata_paired	Spirochaetota	32587	P	112688	54	112742	0.00372
ERR3199591_1_kneaddata_paired	Desulfobacterota_A	11509	P	80511	799	81310	0.00268
ERR3199591_1_kneaddata_paired	Deferribacterota	10822	P	23488	79	23567	0.00078
ERR3199591_1_kneaddata_paired	Firmicutes_B	17289	P	560	18	578	0.00002
ERR3199591_1_kneaddata_paired	Firmicutes_I	18140	P	506	0	506	0.00002
ERR3199591_1_kneaddata_paired	Firmicutes_C	17613	P	222	0	222	0.00001
ERR3199591_1_kneaddata_paired	Thermotogota	33086	P	23	0	23	0.00000
ERR3199592_1_kneaddata_paired	Bacteroidota	4587	P	18104921	63844	18168765	0.64082
ERR3199592_1_kneaddata_paired	Firmicutes_A	14608	P	3572013	41132	3613145	0.12744
ERR3199592_1_kneaddata_paired	Verrucomicrobiota	33333	P	2977259	25964	3003223	0.10592
ERR3199592_1_kneaddata_paired	Firmicutes	12188	P	1350048	34374	1384422	0.04883
ERR3199592_1_kneaddata_paired	Actinobacteriota	615	P	923217	1053	924270	0.03260
ERR3199592_1_kneaddata_paired	Proteobacteria	22518	P	322501	903	323404	0.01141
ERR3199592_1_kneaddata_paired	Campylobacterota	8700	P	251252	22	251274	0.00886
ERR3199592_1_kneaddata_paired	Elusimicrobiota	11888	P	248841	0	248841	0.00878
ERR3199592_1_kneaddata_paired	Cyanobacteria	9876	P	190241	12670	202911	0.00716
ERR3199592_1_kneaddata_paired	Deferribacterota	10822	P	92795	347	93142	0.00329
ERR3199592_1_kneaddata_paired	Desulfobacterota_A	11509	P	79049	879	79928	0.00282
ERR3199592_1_kneaddata_paired	Spirochaetota	32587	P	58005	30	58035	0.00205
ERR3199592_1_kneaddata_paired	Firmicutes_I	18140	P	458	0	458	0.00002
ERR3199592_1_kneaddata_paired	Firmicutes_B	17289	P	438	15	453	0.00002
ERR3199592_1_kneaddata_paired	Firmicutes_C	17613	P	171	0	171	0.00001
ERR3199592_1_kneaddata_paired	Thermotogota	33086	P	11	0	11	0.00000
ERR3199593_1_kneaddata_paired	Bacteroidota	4587	P	19370562	70164	19440726	0.70816
ERR3199593_1_kneaddata_paired	Firmicutes_A	14608	P	3312182	23343	3335525	0.12150
ERR3199593_1_kneaddata_paired	Firmicutes	12188	P	1661331	30508	1691839	0.06163
ERR3199593_1_kneaddata_paired	Verrucomicrobiota	33333	P	1386071	19240	1405311	0.05119
ERR3199593_1_kneaddata_paired	Actinobacteriota	615	P	555404	1049	556453	0.02027
ERR3199593_1_kneaddata_paired	Proteobacteria	22518	P	311510	3675	315185	0.01148
ERR3199593_1_kneaddata_paired	Spirochaetota	32587	P	264756	219	264975	0.00965
ERR3199593_1_kneaddata_paired	Desulfobacterota_A	11509	P	192524	4432	196956	0.00717
ERR3199593_1_kneaddata_paired	Campylobacterota	8700	P	139827	92	139919	0.00510
ERR3199593_1_kneaddata_paired	Elusimicrobiota	11888	P	43239	0	43239	0.00158
ERR3199593_1_kneaddata_paired	Cyanobacteria	9876	P	42009	3415	45424	0.00165
ERR3199593_1_kneaddata_paired	Deferribacterota	10822	P	15823	92	15915	0.00058
ERR3199593_1_kneaddata_paired	Firmicutes_B	17289	P	555	31	586	0.00002
ERR3199593_1_kneaddata_paired	Firmicutes_I	18140	P	404	0	404	0.00001
ERR3199593_1_kneaddata_paired	Firmicutes_C	17613	P	103	0	103	0.00000
ERR3199593_1_kneaddata_paired	Thermotogota	33086	P	16	0	16	0.00000
ERR3199594_1_kneaddata_paired	Bacteroidota	4587	P	22202597	98938	22301535	0.77965
ERR3199594_1_kneaddata_paired	Firmicutes_A	14608	P	2855763	28559	2884322	0.10083
ERR3199594_1_kneaddata_paired	Firmicutes	12188	P	1881904	23582	1905486	0.06661
ERR3199594_1_kneaddata_paired	Actinobacteriota	615	P	984336	1880	986216	0.03448
ERR3199594_1_kneaddata_paired	Proteobacteria	22518	P	170205	340	170545	0.00596
ERR3199594_1_kneaddata_paired	Campylobacterota	8700	P	115526	70	115596	0.00404
ERR3199594_1_kneaddata_paired	Cyanobacteria	9876	P	83069	7814	90883	0.00318
ERR3199594_1_kneaddata_paired	Desulfobacterota_A	11509	P	76539	1035	77574	0.00271
ERR3199594_1_kneaddata_paired	Spirochaetota	32587	P	46172	34	46206	0.00162
ERR3199594_1_kneaddata_paired	Elusimicrobiota	11888	P	15968	0	15968	0.00056
ERR3199594_1_kneaddata_paired	Deferribacterota	10822	P	4451	22	4473	0.00016
ERR3199594_1_kneaddata_paired	Verrucomicrobiota	33333	P	4289	74	4363	0.00015
ERR3199594_1_kneaddata_paired	Firmicutes_I	18140	P	1080	0	1080	0.00004
ERR3199594_1_kneaddata_paired	Firmicutes_B	17289	P	282	13	295	0.00001
ERR3199594_1_kneaddata_paired	Firmicutes_C	17613	P	40	0	40	0.00000
ERR3199594_1_kneaddata_paired	Thermotogota	33086	P	3	0	3	0.00000
ERR3199595_1_kneaddata_paired	Bacteroidota	4587	P	14363596	50475	14414071	0.50610
ERR3199595_1_kneaddata_paired	Firmicutes_A	14608	P	5937524	52520	5990044	0.21032
ERR3199595_1_kneaddata_paired	Verrucomicrobiota	33333	P	3802393	21558	3823951	0.13427
ERR3199595_1_kneaddata_paired	Elusimicrobiota	11888	P	1302150	0	1302150	0.04572
ERR3199595_1_kneaddata_paired	Proteobacteria	22518	P	1034878	10359	1045237	0.03670
ERR3199595_1_kneaddata_paired	Cyanobacteria	9876	P	700014	30762	730776	0.02566
ERR3199595_1_kneaddata_paired	Actinobacteriota	615	P	348721	388	349109	0.01226
ERR3199595_1_kneaddata_paired	Firmicutes	12188	P	252501	2074	254575	0.00894
ERR3199595_1_kneaddata_paired	Spirochaetota	32587	P	247081	85	247166	0.00868
ERR3199595_1_kneaddata_paired	Desulfobacterota_A	11509	P	167341	1225	168566	0.00592
ERR3199595_1_kneaddata_paired	Deferribacterota	10822	P	83255	202	83457	0.00293
ERR3199595_1_kneaddata_paired	Campylobacterota	8700	P	69615	4	69619	0.00244
ERR3199595_1_kneaddata_paired	Firmicutes_B	17289	P	959	22	981	0.00003
ERR3199595_1_kneaddata_paired	Firmicutes_I	18140	P	449	0	449	0.00002
ERR3199595_1_kneaddata_paired	Firmicutes_C	17613	P	300	0	300	0.00001
ERR3199595_1_kneaddata_paired	Thermotogota	33086	P	31	0	31	0.00000
ERR3199596_1_kneaddata_paired	Bacteroidota	4587	P	20592821	82555	20675376	0.72669
ERR3199596_1_kneaddata_paired	Firmicutes_A	14608	P	3781628	33984	3815612	0.13411
ERR3199596_1_kneaddata_paired	Verrucomicrobiota	33333	P	1418712	15271	1433983	0.05040
ERR3199596_1_kneaddata_paired	Firmicutes	12188	P	901379	14918	916297	0.03221
ERR3199596_1_kneaddata_paired	Proteobacteria	22518	P	403642	9693	413335	0.01453
ERR3199596_1_kneaddata_paired	Actinobacteriota	615	P	367044	754	367798	0.01293
ERR3199596_1_kneaddata_paired	Cyanobacteria	9876	P	233287	18300	251587	0.00884
ERR3199596_1_kneaddata_paired	Campylobacterota	8700	P	190612	28	190640	0.00670
ERR3199596_1_kneaddata_paired	Desulfobacterota_A	11509	P	171365	1794	173159	0.00609
ERR3199596_1_kneaddata_paired	Elusimicrobiota	11888	P	142445	0	142445	0.00501
ERR3199596_1_kneaddata_paired	Deferribacterota	10822	P	43775	198	43973	0.00155
ERR3199596_1_kneaddata_paired	Spirochaetota	32587	P	26640	17	26657	0.00094
ERR3199596_1_kneaddata_paired	Firmicutes_B	17289	P	364	15	379	0.00001
ERR3199596_1_kneaddata_paired	Firmicutes_I	18140	P	196	0	196	0.00001
ERR3199596_1_kneaddata_paired	Firmicutes_C	17613	P	84	0	84	0.00000
ERR3199596_1_kneaddata_paired	Thermotogota	33086	P	17	0	17	0.00000
ERR3199597_1_kneaddata_paired	Firmicutes_A	14608	P	14400029	50137	14450166	0.45057
ERR3199597_1_kneaddata_paired	Bacteroidota	4587	P	11879237	45566	11924803	0.37183
ERR3199597_1_kneaddata_paired	Desulfobacterota_A	11509	P	1200204	13008	1213212	0.03783
ERR3199597_1_kneaddata_paired	Firmicutes	12188	P	1146891	13070	1159961	0.03617
ERR3199597_1_kneaddata_paired	Verrucomicrobiota	33333	P	937447	8439	945886	0.02949
ERR3199597_1_kneaddata_paired	Spirochaetota	32587	P	694080	371	694451	0.02165
ERR3199597_1_kneaddata_paired	Campylobacterota	8700	P	632687	20	632707	0.01973
ERR3199597_1_kneaddata_paired	Proteobacteria	22518	P	340162	701	340863	0.01063
ERR3199597_1_kneaddata_paired	Deferribacterota	10822	P	322970	1228	324198	0.01011
ERR3199597_1_kneaddata_paired	Actinobacteriota	615	P	253088	508	253596	0.00791
ERR3199597_1_kneaddata_paired	Cyanobacteria	9876	P	80897	4945	85842	0.00268
ERR3199597_1_kneaddata_paired	Elusimicrobiota	11888	P	42764	0	42764	0.00133
ERR3199597_1_kneaddata_paired	Firmicutes_B	17289	P	1229	44	1273	0.00004
ERR3199597_1_kneaddata_paired	Firmicutes_I	18140	P	674	0	674	0.00002
ERR3199597_1_kneaddata_paired	Firmicutes_C	17613	P	233	0	233	0.00001
ERR3199597_1_kneaddata_paired	Thermotogota	33086	P	24	0	24	0.00000
ERR3199598_1_kneaddata_paired	Firmicutes_A	14608	P	13844703	57959	13902662	0.45618
ERR3199598_1_kneaddata_paired	Bacteroidota	4587	P	11739695	56116	11795811	0.38705
ERR3199598_1_kneaddata_paired	Spirochaetota	32587	P	3042641	1828	3044469	0.09990
ERR3199598_1_kneaddata_paired	Desulfobacterota_A	11509	P	451596	4904	456500	0.01498
ERR3199598_1_kneaddata_paired	Deferribacterota	10822	P	396595	1699	398294	0.01307
ERR3199598_1_kneaddata_paired	Firmicutes	12188	P	330325	4495	334820	0.01099
ERR3199598_1_kneaddata_paired	Campylobacterota	8700	P	217008	14	217022	0.00712
ERR3199598_1_kneaddata_paired	Verrucomicrobiota	33333	P	134518	1385	135903	0.00446
ERR3199598_1_kneaddata_paired	Actinobacteriota	615	P	95058	274	95332	0.00313
ERR3199598_1_kneaddata_paired	Proteobacteria	22518	P	59872	159	60031	0.00197
ERR3199598_1_kneaddata_paired	Cyanobacteria	9876	P	21306	1029	22335	0.00073
ERR3199598_1_kneaddata_paired	Elusimicrobiota	11888	P	11256	0	11256	0.00037
ERR3199598_1_kneaddata_paired	Firmicutes_B	17289	P	1057	43	1100	0.00004
ERR3199598_1_kneaddata_paired	Firmicutes_I	18140	P	301	0	301	0.00001
ERR3199598_1_kneaddata_paired	Firmicutes_C	17613	P	151	0	151	0.00000
ERR3199598_1_kneaddata_paired	Thermotogota	33086	P	16	0	16	0.00000
ERR3199599_1_kneaddata_paired	Firmicutes_A	14608	P	12987964	48945	13036909	0.46511
ERR3199599_1_kneaddata_paired	Bacteroidota	4587	P	11408543	49676	11458219	0.40879
ERR3199599_1_kneaddata_paired	Campylobacterota	8700	P	1194580	130	1194710	0.04262
ERR3199599_1_kneaddata_paired	Firmicutes	12188	P	1112074	11270	1123344	0.04008
ERR3199599_1_kneaddata_paired	Desulfobacterota_A	11509	P	405344	4082	409426	0.01461
ERR3199599_1_kneaddata_paired	Actinobacteriota	615	P	305585	485	306070	0.01092
ERR3199599_1_kneaddata_paired	Spirochaetota	32587	P	296720	159	296879	0.01059
ERR3199599_1_kneaddata_paired	Proteobacteria	22518	P	90862	164	91026	0.00325
ERR3199599_1_kneaddata_paired	Cyanobacteria	9876	P	89589	6398	95987	0.00342
ERR3199599_1_kneaddata_paired	Deferribacterota	10822	P	8226	29	8255	0.00029
ERR3199599_1_kneaddata_paired	Elusimicrobiota	11888	P	5646	0	5646	0.00020
ERR3199599_1_kneaddata_paired	Verrucomicrobiota	33333	P	1626	38	1664	0.00006
ERR3199599_1_kneaddata_paired	Firmicutes_B	17289	P	927	33	960	0.00003
ERR3199599_1_kneaddata_paired	Firmicutes_I	18140	P	655	0	655	0.00002
ERR3199599_1_kneaddata_paired	Firmicutes_C	17613	P	131	0	131	0.00000
ERR3199599_1_kneaddata_paired	Thermotogota	33086	P	18	0	18	0.00000
ERR3199600_1_kneaddata_paired	Bacteroidota	4587	P	18459550	106322	18565872	0.72746
ERR3199600_1_kneaddata_paired	Firmicutes_A	14608	P	4005715	51479	4057194	0.15897
ERR3199600_1_kneaddata_paired	Verrucomicrobiota	33333	P	1255023	11242	1266265	0.04962
ERR3199600_1_kneaddata_paired	Proteobacteria	22518	P	610746	1177	611923	0.02398
ERR3199600_1_kneaddata_paired	Spirochaetota	32587	P	351499	188	351687	0.01378
ERR3199600_1_kneaddata_paired	Firmicutes	12188	P	228425	2280	230705	0.00904
ERR3199600_1_kneaddata_paired	Cyanobacteria	9876	P	132675	6196	138871	0.00544
ERR3199600_1_kneaddata_paired	Actinobacteriota	615	P	86015	525	86540	0.00339
ERR3199600_1_kneaddata_paired	Campylobacterota	8700	P	65574	1	65575	0.00257
ERR3199600_1_kneaddata_paired	Deferribacterota	10822	P	63327	241	63568	0.00249
ERR3199600_1_kneaddata_paired	Desulfobacterota_A	11509	P	62197	722	62919	0.00247
ERR3199600_1_kneaddata_paired	Elusimicrobiota	11888	P	19209	0	19209	0.00075
ERR3199600_1_kneaddata_paired	Firmicutes_B	17289	P	947	34	981	0.00004
ERR3199600_1_kneaddata_paired	Firmicutes_I	18140	P	187	0	187	0.00001
ERR3199600_1_kneaddata_paired	Firmicutes_C	17613	P	54	0	54	0.00000
ERR3199600_1_kneaddata_paired	Thermotogota	33086	P	8	0	8	0.00000
ERR3199601_1_kneaddata_paired	Firmicutes_A	14608	P	12459914	35546	12495460	0.56731
ERR3199601_1_kneaddata_paired	Bacteroidota	4587	P	6532390	28442	6560832	0.29787
ERR3199601_1_kneaddata_paired	Spirochaetota	32587	P	1827741	783	1828524	0.08302
ERR3199601_1_kneaddata_paired	Deferribacterota	10822	P	392755	1200	393955	0.01789
ERR3199601_1_kneaddata_paired	Desulfobacterota_A	11509	P	260068	2373	262441	0.01192
ERR3199601_1_kneaddata_paired	Campylobacterota	8700	P	234822	4	234826	0.01066
ERR3199601_1_kneaddata_paired	Firmicutes	12188	P	156311	1610	157921	0.00717
ERR3199601_1_kneaddata_paired	Actinobacteriota	615	P	40790	76	40866	0.00186
ERR3199601_1_kneaddata_paired	Proteobacteria	22518	P	20526	31	20557	0.00093
ERR3199601_1_kneaddata_paired	Verrucomicrobiota	33333	P	16531	126	16657	0.00076
ERR3199601_1_kneaddata_paired	Cyanobacteria	9876	P	11689	400	12089	0.00055
ERR3199601_1_kneaddata_paired	Firmicutes_B	17289	P	980	28	1008	0.00005
ERR3199601_1_kneaddata_paired	Elusimicrobiota	11888	P	475	0	475	0.00002
ERR3199601_1_kneaddata_paired	Firmicutes_I	18140	P	169	0	169	0.00001
ERR3199601_1_kneaddata_paired	Firmicutes_C	17613	P	145	0	145	0.00001
ERR3199601_1_kneaddata_paired	Thermotogota	33086	P	11	0	11	0.00000
ERR3199602_1_kneaddata_paired	Bacteroidota	4587	P	18933169	64919	18998088	0.69879
ERR3199602_1_kneaddata_paired	Firmicutes_A	14608	P	3680240	28642	3708882	0.13642
ERR3199602_1_kneaddata_paired	Firmicutes	12188	P	1546313	27230	1573543	0.05788
ERR3199602_1_kneaddata_paired	Verrucomicrobiota	33333	P	962806	12004	974810	0.03586
ERR3199602_1_kneaddata_paired	Actinobacteriota	615	P	503406	816	504222	0.01855
ERR3199602_1_kneaddata_paired	Proteobacteria	22518	P	398481	6069	404550	0.01488
ERR3199602_1_kneaddata_paired	Spirochaetota	32587	P	360413	268	360681	0.01327
ERR3199602_1_kneaddata_paired	Desulfobacterota_A	11509	P	327326	6381	333707	0.01227
ERR3199602_1_kneaddata_paired	Campylobacterota	8700	P	122700	29	122729	0.00451
ERR3199602_1_kneaddata_paired	Elusimicrobiota	11888	P	99204	0	99204	0.00365
ERR3199602_1_kneaddata_paired	Cyanobacteria	9876	P	90515	7921	98436	0.00362
ERR3199602_1_kneaddata_paired	Deferribacterota	10822	P	7141	36	7177	0.00026
ERR3199602_1_kneaddata_paired	Firmicutes_B	17289	P	494	24	518	0.00002
ERR3199602_1_kneaddata_paired	Firmicutes_I	18140	P	436	0	436	0.00002
ERR3199602_1_kneaddata_paired	Firmicutes_C	17613	P	149	0	149	0.00001
ERR3199602_1_kneaddata_paired	Thermotogota	33086	P	16	0	16	0.00000
ERR3199603_1_kneaddata_paired	Bacteroidota	4587	P	23449744	99549	23549293	0.78910
ERR3199603_1_kneaddata_paired	Firmicutes_A	14608	P	2572171	42428	2614599	0.08761
ERR3199603_1_kneaddata_paired	Verrucomicrobiota	33333	P	1538738	18121	1556859	0.05217
ERR3199603_1_kneaddata_paired	Firmicutes	12188	P	961309	40133	1001442	0.03356
ERR3199603_1_kneaddata_paired	Actinobacteriota	615	P	471274	1164	472438	0.01583
ERR3199603_1_kneaddata_paired	Proteobacteria	22518	P	255335	1527	256862	0.00861
ERR3199603_1_kneaddata_paired	Spirochaetota	32587	P	147637	103	147740	0.00495
ERR3199603_1_kneaddata_paired	Desulfobacterota_A	11509	P	137732	1665	139397	0.00467
ERR3199603_1_kneaddata_paired	Cyanobacteria	9876	P	56845	4905	61750	0.00207
ERR3199603_1_kneaddata_paired	Campylobacterota	8700	P	27672	3	27675	0.00093
ERR3199603_1_kneaddata_paired	Deferribacterota	10822	P	10222	50	10272	0.00034
ERR3199603_1_kneaddata_paired	Elusimicrobiota	11888	P	4299	0	4299	0.00014
ERR3199603_1_kneaddata_paired	Firmicutes_I	18140	P	290	0	290	0.00001
ERR3199603_1_kneaddata_paired	Firmicutes_B	17289	P	148	7	155	0.00001
ERR3199603_1_kneaddata_paired	Firmicutes_C	17613	P	35	0	35	0.00000
ERR3199603_1_kneaddata_paired	Thermotogota	33086	P	3	0	3	0.00000
ERR3199604_1_kneaddata_paired	Bacteroidota	4587	P	16823279	53871	16877150	0.54227
ERR3199604_1_kneaddata_paired	Firmicutes_A	14608	P	8339048	48046	8387094	0.26948
ERR3199604_1_kneaddata_paired	Verrucomicrobiota	33333	P	2046193	15024	2061217	0.06623
ERR3199604_1_kneaddata_paired	Firmicutes	12188	P	1810085	53261	1863346	0.05987
ERR3199604_1_kneaddata_paired	Actinobacteriota	615	P	378814	538	379352	0.01219
ERR3199604_1_kneaddata_paired	Desulfobacterota_A	11509	P	365417	3288	368705	0.01185
ERR3199604_1_kneaddata_paired	Campylobacterota	8700	P	357132	24	357156	0.01148
ERR3199604_1_kneaddata_paired	Cyanobacteria	9876	P	346698	20578	367276	0.01180
ERR3199604_1_kneaddata_paired	Proteobacteria	22518	P	233863	654	234517	0.00754
ERR3199604_1_kneaddata_paired	Elusimicrobiota	11888	P	114500	0	114500	0.00368
ERR3199604_1_kneaddata_paired	Spirochaetota	32587	P	87542	39	87581	0.00281
ERR3199604_1_kneaddata_paired	Deferribacterota	10822	P	23304	72	23376	0.00075
ERR3199604_1_kneaddata_paired	Firmicutes_B	17289	P	904	27	931	0.00003
ERR3199604_1_kneaddata_paired	Firmicutes_I	18140	P	668	0	668	0.00002
ERR3199604_1_kneaddata_paired	Firmicutes_C	17613	P	178	0	178	0.00001
ERR3199604_1_kneaddata_paired	Thermotogota	33086	P	20	0	20	0.00000
ERR3199605_1_kneaddata_paired	Bacteroidota	4587	P	15130000	62474	15192474	0.55535
ERR3199605_1_kneaddata_paired	Firmicutes_A	14608	P	6816238	44333	6860571	0.25078
ERR3199605_1_kneaddata_paired	Verrucomicrobiota	33333	P	1309882	14211	1324093	0.04840
ERR3199605_1_kneaddata_paired	Proteobacteria	22518	P	974170	14403	988573	0.03614
ERR3199605_1_kneaddata_paired	Firmicutes	12188	P	805759	8741	814500	0.02977
ERR3199605_1_kneaddata_paired	Spirochaetota	32587	P	662162	434	662596	0.02422
ERR3199605_1_kneaddata_paired	Actinobacteriota	615	P	480981	836	481817	0.01761
ERR3199605_1_kneaddata_paired	Elusimicrobiota	11888	P	343669	0	343669	0.01256
ERR3199605_1_kneaddata_paired	Cyanobacteria	9876	P	273921	23355	297276	0.01087
ERR3199605_1_kneaddata_paired	Desulfobacterota_A	11509	P	237703	2769	240472	0.00879
ERR3199605_1_kneaddata_paired	Campylobacterota	8700	P	126965	37	127002	0.00464
ERR3199605_1_kneaddata_paired	Deferribacterota	10822	P	21913	100	22013	0.00080
ERR3199605_1_kneaddata_paired	Firmicutes_B	17289	P	831	36	867	0.00003
ERR3199605_1_kneaddata_paired	Firmicutes_I	18140	P	562	0	562	0.00002
ERR3199605_1_kneaddata_paired	Firmicutes_C	17613	P	220	0	220	0.00001
ERR3199605_1_kneaddata_paired	Thermotogota	33086	P	77	0	77	0.00000
ERR3199606_1_kneaddata_paired	Bacteroidota	4587	P	15247052	57113	15304165	0.51955
ERR3199606_1_kneaddata_paired	Firmicutes_A	14608	P	9805067	45387	9850454	0.33441
ERR3199606_1_kneaddata_paired	Desulfobacterota_A	11509	P	1066180	13716	1079896	0.03666
ERR3199606_1_kneaddata_paired	Firmicutes	12188	P	886449	8269	894718	0.03037
ERR3199606_1_kneaddata_paired	Campylobacterota	8700	P	702573	74	702647	0.02385
ERR3199606_1_kneaddata_paired	Verrucomicrobiota	33333	P	445755	5076	450831	0.01530
ERR3199606_1_kneaddata_paired	Proteobacteria	22518	P	339155	6852	346007	0.01175
ERR3199606_1_kneaddata_paired	Actinobacteriota	615	P	318140	524	318664	0.01082
ERR3199606_1_kneaddata_paired	Spirochaetota	32587	P	259730	166	259896	0.00882
ERR3199606_1_kneaddata_paired	Cyanobacteria	9876	P	193748	6607	200355	0.00680
ERR3199606_1_kneaddata_paired	Elusimicrobiota	11888	P	24269	0	24269	0.00082
ERR3199606_1_kneaddata_paired	Deferribacterota	10822	P	22937	103	23040	0.00078
ERR3199606_1_kneaddata_paired	Firmicutes_B	17289	P	1020	44	1064	0.00004
ERR3199606_1_kneaddata_paired	Firmicutes_I	18140	P	392	0	392	0.00001
ERR3199606_1_kneaddata_paired	Firmicutes_C	17613	P	155	0	155	0.00001
ERR3199606_1_kneaddata_paired	Thermotogota	33086	P	21	0	21	0.00000
ERR3199607_1_kneaddata_paired	Bacteroidota	4587	P	20888399	74574	20962973	0.69623
ERR3199607_1_kneaddata_paired	Firmicutes_A	14608	P	6087667	76713	6164380	0.20473
ERR3199607_1_kneaddata_paired	Firmicutes	12188	P	941740	22702	964442	0.03203
ERR3199607_1_kneaddata_paired	Verrucomicrobiota	33333	P	627934	7020	634954	0.02109
ERR3199607_1_kneaddata_paired	Actinobacteriota	615	P	554104	948	555052	0.01843
ERR3199607_1_kneaddata_paired	Desulfobacterota_A	11509	P	252468	3086	255554	0.00849
ERR3199607_1_kneaddata_paired	Proteobacteria	22518	P	187359	1516	188875	0.00627
ERR3199607_1_kneaddata_paired	Spirochaetota	32587	P	148198	98	148296	0.00493
ERR3199607_1_kneaddata_paired	Campylobacterota	8700	P	74883	1	74884	0.00249
ERR3199607_1_kneaddata_paired	Cyanobacteria	9876	P	56556	4905	61461	0.00204
ERR3199607_1_kneaddata_paired	Elusimicrobiota	11888	P	48483	0	48483	0.00161
ERR3199607_1_kneaddata_paired	Deferribacterota	10822	P	47943	225	48168	0.00160
ERR3199607_1_kneaddata_paired	Firmicutes_B	17289	P	1438	64	1502	0.00005
ERR3199607_1_kneaddata_paired	Firmicutes_I	18140	P	208	0	208	0.00001
ERR3199607_1_kneaddata_paired	Firmicutes_C	17613	P	99	0	99	0.00000
ERR3199607_1_kneaddata_paired	Thermotogota	33086	P	7	0	7	0.00000
ERR3199608_1_kneaddata_paired	Bacteroidota	4587	P	17067151	81935	17149086	0.61893
ERR3199608_1_kneaddata_paired	Firmicutes_A	14608	P	6248067	39501	6287568	0.22693
ERR3199608_1_kneaddata_paired	Firmicutes	12188	P	1329685	14713	1344398	0.04852
ERR3199608_1_kneaddata_paired	Verrucomicrobiota	33333	P	1078070	13145	1091215	0.03938
ERR3199608_1_kneaddata_paired	Actinobacteriota	615	P	460297	771	461068	0.01664
ERR3199608_1_kneaddata_paired	Elusimicrobiota	11888	P	326876	0	326876	0.01180
ERR3199608_1_kneaddata_paired	Proteobacteria	22518	P	296419	1283	297702	0.01074
ERR3199608_1_kneaddata_paired	Desulfobacterota_A	11509	P	218547	3007	221554	0.00800
ERR3199608_1_kneaddata_paired	Campylobacterota	8700	P	214873	47	214920	0.00776
ERR3199608_1_kneaddata_paired	Cyanobacteria	9876	P	209315	20398	229713	0.00829
ERR3199608_1_kneaddata_paired	Deferribacterota	10822	P	72026	373	72399	0.00261
ERR3199608_1_kneaddata_paired	Spirochaetota	32587	P	9400	7	9407	0.00034
ERR3199608_1_kneaddata_paired	Firmicutes_B	17289	P	781	38	819	0.00003
ERR3199608_1_kneaddata_paired	Firmicutes_I	18140	P	760	0	760	0.00003
ERR3199608_1_kneaddata_paired	Firmicutes_C	17613	P	130	0	130	0.00000
ERR3199608_1_kneaddata_paired	Thermotogota	33086	P	33	0	33	0.00000
ERR3199609_1_kneaddata_paired	Firmicutes_A	14608	P	12417372	42624	12459996	0.50347
ERR3199609_1_kneaddata_paired	Bacteroidota	4587	P	4766431	24677	4791108	0.19359
ERR3199609_1_kneaddata_paired	Spirochaetota	32587	P	3248327	1202	3249529	0.13130
ERR3199609_1_kneaddata_paired	Verrucomicrobiota	33333	P	1380320	8418	1388738	0.05611
ERR3199609_1_kneaddata_paired	Campylobacterota	8700	P	859726	33	859759	0.03474
ERR3199609_1_kneaddata_paired	Desulfobacterota_A	11509	P	521677	3172	524849	0.02121
ERR3199609_1_kneaddata_paired	Firmicutes	12188	P	456622	2565	459187	0.01855
ERR3199609_1_kneaddata_paired	Elusimicrobiota	11888	P	451427	0	451427	0.01824
ERR3199609_1_kneaddata_paired	Deferribacterota	10822	P	245866	645	246511	0.00996
ERR3199609_1_kneaddata_paired	Proteobacteria	22518	P	149417	2009	151426	0.00612
ERR3199609_1_kneaddata_paired	Actinobacteriota	615	P	91460	188	91648	0.00370
ERR3199609_1_kneaddata_paired	Cyanobacteria	9876	P	67128	2313	69441	0.00281
ERR3199609_1_kneaddata_paired	Firmicutes_B	17289	P	3942	98	4040	0.00016
ERR3199609_1_kneaddata_paired	Firmicutes_I	18140	P	432	0	432	0.00002
ERR3199609_1_kneaddata_paired	Firmicutes_C	17613	P	236	0	236	0.00001
ERR3199609_1_kneaddata_paired	Thermotogota	33086	P	29	0	29	0.00000
ERR3199610_1_kneaddata_paired	Bacteroidota	4587	P	18282391	73598	18355989	0.63537
ERR3199610_1_kneaddata_paired	Firmicutes_A	14608	P	6714494	52532	6767026	0.23423
ERR3199610_1_kneaddata_paired	Firmicutes	12188	P	1560398	29273	1589671	0.05502
ERR3199610_1_kneaddata_paired	Verrucomicrobiota	33333	P	641179	6221	647400	0.02241
ERR3199610_1_kneaddata_paired	Actinobacteriota	615	P	567992	924	568916	0.01969
ERR3199610_1_kneaddata_paired	Spirochaetota	32587	P	411373	240	411613	0.01425
ERR3199610_1_kneaddata_paired	Campylobacterota	8700	P	199761	37	199798	0.00692
ERR3199610_1_kneaddata_paired	Proteobacteria	22518	P	137897	276	138173	0.00478
ERR3199610_1_kneaddata_paired	Desulfobacterota_A	11509	P	81430	1068	82498	0.00286
ERR3199610_1_kneaddata_paired	Cyanobacteria	9876	P	70954	4897	75851	0.00263
ERR3199610_1_kneaddata_paired	Elusimicrobiota	11888	P	30698	0	30698	0.00106
ERR3199610_1_kneaddata_paired	Deferribacterota	10822	P	20442	82	20524	0.00071
ERR3199610_1_kneaddata_paired	Firmicutes_B	17289	P	1366	53	1419	0.00005
ERR3199610_1_kneaddata_paired	Firmicutes_I	18140	P	569	0	569	0.00002
ERR3199610_1_kneaddata_paired	Firmicutes_C	17613	P	131	0	131	0.00000
ERR3199610_1_kneaddata_paired	Thermotogota	33086	P	31	0	31	0.00000
ERR3199611_1_kneaddata_paired	Bacteroidota	4587	P	15897798	77462	15975260	0.58046
ERR3199611_1_kneaddata_paired	Firmicutes_A	14608	P	8526221	60852	8587073	0.31201
ERR3199611_1_kneaddata_paired	Firmicutes	12188	P	993619	8547	1002166	0.03641
ERR3199611_1_kneaddata_paired	Spirochaetota	32587	P	961819	575	962394	0.03497
ERR3199611_1_kneaddata_paired	Campylobacterota	8700	P	426652	65	426717	0.01550
ERR3199611_1_kneaddata_paired	Desulfobacterota_A	11509	P	209299	3531	212830	0.00773
ERR3199611_1_kneaddata_paired	Deferribacterota	10822	P	171214	729	171943	0.00625
ERR3199611_1_kneaddata_paired	Actinobacteriota	615	P	95791	300	96091	0.00349
ERR3199611_1_kneaddata_paired	Proteobacteria	22518	P	33178	114	33292	0.00121
ERR3199611_1_kneaddata_paired	Verrucomicrobiota	33333	P	32959	346	33305	0.00121
ERR3199611_1_kneaddata_paired	Cyanobacteria	9876	P	15659	790	16449	0.00060
ERR3199611_1_kneaddata_paired	Firmicutes_B	17289	P	2707	110	2817	0.00010
ERR3199611_1_kneaddata_paired	Elusimicrobiota	11888	P	797	0	797	0.00003
ERR3199611_1_kneaddata_paired	Firmicutes_I	18140	P	290	0	290	0.00001
ERR3199611_1_kneaddata_paired	Firmicutes_C	17613	P	142	0	142	0.00001
ERR3199611_1_kneaddata_paired	Thermotogota	33086	P	38	0	38	0.00000
ERR3199612_1_kneaddata_paired	Bacteroidota	4587	P	24121809	122062	24243871	0.78275
ERR3199612_1_kneaddata_paired	Firmicutes_A	14608	P	3701126	39897	3741023	0.12078
ERR3199612_1_kneaddata_paired	Firmicutes	12188	P	1091113	28434	1119547	0.03615
ERR3199612_1_kneaddata_paired	Verrucomicrobiota	33333	P	600280	6716	606996	0.01960
ERR3199612_1_kneaddata_paired	Proteobacteria	22518	P	367183	1550	368733	0.01191
ERR3199612_1_kneaddata_paired	Actinobacteriota	615	P	327979	811	328790	0.01062
ERR3199612_1_kneaddata_paired	Spirochaetota	32587	P	138299	92	138391	0.00447
ERR3199612_1_kneaddata_paired	Elusimicrobiota	11888	P	121840	0	121840	0.00393
ERR3199612_1_kneaddata_paired	Desulfobacterota_A	11509	P	109141	1158	110299	0.00356
ERR3199612_1_kneaddata_paired	Campylobacterota	8700	P	92079	7	92086	0.00297
ERR3199612_1_kneaddata_paired	Cyanobacteria	9876	P	77700	6772	84472	0.00273
ERR3199612_1_kneaddata_paired	Deferribacterota	10822	P	15508	73	15581	0.00050
ERR3199612_1_kneaddata_paired	Firmicutes_I	18140	P	462	0	462	0.00001
ERR3199612_1_kneaddata_paired	Firmicutes_B	17289	P	438	19	457	0.00001
ERR3199612_1_kneaddata_paired	Firmicutes_C	17613	P	47	0	47	0.00000
ERR3199612_1_kneaddata_paired	Thermotogota	33086	P	10	0	10	0.00000
ERR3199613_1_kneaddata_paired	Bacteroidota	4587	P	20727238	119802	20847040	0.75152
ERR3199613_1_kneaddata_paired	Firmicutes_A	14608	P	3971966	33978	4005944	0.14441
ERR3199613_1_kneaddata_paired	Firmicutes	12188	P	1386349	20128	1406477	0.05070
ERR3199613_1_kneaddata_paired	Actinobacteriota	615	P	800976	1636	802612	0.02893
ERR3199613_1_kneaddata_paired	Proteobacteria	22518	P	176444	661	177105	0.00638
ERR3199613_1_kneaddata_paired	Campylobacterota	8700	P	145153	101	145254	0.00524
ERR3199613_1_kneaddata_paired	Desulfobacterota_A	11509	P	102028	1916	103944	0.00375
ERR3199613_1_kneaddata_paired	Elusimicrobiota	11888	P	99390	0	99390	0.00358
ERR3199613_1_kneaddata_paired	Verrucomicrobiota	33333	P	92342	1325	93667	0.00338
ERR3199613_1_kneaddata_paired	Cyanobacteria	9876	P	29593	2459	32052	0.00116
ERR3199613_1_kneaddata_paired	Deferribacterota	10822	P	14663	86	14749	0.00053
ERR3199613_1_kneaddata_paired	Spirochaetota	32587	P	10182	9	10191	0.00037
ERR3199613_1_kneaddata_paired	Firmicutes_I	18140	P	750	0	750	0.00003
ERR3199613_1_kneaddata_paired	Firmicutes_B	17289	P	467	26	493	0.00002
ERR3199613_1_kneaddata_paired	Firmicutes_C	17613	P	99	0	99	0.00000
ERR3199613_1_kneaddata_paired	Thermotogota	33086	P	11	0	11	0.00000
ERR3199614_1_kneaddata_paired	Bacteroidota	4587	P	19600087	77436	19677523	0.65904
ERR3199614_1_kneaddata_paired	Firmicutes_A	14608	P	4456869	25305	4482174	0.15012
ERR3199614_1_kneaddata_paired	Verrucomicrobiota	33333	P	2112446	23001	2135447	0.07152
ERR3199614_1_kneaddata_paired	Firmicutes	12188	P	1603639	21787	1625426	0.05444
ERR3199614_1_kneaddata_paired	Proteobacteria	22518	P	524089	2898	526987	0.01765
ERR3199614_1_kneaddata_paired	Actinobacteriota	615	P	501510	1071	502581	0.01683
ERR3199614_1_kneaddata_paired	Cyanobacteria	9876	P	224036	19002	243038	0.00814
ERR3199614_1_kneaddata_paired	Campylobacterota	8700	P	205898	33	205931	0.00690
ERR3199614_1_kneaddata_paired	Spirochaetota	32587	P	150976	99	151075	0.00506
ERR3199614_1_kneaddata_paired	Elusimicrobiota	11888	P	150398	0	150398	0.00504
ERR3199614_1_kneaddata_paired	Desulfobacterota_A	11509	P	122550	1573	124123	0.00416
ERR3199614_1_kneaddata_paired	Deferribacterota	10822	P	30816	141	30957	0.00104
ERR3199614_1_kneaddata_paired	Firmicutes_I	18140	P	1276	0	1276	0.00004
ERR3199614_1_kneaddata_paired	Firmicutes_B	17289	P	490	21	511	0.00002
ERR3199614_1_kneaddata_paired	Firmicutes_C	17613	P	156	0	156	0.00001
ERR3199614_1_kneaddata_paired	Thermotogota	33086	P	28	0	28	0.00000
ERR3199615_1_kneaddata_paired	Bacteroidota	4587	P	19673476	92983	19766459	0.68960
ERR3199615_1_kneaddata_paired	Firmicutes_A	14608	P	4332734	30718	4363452	0.15223
ERR3199615_1_kneaddata_paired	Verrucomicrobiota	33333	P	2199299	26531	2225830	0.07765
ERR3199615_1_kneaddata_paired	Firmicutes	12188	P	665574	37638	703212	0.02453
ERR3199615_1_kneaddata_paired	Elusimicrobiota	11888	P	402673	0	402673	0.01405
ERR3199615_1_kneaddata_paired	Actinobacteriota	615	P	341849	878	342727	0.01196
ERR3199615_1_kneaddata_paired	Proteobacteria	22518	P	330267	1165	331432	0.01156
ERR3199615_1_kneaddata_paired	Desulfobacterota_A	11509	P	163679	1993	165672	0.00578
ERR3199615_1_kneaddata_paired	Spirochaetota	32587	P	162238	118	162356	0.00566
ERR3199615_1_kneaddata_paired	Campylobacterota	8700	P	93211	30	93241	0.00325
ERR3199615_1_kneaddata_paired	Cyanobacteria	9876	P	86987	7642	94629	0.00330
ERR3199615_1_kneaddata_paired	Deferribacterota	10822	P	10445	52	10497	0.00037
ERR3199615_1_kneaddata_paired	Firmicutes_B	17289	P	714	35	749	0.00003
ERR3199615_1_kneaddata_paired	Firmicutes_I	18140	P	582	0	582	0.00002
ERR3199615_1_kneaddata_paired	Firmicutes_C	17613	P	95	0	95	0.00000
ERR3199615_1_kneaddata_paired	Thermotogota	33086	P	18	0	18	0.00000
ERR3199616_1_kneaddata_paired	Bacteroidota	4587	P	21818948	111154	21930102	0.71299
ERR3199616_1_kneaddata_paired	Firmicutes_A	14608	P	4046957	40219	4087176	0.13288
ERR3199616_1_kneaddata_paired	Firmicutes	12188	P	2086204	27348	2113552	0.06872
ERR3199616_1_kneaddata_paired	Actinobacteriota	615	P	1250373	2420	1252793	0.04073
ERR3199616_1_kneaddata_paired	Verrucomicrobiota	33333	P	449103	6563	455666	0.01481
ERR3199616_1_kneaddata_paired	Spirochaetota	32587	P	353660	306	353966	0.01151
ERR3199616_1_kneaddata_paired	Proteobacteria	22518	P	159349	3239	162588	0.00529
ERR3199616_1_kneaddata_paired	Campylobacterota	8700	P	156955	81	157036	0.00511
ERR3199616_1_kneaddata_paired	Desulfobacterota_A	11509	P	103090	1962	105052	0.00342
ERR3199616_1_kneaddata_paired	Cyanobacteria	9876	P	89049	5477	94526	0.00307
ERR3199616_1_kneaddata_paired	Deferribacterota	10822	P	41554	255	41809	0.00136
ERR3199616_1_kneaddata_paired	Elusimicrobiota	11888	P	2714	0	2714	0.00009
ERR3199616_1_kneaddata_paired	Firmicutes_I	18140	P	414	0	414	0.00001
ERR3199616_1_kneaddata_paired	Firmicutes_B	17289	P	401	23	424	0.00001
ERR3199616_1_kneaddata_paired	Firmicutes_C	17613	P	49	0	49	0.00000
ERR3199616_1_kneaddata_paired	Thermotogota	33086	P	18	0	18	0.00000
ERR3199617_1_kneaddata_paired	Bacteroidota	4587	P	10712160	59900	10772060	0.44337
ERR3199617_1_kneaddata_paired	Firmicutes_A	14608	P	9940388	61520	10001908	0.41167
ERR3199617_1_kneaddata_paired	Spirochaetota	32587	P	571163	348	571511	0.02352
ERR3199617_1_kneaddata_paired	Verrucomicrobiota	33333	P	540776	5495	546271	0.02248
ERR3199617_1_kneaddata_paired	Firmicutes	12188	P	486780	6230	493010	0.02029
ERR3199617_1_kneaddata_paired	Campylobacterota	8700	P	484821	30	484851	0.01996
ERR3199617_1_kneaddata_paired	Desulfobacterota_A	11509	P	401074	4130	405204	0.01668
ERR3199617_1_kneaddata_paired	Elusimicrobiota	11888	P	364695	0	364695	0.01501
ERR3199617_1_kneaddata_paired	Deferribacterota	10822	P	309810	1340	311150	0.01281
ERR3199617_1_kneaddata_paired	Actinobacteriota	615	P	202906	649	203555	0.00838
ERR3199617_1_kneaddata_paired	Cyanobacteria	9876	P	90730	6702	97432	0.00401
ERR3199617_1_kneaddata_paired	Proteobacteria	22518	P	42036	202	42238	0.00174
ERR3199617_1_kneaddata_paired	Firmicutes_B	17289	P	1455	60	1515	0.00006
ERR3199617_1_kneaddata_paired	Firmicutes_I	18140	P	477	0	477	0.00002
ERR3199617_1_kneaddata_paired	Firmicutes_C	17613	P	180	0	180	0.00001
ERR3199617_1_kneaddata_paired	Thermotogota	33086	P	28	0	28	0.00000
ERR3199618_1_kneaddata_paired	Bacteroidota	4587	P	18854820	84098	18938918	0.70035
ERR3199618_1_kneaddata_paired	Firmicutes_A	14608	P	5483202	66860	5550062	0.20524
ERR3199618_1_kneaddata_paired	Firmicutes	12188	P	728513	10064	738577	0.02731
ERR3199618_1_kneaddata_paired	Verrucomicrobiota	33333	P	564425	5976	570401	0.02109
ERR3199618_1_kneaddata_paired	Actinobacteriota	615	P	379567	833	380400	0.01407
ERR3199618_1_kneaddata_paired	Campylobacterota	8700	P	198607	3	198610	0.00734
ERR3199618_1_kneaddata_paired	Spirochaetota	32587	P	160568	109	160677	0.00594
ERR3199618_1_kneaddata_paired	Proteobacteria	22518	P	140673	283	140956	0.00521
ERR3199618_1_kneaddata_paired	Desulfobacterota_A	11509	P	111669	1375	113044	0.00418
ERR3199618_1_kneaddata_paired	Deferribacterota	10822	P	96531	434	96965	0.00359
ERR3199618_1_kneaddata_paired	Cyanobacteria	9876	P	87320	7583	94903	0.00351
ERR3199618_1_kneaddata_paired	Elusimicrobiota	11888	P	57892	0	57892	0.00214
ERR3199618_1_kneaddata_paired	Firmicutes_B	17289	P	344	14	358	0.00001
ERR3199618_1_kneaddata_paired	Firmicutes_I	18140	P	187	0	187	0.00001
ERR3199618_1_kneaddata_paired	Firmicutes_C	17613	P	59	0	59	0.00000
ERR3199618_1_kneaddata_paired	Thermotogota	33086	P	10	0	10	0.00000
ERR3199619_1_kneaddata_paired	Bacteroidota	4587	P	19440191	81332	19521523	0.65548
ERR3199619_1_kneaddata_paired	Firmicutes_A	14608	P	5002723	33800	5036523	0.16911
ERR3199619_1_kneaddata_paired	Verrucomicrobiota	33333	P	1717664	17533	1735197	0.05826
ERR3199619_1_kneaddata_paired	Firmicutes	12188	P	1286906	17920	1304826	0.04381
ERR3199619_1_kneaddata_paired	Actinobacteriota	615	P	626555	887	627442	0.02107
ERR3199619_1_kneaddata_paired	Proteobacteria	22518	P	374678	6198	380876	0.01279
ERR3199619_1_kneaddata_paired	Cyanobacteria	9876	P	337521	27957	365478	0.01227
ERR3199619_1_kneaddata_paired	Elusimicrobiota	11888	P	307565	0	307565	0.01033
ERR3199619_1_kneaddata_paired	Campylobacterota	8700	P	183915	5	183920	0.00618
ERR3199619_1_kneaddata_paired	Desulfobacterota_A	11509	P	159048	1917	160965	0.00540
ERR3199619_1_kneaddata_paired	Spirochaetota	32587	P	114882	71	114953	0.00386
ERR3199619_1_kneaddata_paired	Deferribacterota	10822	P	40903	176	41079	0.00138
ERR3199619_1_kneaddata_paired	Firmicutes_I	18140	P	683	0	683	0.00002
ERR3199619_1_kneaddata_paired	Firmicutes_B	17289	P	639	26	665	0.00002
ERR3199619_1_kneaddata_paired	Firmicutes_C	17613	P	94	0	94	0.00000
ERR3199619_1_kneaddata_paired	Thermotogota	33086	P	18	0	18	0.00000
ERR3199620_1_kneaddata_paired	Bacteroidota	4587	P	12987038	58223	13045261	0.50496
ERR3199620_1_kneaddata_paired	Firmicutes_A	14608	P	10024101	35586	10059687	0.38940
ERR3199620_1_kneaddata_paired	Firmicutes	12188	P	1409951	11353	1421304	0.05502
ERR3199620_1_kneaddata_paired	Cyanobacteria	9876	P	425298	28194	453492	0.01755
ERR3199620_1_kneaddata_paired	Campylobacterota	8700	P	196481	4	196485	0.00761
ERR3199620_1_kneaddata_paired	Desulfobacterota_A	11509	P	173438	1470	174908	0.00677
ERR3199620_1_kneaddata_paired	Verrucomicrobiota	33333	P	128457	1034	129491	0.00501
ERR3199620_1_kneaddata_paired	Deferribacterota	10822	P	114466	388	114854	0.00445
ERR3199620_1_kneaddata_paired	Proteobacteria	22518	P	94838	223	95061	0.00368
ERR3199620_1_kneaddata_paired	Spirochaetota	32587	P	59225	28	59253	0.00229
ERR3199620_1_kneaddata_paired	Actinobacteriota	615	P	46772	145	46917	0.00182
ERR3199620_1_kneaddata_paired	Elusimicrobiota	11888	P	34848	0	34848	0.00135
ERR3199620_1_kneaddata_paired	Firmicutes_B	17289	P	1728	55	1783	0.00007
ERR3199620_1_kneaddata_paired	Firmicutes_I	18140	P	555	0	555	0.00002
ERR3199620_1_kneaddata_paired	Firmicutes_C	17613	P	121	0	121	0.00000
ERR3199620_1_kneaddata_paired	Thermotogota	33086	P	12	0	12	0.00000
ERR3199621_1_kneaddata_paired	Bacteroidota	4587	P	20340828	85237	20426065	0.65199
ERR3199621_1_kneaddata_paired	Firmicutes_A	14608	P	7641528	70047	7711575	0.24615
ERR3199621_1_kneaddata_paired	Verrucomicrobiota	33333	P	1520117	19467	1539584	0.04914
ERR3199621_1_kneaddata_paired	Firmicutes	12188	P	386688	7177	393865	0.01257
ERR3199621_1_kneaddata_paired	Spirochaetota	32587	P	316688	240	316928	0.01012
ERR3199621_1_kneaddata_paired	Desulfobacterota_A	11509	P	200195	3010	203205	0.00649
ERR3199621_1_kneaddata_paired	Proteobacteria	22518	P	191313	1879	193192	0.00617
ERR3199621_1_kneaddata_paired	Campylobacterota	8700	P	158844	49	158893	0.00507
ERR3199621_1_kneaddata_paired	Actinobacteriota	615	P	158684	498	159182	0.00508
ERR3199621_1_kneaddata_paired	Elusimicrobiota	11888	P	105573	0	105573	0.00337
ERR3199621_1_kneaddata_paired	Cyanobacteria	9876	P	78181	7308	85489	0.00273
ERR3199621_1_kneaddata_paired	Deferribacterota	10822	P	33746	181	33927	0.00108
ERR3199621_1_kneaddata_paired	Firmicutes_B	17289	P	612	31	643	0.00002
ERR3199621_1_kneaddata_paired	Firmicutes_I	18140	P	282	0	282	0.00001
ERR3199621_1_kneaddata_paired	Firmicutes_C	17613	P	149	0	149	0.00000
ERR3199621_1_kneaddata_paired	Thermotogota	33086	P	12	0	12	0.00000
ERR3199622_1_kneaddata_paired	Bacteroidota	4587	P	21761866	113673	21875539	0.74255
ERR3199622_1_kneaddata_paired	Firmicutes_A	14608	P	4535384	41172	4576556	0.15535
ERR3199622_1_kneaddata_paired	Firmicutes	12188	P	774213	16309	790522	0.02683
ERR3199622_1_kneaddata_paired	Verrucomicrobiota	33333	P	552193	8797	560990	0.01904
ERR3199622_1_kneaddata_paired	Actinobacteriota	615	P	463974	1380	465354	0.01580
ERR3199622_1_kneaddata_paired	Spirochaetota	32587	P	331804	313	332117	0.01127
ERR3199622_1_kneaddata_paired	Desulfobacterota_A	11509	P	321762	6317	328079	0.01114
ERR3199622_1_kneaddata_paired	Campylobacterota	8700	P	228321	86	228407	0.00775
ERR3199622_1_kneaddata_paired	Proteobacteria	22518	P	155385	1460	156845	0.00532
ERR3199622_1_kneaddata_paired	Elusimicrobiota	11888	P	55832	0	55832	0.00190
ERR3199622_1_kneaddata_paired	Cyanobacteria	9876	P	49388	5750	55138	0.00187
ERR3199622_1_kneaddata_paired	Deferribacterota	10822	P	33431	223	33654	0.00114
ERR3199622_1_kneaddata_paired	Firmicutes_B	17289	P	505	32	537	0.00002
ERR3199622_1_kneaddata_paired	Firmicutes_I	18140	P	472	0	472	0.00002
ERR3199622_1_kneaddata_paired	Firmicutes_C	17613	P	65	0	65	0.00000
ERR3199622_1_kneaddata_paired	Thermotogota	33086	P	28	0	28	0.00000
ERR3199623_1_kneaddata_paired	Bacteroidota	4587	P	17602025	72830	17674855	0.58699
ERR3199623_1_kneaddata_paired	Firmicutes_A	14608	P	8110633	65321	8175954	0.27153
ERR3199623_1_kneaddata_paired	Firmicutes	12188	P	1424270	11781	1436051	0.04769
ERR3199623_1_kneaddata_paired	Verrucomicrobiota	33333	P	816802	7785	824587	0.02739
ERR3199623_1_kneaddata_paired	Proteobacteria	22518	P	527118	12657	539775	0.01793
ERR3199623_1_kneaddata_paired	Actinobacteriota	615	P	420787	1000	421787	0.01401
ERR3199623_1_kneaddata_paired	Campylobacterota	8700	P	257973	58	258031	0.00857
ERR3199623_1_kneaddata_paired	Desulfobacterota_A	11509	P	231858	2231	234089	0.00777
ERR3199623_1_kneaddata_paired	Spirochaetota	32587	P	195221	111	195332	0.00649
ERR3199623_1_kneaddata_paired	Elusimicrobiota	11888	P	167459	0	167459	0.00556
ERR3199623_1_kneaddata_paired	Cyanobacteria	9876	P	153816	11482	165298	0.00549
ERR3199623_1_kneaddata_paired	Deferribacterota	10822	P	16310	65	16375	0.00054
ERR3199623_1_kneaddata_paired	Firmicutes_B	17289	P	730	28	758	0.00003
ERR3199623_1_kneaddata_paired	Firmicutes_I	18140	P	359	0	359	0.00001
ERR3199623_1_kneaddata_paired	Firmicutes_C	17613	P	170	0	170	0.00001
ERR3199623_1_kneaddata_paired	Thermotogota	33086	P	17	0	17	0.00000
ERR3199624_1_kneaddata_paired	Bacteroidota	4587	P	18738083	90854	18828937	0.73189
ERR3199624_1_kneaddata_paired	Firmicutes_A	14608	P	4453385	42142	4495527	0.17474
ERR3199624_1_kneaddata_paired	Verrucomicrobiota	33333	P	699294	8550	707844	0.02751
ERR3199624_1_kneaddata_paired	Firmicutes	12188	P	660051	20130	680181	0.02644
ERR3199624_1_kneaddata_paired	Campylobacterota	8700	P	241473	37	241510	0.00939
ERR3199624_1_kneaddata_paired	Desulfobacterota_A	11509	P	237100	3143	240243	0.00934
ERR3199624_1_kneaddata_paired	Actinobacteriota	615	P	213582	653	214235	0.00833
ERR3199624_1_kneaddata_paired	Proteobacteria	22518	P	120652	372	121024	0.00470
ERR3199624_1_kneaddata_paired	Cyanobacteria	9876	P	86107	4785	90892	0.00353
ERR3199624_1_kneaddata_paired	Spirochaetota	32587	P	38019	28	38047	0.00148
ERR3199624_1_kneaddata_paired	Elusimicrobiota	11888	P	34967	0	34967	0.00136
ERR3199624_1_kneaddata_paired	Deferribacterota	10822	P	31060	160	31220	0.00121
ERR3199624_1_kneaddata_paired	Firmicutes_B	17289	P	890	44	934	0.00004
ERR3199624_1_kneaddata_paired	Firmicutes_I	18140	P	557	0	557	0.00002
ERR3199624_1_kneaddata_paired	Firmicutes_C	17613	P	158	0	158	0.00001
ERR3199624_1_kneaddata_paired	Thermotogota	33086	P	6	0	6	0.00000
ERR3199625_1_kneaddata_paired	Bacteroidota	4587	P	12070489	44162	12114651	0.45957
ERR3199625_1_kneaddata_paired	Firmicutes_A	14608	P	9128747	78747	9207494	0.34929
ERR3199625_1_kneaddata_paired	Spirochaetota	32587	P	1927531	1065	1928596	0.07316
ERR3199625_1_kneaddata_paired	Campylobacterota	8700	P	676649	69	676718	0.02567
ERR3199625_1_kneaddata_paired	Verrucomicrobiota	33333	P	672134	6193	678327	0.02573
ERR3199625_1_kneaddata_paired	Desulfobacterota_A	11509	P	525386	4080	529466	0.02009
ERR3199625_1_kneaddata_paired	Firmicutes	12188	P	367249	8075	375324	0.01424
ERR3199625_1_kneaddata_paired	Actinobacteriota	615	P	284798	769	285567	0.01083
ERR3199625_1_kneaddata_paired	Elusimicrobiota	11888	P	235870	0	235870	0.00895
ERR3199625_1_kneaddata_paired	Proteobacteria	22518	P	145281	375	145656	0.00553
ERR3199625_1_kneaddata_paired	Deferribacterota	10822	P	118416	466	118882	0.00451
ERR3199625_1_kneaddata_paired	Cyanobacteria	9876	P	58876	4264	63140	0.00240
ERR3199625_1_kneaddata_paired	Firmicutes_B	17289	P	642	24	666	0.00003
ERR3199625_1_kneaddata_paired	Firmicutes_I	18140	P	394	0	394	0.00001
ERR3199625_1_kneaddata_paired	Firmicutes_C	17613	P	113	0	113	0.00000
ERR3199625_1_kneaddata_paired	Thermotogota	33086	P	10	0	10	0.00000
ERR3199626_1_kneaddata_paired	Bacteroidota	4587	P	23532717	126610	23659327	0.79719
ERR3199626_1_kneaddata_paired	Firmicutes_A	14608	P	3110445	37664	3148109	0.10607
ERR3199626_1_kneaddata_paired	Firmicutes	12188	P	1338636	14375	1353011	0.04559
ERR3199626_1_kneaddata_paired	Spirochaetota	32587	P	439132	340	439472	0.01481
ERR3199626_1_kneaddata_paired	Actinobacteriota	615	P	431291	1006	432297	0.01457
ERR3199626_1_kneaddata_paired	Proteobacteria	22518	P	198934	1491	200425	0.00675
ERR3199626_1_kneaddata_paired	Cyanobacteria	9876	P	128020	13118	141138	0.00476
ERR3199626_1_kneaddata_paired	Campylobacterota	8700	P	111418	66	111484	0.00376
ERR3199626_1_kneaddata_paired	Desulfobacterota_A	11509	P	79854	1236	81090	0.00273
ERR3199626_1_kneaddata_paired	Deferribacterota	10822	P	57906	318	58224	0.00196
ERR3199626_1_kneaddata_paired	Verrucomicrobiota	33333	P	36035	473	36508	0.00123
ERR3199626_1_kneaddata_paired	Elusimicrobiota	11888	P	16260	0	16260	0.00055
ERR3199626_1_kneaddata_paired	Firmicutes_I	18140	P	711	0	711	0.00002
ERR3199626_1_kneaddata_paired	Firmicutes_B	17289	P	299	15	314	0.00001
ERR3199626_1_kneaddata_paired	Firmicutes_C	17613	P	52	0	52	0.00000
ERR3199626_1_kneaddata_paired	Thermotogota	33086	P	7	0	7	0.00000
ERR3199627_1_kneaddata_paired	Bacteroidota	4587	P	21485336	105504	21590840	0.77418
ERR3199627_1_kneaddata_paired	Firmicutes_A	14608	P	2924365	28593	2952958	0.10588
ERR3199627_1_kneaddata_paired	Firmicutes	12188	P	1324713	27940	1352653	0.04850
ERR3199627_1_kneaddata_paired	Verrucomicrobiota	33333	P	751273	8967	760240	0.02726
ERR3199627_1_kneaddata_paired	Actinobacteriota	615	P	393178	989	394167	0.01413
ERR3199627_1_kneaddata_paired	Proteobacteria	22518	P	247970	490	248460	0.00891
ERR3199627_1_kneaddata_paired	Campylobacterota	8700	P	188026	47	188073	0.00674
ERR3199627_1_kneaddata_paired	Spirochaetota	32587	P	132738	94	132832	0.00476
ERR3199627_1_kneaddata_paired	Desulfobacterota_A	11509	P	103400	1477	104877	0.00376
ERR3199627_1_kneaddata_paired	Cyanobacteria	9876	P	97727	8832	106559	0.00382
ERR3199627_1_kneaddata_paired	Elusimicrobiota	11888	P	47508	0	47508	0.00170
ERR3199627_1_kneaddata_paired	Deferribacterota	10822	P	8703	43	8746	0.00031
ERR3199627_1_kneaddata_paired	Firmicutes_I	18140	P	476	0	476	0.00002
ERR3199627_1_kneaddata_paired	Firmicutes_B	17289	P	281	13	294	0.00001
ERR3199627_1_kneaddata_paired	Firmicutes_C	17613	P	73	0	73	0.00000
ERR3199627_1_kneaddata_paired	Thermotogota	33086	P	5	0	5	0.00000
ERR3199628_1_kneaddata_paired	Bacteroidota	4587	P	10288707	55455	10344162	0.40463
ERR3199628_1_kneaddata_paired	Verrucomicrobiota	33333	P	5529922	37661	5567583	0.21778
ERR3199628_1_kneaddata_paired	Firmicutes_A	14608	P	4976803	25012	5001815	0.19565
ERR3199628_1_kneaddata_paired	Firmicutes	12188	P	1404665	6022	1410687	0.05518
ERR3199628_1_kneaddata_paired	Elusimicrobiota	11888	P	1132223	0	1132223	0.04429
ERR3199628_1_kneaddata_paired	Proteobacteria	22518	P	951892	2407	954299	0.03733
ERR3199628_1_kneaddata_paired	Campylobacterota	8700	P	328165	26	328191	0.01284
ERR3199628_1_kneaddata_paired	Cyanobacteria	9876	P	249865	8387	258252	0.01010
ERR3199628_1_kneaddata_paired	Desulfobacterota_A	11509	P	185923	1417	187340	0.00733
ERR3199628_1_kneaddata_paired	Spirochaetota	32587	P	184908	78	184986	0.00724
ERR3199628_1_kneaddata_paired	Actinobacteriota	615	P	112002	221	112223	0.00439
ERR3199628_1_kneaddata_paired	Deferribacterota	10822	P	79983	233	80216	0.00314
ERR3199628_1_kneaddata_paired	Firmicutes_B	17289	P	1240	34	1274	0.00005
ERR3199628_1_kneaddata_paired	Firmicutes_I	18140	P	1001	0	1001	0.00004
ERR3199628_1_kneaddata_paired	Firmicutes_C	17613	P	423	0	423	0.00002
ERR3199628_1_kneaddata_paired	Thermotogota	33086	P	20	0	20	0.00000
ERR3199629_1_kneaddata_paired	Bacteroidota	4587	P	16079243	84742	16163985	0.60898
ERR3199629_1_kneaddata_paired	Firmicutes_A	14608	P	6527507	58042	6585549	0.24811
ERR3199629_1_kneaddata_paired	Verrucomicrobiota	33333	P	1356286	11446	1367732	0.05153
ERR3199629_1_kneaddata_paired	Firmicutes	12188	P	1033284	9614	1042898	0.03929
ERR3199629_1_kneaddata_paired	Campylobacterota	8700	P	279151	6	279157	0.01052
ERR3199629_1_kneaddata_paired	Actinobacteriota	615	P	233354	543	233897	0.00881
ERR3199629_1_kneaddata_paired	Spirochaetota	32587	P	192267	97	192364	0.00725
ERR3199629_1_kneaddata_paired	Cyanobacteria	9876	P	180572	11209	191781	0.00723
ERR3199629_1_kneaddata_paired	Desulfobacterota_A	11509	P	169219	1685	170904	0.00644
ERR3199629_1_kneaddata_paired	Proteobacteria	22518	P	168507	2404	170911	0.00644
ERR3199629_1_kneaddata_paired	Deferribacterota	10822	P	98177	352	98529	0.00371
ERR3199629_1_kneaddata_paired	Elusimicrobiota	11888	P	44092	0	44092	0.00166
ERR3199629_1_kneaddata_paired	Firmicutes_B	17289	P	474	16	490	0.00002
ERR3199629_1_kneaddata_paired	Firmicutes_I	18140	P	352	0	352	0.00001
ERR3199629_1_kneaddata_paired	Firmicutes_C	17613	P	239	0	239	0.00001
ERR3199629_1_kneaddata_paired	Thermotogota	33086	P	20	0	20	0.00000
ERR3199630_1_kneaddata_paired	Bacteroidota	4587	P	18050408	93375	18143783	0.56802
ERR3199630_1_kneaddata_paired	Firmicutes_A	14608	P	11069412	62135	11131547	0.34849
ERR3199630_1_kneaddata_paired	Firmicutes	12188	P	1350782	11347	1362129	0.04264
ERR3199630_1_kneaddata_paired	Actinobacteriota	615	P	323837	821	324658	0.01016
ERR3199630_1_kneaddata_paired	Campylobacterota	8700	P	300664	25	300689	0.00941
ERR3199630_1_kneaddata_paired	Desulfobacterota_A	11509	P	236956	3065	240021	0.00751
ERR3199630_1_kneaddata_paired	Verrucomicrobiota	33333	P	212922	2074	214996	0.00673
ERR3199630_1_kneaddata_paired	Proteobacteria	22518	P	89120	1428	90548	0.00283
ERR3199630_1_kneaddata_paired	Spirochaetota	32587	P	53373	31	53404	0.00167
ERR3199630_1_kneaddata_paired	Cyanobacteria	9876	P	44121	3096	47217	0.00148
ERR3199630_1_kneaddata_paired	Deferribacterota	10822	P	29476	120	29596	0.00093
ERR3199630_1_kneaddata_paired	Elusimicrobiota	11888	P	2683	0	2683	0.00008
ERR3199630_1_kneaddata_paired	Firmicutes_B	17289	P	554	21	575	0.00002
ERR3199630_1_kneaddata_paired	Firmicutes_I	18140	P	355	0	355	0.00001
ERR3199630_1_kneaddata_paired	Firmicutes_C	17613	P	104	0	104	0.00000
ERR3199630_1_kneaddata_paired	Thermotogota	33086	P	37	0	37	0.00000
ERR3199631_1_kneaddata_paired	Bacteroidota	4587	P	15023110	57066	15080176	0.56669
ERR3199631_1_kneaddata_paired	Firmicutes_A	14608	P	4717103	34980	4752083	0.17858
ERR3199631_1_kneaddata_paired	Cyanobacteria	9876	P	1621197	49512	1670709	0.06278
ERR3199631_1_kneaddata_paired	Verrucomicrobiota	33333	P	1599722	15312	1615034	0.06069
ERR3199631_1_kneaddata_paired	Elusimicrobiota	11888	P	978224	0	978224	0.03676
ERR3199631_1_kneaddata_paired	Proteobacteria	22518	P	742697	5015	747712	0.02810
ERR3199631_1_kneaddata_paired	Firmicutes	12188	P	590315	5327	595642	0.02238
ERR3199631_1_kneaddata_paired	Actinobacteriota	615	P	419621	901	420522	0.01580
ERR3199631_1_kneaddata_paired	Spirochaetota	32587	P	290180	167	290347	0.01091
ERR3199631_1_kneaddata_paired	Desulfobacterota_A	11509	P	241391	2341	243732	0.00916
ERR3199631_1_kneaddata_paired	Campylobacterota	8700	P	135564	8	135572	0.00509
ERR3199631_1_kneaddata_paired	Deferribacterota	10822	P	79662	325	79987	0.00301
ERR3199631_1_kneaddata_paired	Firmicutes_B	17289	P	638	24	662	0.00002
ERR3199631_1_kneaddata_paired	Firmicutes_I	18140	P	351	0	351	0.00001
ERR3199631_1_kneaddata_paired	Firmicutes_C	17613	P	157	0	157	0.00001
ERR3199631_1_kneaddata_paired	Thermotogota	33086	P	20	0	20	0.00000
ERR3199632_1_kneaddata_paired	Firmicutes_A	14608	P	13481068	49745	13530813	0.51692
ERR3199632_1_kneaddata_paired	Bacteroidota	4587	P	7348976	40616	7389592	0.28231
ERR3199632_1_kneaddata_paired	Spirochaetota	32587	P	1305850	598	1306448	0.04991
ERR3199632_1_kneaddata_paired	Campylobacterota	8700	P	993972	48	994020	0.03797
ERR3199632_1_kneaddata_paired	Firmicutes	12188	P	853234	7191	860425	0.03287
ERR3199632_1_kneaddata_paired	Desulfobacterota_A	11509	P	576363	4774	581137	0.02220
ERR3199632_1_kneaddata_paired	Deferribacterota	10822	P	372627	1214	373841	0.01428
ERR3199632_1_kneaddata_paired	Proteobacteria	22518	P	323575	714	324289	0.01239
ERR3199632_1_kneaddata_paired	Verrucomicrobiota	33333	P	297066	2297	299363	0.01144
ERR3199632_1_kneaddata_paired	Actinobacteriota	615	P	205510	220	205730	0.00786
ERR3199632_1_kneaddata_paired	Elusimicrobiota	11888	P	161197	0	161197	0.00616
ERR3199632_1_kneaddata_paired	Cyanobacteria	9876	P	139833	6974	146807	0.00561
ERR3199632_1_kneaddata_paired	Firmicutes_B	17289	P	1426	44	1470	0.00006
ERR3199632_1_kneaddata_paired	Firmicutes_I	18140	P	389	0	389	0.00001
ERR3199632_1_kneaddata_paired	Firmicutes_C	17613	P	295	0	295	0.00001
ERR3199632_1_kneaddata_paired	Thermotogota	33086	P	56	0	56	0.00000
ERR3199633_1_kneaddata_paired	Bacteroidota	4587	P	20493181	85473	20578654	0.70514
ERR3199633_1_kneaddata_paired	Firmicutes_A	14608	P	4651226	49881	4701107	0.16109
ERR3199633_1_kneaddata_paired	Verrucomicrobiota	33333	P	1131742	13897	1145639	0.03926
ERR3199633_1_kneaddata_paired	Firmicutes	12188	P	1126806	10505	1137311	0.03897
ERR3199633_1_kneaddata_paired	Proteobacteria	22518	P	447463	15184	462647	0.01585
ERR3199633_1_kneaddata_paired	Actinobacteriota	615	P	317910	704	318614	0.01092
ERR3199633_1_kneaddata_paired	Desulfobacterota_A	11509	P	287460	3818	291278	0.00998
ERR3199633_1_kneaddata_paired	Campylobacterota	8700	P	245425	87	245512	0.00841
ERR3199633_1_kneaddata_paired	Cyanobacteria	9876	P	134454	12851	147305	0.00505
ERR3199633_1_kneaddata_paired	Elusimicrobiota	11888	P	98868	0	98868	0.00339
ERR3199633_1_kneaddata_paired	Spirochaetota	32587	P	36187	27	36214	0.00124
ERR3199633_1_kneaddata_paired	Deferribacterota	10822	P	19653	102	19755	0.00068
ERR3199633_1_kneaddata_paired	Firmicutes_B	17289	P	529	26	555	0.00002
ERR3199633_1_kneaddata_paired	Firmicutes_I	18140	P	166	0	166	0.00001
ERR3199633_1_kneaddata_paired	Firmicutes_C	17613	P	56	0	56	0.00000
ERR3199633_1_kneaddata_paired	Thermotogota	33086	P	40	0	40	0.00000
ERR3199634_1_kneaddata_paired	Bacteroidota	4587	P	13882769	60413	13943182	0.49541
ERR3199634_1_kneaddata_paired	Firmicutes_A	14608	P	11800213	57709	11857922	0.42132
ERR3199634_1_kneaddata_paired	Verrucomicrobiota	33333	P	747235	7217	754452	0.02681
ERR3199634_1_kneaddata_paired	Spirochaetota	32587	P	546323	314	546637	0.01942
ERR3199634_1_kneaddata_paired	Firmicutes	12188	P	332018	4784	336802	0.01197
ERR3199634_1_kneaddata_paired	Elusimicrobiota	11888	P	146932	0	146932	0.00522
ERR3199634_1_kneaddata_paired	Actinobacteriota	615	P	131324	333	131657	0.00468
ERR3199634_1_kneaddata_paired	Proteobacteria	22518	P	130358	492	130850	0.00465
ERR3199634_1_kneaddata_paired	Desulfobacterota_A	11509	P	112511	1259	113770	0.00404
ERR3199634_1_kneaddata_paired	Cyanobacteria	9876	P	94798	7090	101888	0.00362
ERR3199634_1_kneaddata_paired	Campylobacterota	8700	P	66986	10	66996	0.00238
ERR3199634_1_kneaddata_paired	Deferribacterota	10822	P	12226	49	12275	0.00044
ERR3199634_1_kneaddata_paired	Firmicutes_B	17289	P	922	36	958	0.00003
ERR3199634_1_kneaddata_paired	Firmicutes_I	18140	P	301	0	301	0.00001
ERR3199634_1_kneaddata_paired	Firmicutes_C	17613	P	206	0	206	0.00001
ERR3199634_1_kneaddata_paired	Thermotogota	33086	P	19	0	19	0.00000
ERR3199635_1_kneaddata_paired	Bacteroidota	4587	P	9483428	45539	9528967	0.43475
ERR3199635_1_kneaddata_paired	Firmicutes_A	14608	P	8130850	29254	8160104	0.37230
ERR3199635_1_kneaddata_paired	Verrucomicrobiota	33333	P	1198404	8314	1206718	0.05506
ERR3199635_1_kneaddata_paired	Elusimicrobiota	11888	P	1089848	0	1089848	0.04972
ERR3199635_1_kneaddata_paired	Proteobacteria	22518	P	548110	1683	549793	0.02508
ERR3199635_1_kneaddata_paired	Cyanobacteria	9876	P	298037	15823	313860	0.01432
ERR3199635_1_kneaddata_paired	Desulfobacterota_A	11509	P	258575	1873	260448	0.01188
ERR3199635_1_kneaddata_paired	Firmicutes	12188	P	252931	1655	254586	0.01162
ERR3199635_1_kneaddata_paired	Campylobacterota	8700	P	232515	28	232543	0.01061
ERR3199635_1_kneaddata_paired	Spirochaetota	32587	P	186793	79	186872	0.00853
ERR3199635_1_kneaddata_paired	Actinobacteriota	615	P	105268	329	105597	0.00482
ERR3199635_1_kneaddata_paired	Deferribacterota	10822	P	27383	80	27463	0.00125
ERR3199635_1_kneaddata_paired	Firmicutes_B	17289	P	918	25	943	0.00004
ERR3199635_1_kneaddata_paired	Firmicutes_I	18140	P	335	0	335	0.00002
ERR3199635_1_kneaddata_paired	Firmicutes_C	17613	P	210	0	210	0.00001
ERR3199635_1_kneaddata_paired	Thermotogota	33086	P	52	0	52	0.00000
ERR3199636_1_kneaddata_paired	Bacteroidota	4587	P	18618790	57717	18676507	0.57241
ERR3199636_1_kneaddata_paired	Firmicutes_A	14608	P	10765453	115702	10881155	0.33349
ERR3199636_1_kneaddata_paired	Verrucomicrobiota	33333	P	853297	7839	861136	0.02639
ERR3199636_1_kneaddata_paired	Firmicutes	12188	P	407745	8813	416558	0.01277
ERR3199636_1_kneaddata_paired	Desulfobacterota_A	11509	P	405789	3874	409663	0.01256
ERR3199636_1_kneaddata_paired	Campylobacterota	8700	P	371955	10	371965	0.01140
ERR3199636_1_kneaddata_paired	Actinobacteriota	615	P	262304	461	262765	0.00805
ERR3199636_1_kneaddata_paired	Proteobacteria	22518	P	237890	1917	239807	0.00735
ERR3199636_1_kneaddata_paired	Spirochaetota	32587	P	208341	114	208455	0.00639
ERR3199636_1_kneaddata_paired	Deferribacterota	10822	P	136769	531	137300	0.00421
ERR3199636_1_kneaddata_paired	Cyanobacteria	9876	P	125529	9252	134781	0.00413
ERR3199636_1_kneaddata_paired	Elusimicrobiota	11888	P	26105	0	26105	0.00080
ERR3199636_1_kneaddata_paired	Firmicutes_B	17289	P	1095	40	1135	0.00003
ERR3199636_1_kneaddata_paired	Firmicutes_I	18140	P	218	0	218	0.00001
ERR3199636_1_kneaddata_paired	Firmicutes_C	17613	P	90	0	90	0.00000
ERR3199636_1_kneaddata_paired	Thermotogota	33086	P	2	0	2	0.00000
ERR3199637_1_kneaddata_paired	Bacteroidota	4587	P	20709761	91803	20801564	0.67772
ERR3199637_1_kneaddata_paired	Firmicutes_A	14608	P	6722722	46346	6769068	0.22054
ERR3199637_1_kneaddata_paired	Verrucomicrobiota	33333	P	1053450	14073	1067523	0.03478
ERR3199637_1_kneaddata_paired	Firmicutes	12188	P	631964	9412	641376	0.02090
ERR3199637_1_kneaddata_paired	Elusimicrobiota	11888	P	319909	0	319909	0.01042
ERR3199637_1_kneaddata_paired	Desulfobacterota_A	11509	P	290810	4579	295389	0.00962
ERR3199637_1_kneaddata_paired	Campylobacterota	8700	P	225650	26	225676	0.00735
ERR3199637_1_kneaddata_paired	Cyanobacteria	9876	P	183762	19278	203040	0.00662
ERR3199637_1_kneaddata_paired	Actinobacteriota	615	P	164136	432	164568	0.00536
ERR3199637_1_kneaddata_paired	Proteobacteria	22518	P	162743	2436	165179	0.00538
ERR3199637_1_kneaddata_paired	Deferribacterota	10822	P	33265	188	33453	0.00109
ERR3199637_1_kneaddata_paired	Spirochaetota	32587	P	5535	5	5540	0.00018
ERR3199637_1_kneaddata_paired	Firmicutes_B	17289	P	542	29	571	0.00002
ERR3199637_1_kneaddata_paired	Firmicutes_I	18140	P	324	0	324	0.00001
ERR3199637_1_kneaddata_paired	Firmicutes_C	17613	P	250	0	250	0.00001
ERR3199637_1_kneaddata_paired	Thermotogota	33086	P	36	0	36	0.00000
ERR3199638_1_kneaddata_paired	Bacteroidota	4587	P	12764914	69020	12833934	0.51967
ERR3199638_1_kneaddata_paired	Firmicutes_A	14608	P	3562504	19606	3582110	0.14505
ERR3199638_1_kneaddata_paired	Verrucomicrobiota	33333	P	3368134	12427	3380561	0.13689
ERR3199638_1_kneaddata_paired	Elusimicrobiota	11888	P	1641152	0	1641152	0.06645
ERR3199638_1_kneaddata_paired	Proteobacteria	22518	P	999869	3493	1003362	0.04063
ERR3199638_1_kneaddata_paired	Firmicutes	12188	P	546894	2360	549254	0.02224
ERR3199638_1_kneaddata_paired	Cyanobacteria	9876	P	513108	9700	522808	0.02117
ERR3199638_1_kneaddata_paired	Spirochaetota	32587	P	469199	104	469303	0.01900
ERR3199638_1_kneaddata_paired	Actinobacteriota	615	P	378154	207	378361	0.01532
ERR3199638_1_kneaddata_paired	Desulfobacterota_A	11509	P	220198	779	220977	0.00895
ERR3199638_1_kneaddata_paired	Campylobacterota	8700	P	84203	3	84206	0.00341
ERR3199638_1_kneaddata_paired	Deferribacterota	10822	P	27759	42	27801	0.00113
ERR3199638_1_kneaddata_paired	Firmicutes_B	17289	P	1080	16	1096	0.00004
ERR3199638_1_kneaddata_paired	Firmicutes_I	18140	P	868	0	868	0.00004
ERR3199638_1_kneaddata_paired	Firmicutes_C	17613	P	326	0	326	0.00001
ERR3199638_1_kneaddata_paired	Thermotogota	33086	P	85	0	85	0.00000
ERR3199639_1_kneaddata_paired	Bacteroidota	4587	P	22735816	115714	22851530	0.74218
ERR3199639_1_kneaddata_paired	Firmicutes_A	14608	P	4488077	45586	4533663	0.14725
ERR3199639_1_kneaddata_paired	Firmicutes	12188	P	1035400	8913	1044313	0.03392
ERR3199639_1_kneaddata_paired	Verrucomicrobiota	33333	P	858643	9486	868129	0.02820
ERR3199639_1_kneaddata_paired	Proteobacteria	22518	P	458008	3025	461033	0.01497
ERR3199639_1_kneaddata_paired	Cyanobacteria	9876	P	281111	23135	304246	0.00988
ERR3199639_1_kneaddata_paired	Spirochaetota	32587	P	273180	180	273360	0.00888
ERR3199639_1_kneaddata_paired	Actinobacteriota	615	P	202813	541	203354	0.00660
ERR3199639_1_kneaddata_paired	Campylobacterota	8700	P	109595	3	109598	0.00356
ERR3199639_1_kneaddata_paired	Desulfobacterota_A	11509	P	61325	910	62235	0.00202
ERR3199639_1_kneaddata_paired	Elusimicrobiota	11888	P	57286	0	57286	0.00186
ERR3199639_1_kneaddata_paired	Deferribacterota	10822	P	19398	90	19488	0.00063
ERR3199639_1_kneaddata_paired	Firmicutes_B	17289	P	678	30	708	0.00002
ERR3199639_1_kneaddata_paired	Firmicutes_I	18140	P	395	0	395	0.00001
ERR3199639_1_kneaddata_paired	Firmicutes_C	17613	P	175	0	175	0.00001
ERR3199639_1_kneaddata_paired	Thermotogota	33086	P	21	0	21	0.00000
ERR3199640_1_kneaddata_paired	Bacteroidota	4587	P	21308475	90797	21399272	0.68274
ERR3199640_1_kneaddata_paired	Firmicutes_A	14608	P	4739697	49478	4789175	0.15280
ERR3199640_1_kneaddata_paired	Verrucomicrobiota	33333	P	1869704	18322	1888026	0.06024
ERR3199640_1_kneaddata_paired	Firmicutes	12188	P	1076756	9263	1086019	0.03465
ERR3199640_1_kneaddata_paired	Proteobacteria	22518	P	686973	12872	699845	0.02233
ERR3199640_1_kneaddata_paired	Actinobacteriota	615	P	492486	968	493454	0.01574
ERR3199640_1_kneaddata_paired	Elusimicrobiota	11888	P	249408	0	249408	0.00796
ERR3199640_1_kneaddata_paired	Cyanobacteria	9876	P	210572	16255	226827	0.00724
ERR3199640_1_kneaddata_paired	Desulfobacterota_A	11509	P	190726	1831	192557	0.00614
ERR3199640_1_kneaddata_paired	Campylobacterota	8700	P	171890	57	171947	0.00549
ERR3199640_1_kneaddata_paired	Deferribacterota	10822	P	78698	329	79027	0.00252
ERR3199640_1_kneaddata_paired	Spirochaetota	32587	P	66887	39	66926	0.00214
ERR3199640_1_kneaddata_paired	Firmicutes_B	17289	P	457	18	475	0.00002
ERR3199640_1_kneaddata_paired	Firmicutes_I	18140	P	317	0	317	0.00001
ERR3199640_1_kneaddata_paired	Firmicutes_C	17613	P	87	0	87	0.00000
ERR3199640_1_kneaddata_paired	Thermotogota	33086	P	7	0	7	0.00000
ERR3199641_1_kneaddata_paired	Bacteroidota	4587	P	18387730	103475	18491205	0.69173
ERR3199641_1_kneaddata_paired	Firmicutes_A	14608	P	5595285	52205	5647490	0.21126
ERR3199641_1_kneaddata_paired	Firmicutes	12188	P	981263	10320	991583	0.03709
ERR3199641_1_kneaddata_paired	Spirochaetota	32587	P	367374	271	367645	0.01375
ERR3199641_1_kneaddata_paired	Verrucomicrobiota	33333	P	308091	3818	311909	0.01167
ERR3199641_1_kneaddata_paired	Campylobacterota	8700	P	234566	19	234585	0.00878
ERR3199641_1_kneaddata_paired	Proteobacteria	22518	P	179380	1034	180414	0.00675
ERR3199641_1_kneaddata_paired	Desulfobacterota_A	11509	P	159560	2306	161866	0.00606
ERR3199641_1_kneaddata_paired	Actinobacteriota	615	P	129326	760	130086	0.00487
ERR3199641_1_kneaddata_paired	Elusimicrobiota	11888	P	82073	0	82073	0.00307
ERR3199641_1_kneaddata_paired	Cyanobacteria	9876	P	71554	6279	77833	0.00291
ERR3199641_1_kneaddata_paired	Deferribacterota	10822	P	53743	281	54024	0.00202
ERR3199641_1_kneaddata_paired	Firmicutes_B	17289	P	722	36	758	0.00003
ERR3199641_1_kneaddata_paired	Firmicutes_I	18140	P	230	0	230	0.00001
ERR3199641_1_kneaddata_paired	Firmicutes_C	17613	P	101	0	101	0.00000
ERR3199641_1_kneaddata_paired	Thermotogota	33086	P	14	0	14	0.00000
ERR3199642_1_kneaddata_paired	Bacteroidota	4587	P	19173851	87450	19261301	0.71171
ERR3199642_1_kneaddata_paired	Firmicutes_A	14608	P	4117942	33529	4151471	0.15340
ERR3199642_1_kneaddata_paired	Verrucomicrobiota	33333	P	1568044	19672	1587716	0.05867
ERR3199642_1_kneaddata_paired	Firmicutes	12188	P	794314	15380	809694	0.02992
ERR3199642_1_kneaddata_paired	Actinobacteriota	615	P	510236	914	511150	0.01889
ERR3199642_1_kneaddata_paired	Proteobacteria	22518	P	201782	1740	203522	0.00752
ERR3199642_1_kneaddata_paired	Desulfobacterota_A	11509	P	157069	2242	159311	0.00589
ERR3199642_1_kneaddata_paired	Campylobacterota	8700	P	123394	65	123459	0.00456
ERR3199642_1_kneaddata_paired	Cyanobacteria	9876	P	92776	8994	101770	0.00376
ERR3199642_1_kneaddata_paired	Spirochaetota	32587	P	64386	49	64435	0.00238
ERR3199642_1_kneaddata_paired	Elusimicrobiota	11888	P	60019	0	60019	0.00222
ERR3199642_1_kneaddata_paired	Deferribacterota	10822	P	28292	151	28443	0.00105
ERR3199642_1_kneaddata_paired	Firmicutes_I	18140	P	462	0	462	0.00002
ERR3199642_1_kneaddata_paired	Firmicutes_B	17289	P	430	22	452	0.00002
ERR3199642_1_kneaddata_paired	Firmicutes_C	17613	P	82	0	82	0.00000
ERR3199642_1_kneaddata_paired	Thermotogota	33086	P	21	0	21	0.00000
ERR3199643_1_kneaddata_paired	Bacteroidota	4587	P	22716553	122823	22839376	0.77931
ERR3199643_1_kneaddata_paired	Firmicutes_A	14608	P	2904356	29893	2934249	0.10012
ERR3199643_1_kneaddata_paired	Verrucomicrobiota	33333	P	1189297	19177	1208474	0.04123
ERR3199643_1_kneaddata_paired	Firmicutes	12188	P	821184	11614	832798	0.02842
ERR3199643_1_kneaddata_paired	Actinobacteriota	615	P	409387	932	410319	0.01400
ERR3199643_1_kneaddata_paired	Proteobacteria	22518	P	290303	3109	293412	0.01001
ERR3199643_1_kneaddata_paired	Spirochaetota	32587	P	194555	186	194741	0.00664
ERR3199643_1_kneaddata_paired	Campylobacterota	8700	P	193150	58	193208	0.00659
ERR3199643_1_kneaddata_paired	Elusimicrobiota	11888	P	122210	0	122210	0.00417
ERR3199643_1_kneaddata_paired	Desulfobacterota_A	11509	P	97281	1460	98741	0.00337
ERR3199643_1_kneaddata_paired	Cyanobacteria	9876	P	95554	12211	107765	0.00368
ERR3199643_1_kneaddata_paired	Deferribacterota	10822	P	70727	481	71208	0.00243
ERR3199643_1_kneaddata_paired	Firmicutes_B	17289	P	509	33	542	0.00002
ERR3199643_1_kneaddata_paired	Firmicutes_I	18140	P	189	0	189	0.00001
ERR3199643_1_kneaddata_paired	Firmicutes_C	17613	P	90	0	90	0.00000
ERR3199643_1_kneaddata_paired	Thermotogota	33086	P	11	0	11	0.00000
ERR3199644_1_kneaddata_paired	Bacteroidota	4587	P	18039734	87666	18127400	0.60179
ERR3199644_1_kneaddata_paired	Firmicutes_A	14608	P	9080585	54991	9135576	0.30328
ERR3199644_1_kneaddata_paired	Firmicutes	12188	P	695531	14401	709932	0.02357
ERR3199644_1_kneaddata_paired	Verrucomicrobiota	33333	P	591409	6651	598060	0.01985
ERR3199644_1_kneaddata_paired	Spirochaetota	32587	P	517195	348	517543	0.01718
ERR3199644_1_kneaddata_paired	Actinobacteriota	615	P	377094	774	377868	0.01254
ERR3199644_1_kneaddata_paired	Desulfobacterota_A	11509	P	225009	2608	227617	0.00756
ERR3199644_1_kneaddata_paired	Campylobacterota	8700	P	208909	28	208937	0.00694
ERR3199644_1_kneaddata_paired	Proteobacteria	22518	P	97942	225	98167	0.00326
ERR3199644_1_kneaddata_paired	Elusimicrobiota	11888	P	53959	0	53959	0.00179
ERR3199644_1_kneaddata_paired	Cyanobacteria	9876	P	52595	3998	56593	0.00188
ERR3199644_1_kneaddata_paired	Deferribacterota	10822	P	9357	44	9401	0.00031
ERR3199644_1_kneaddata_paired	Firmicutes_B	17289	P	777	35	812	0.00003
ERR3199644_1_kneaddata_paired	Firmicutes_I	18140	P	528	0	528	0.00002
ERR3199644_1_kneaddata_paired	Firmicutes_C	17613	P	106	0	106	0.00000
ERR3199644_1_kneaddata_paired	Thermotogota	33086	P	6	0	6	0.00000
ERR3199645_1_kneaddata_paired	Bacteroidota	4587	P	14975748	57592	15033340	0.59718
ERR3199645_1_kneaddata_paired	Firmicutes_A	14608	P	3942919	28727	3971646	0.15777
ERR3199645_1_kneaddata_paired	Verrucomicrobiota	33333	P	2224488	18569	2243057	0.08910
ERR3199645_1_kneaddata_paired	Elusimicrobiota	11888	P	1281563	0	1281563	0.05091
ERR3199645_1_kneaddata_paired	Firmicutes	12188	P	855305	31294	886599	0.03522
ERR3199645_1_kneaddata_paired	Actinobacteriota	615	P	440254	502	440756	0.01751
ERR3199645_1_kneaddata_paired	Proteobacteria	22518	P	333713	1258	334971	0.01331
ERR3199645_1_kneaddata_paired	Campylobacterota	8700	P	285186	65	285251	0.01133
ERR3199645_1_kneaddata_paired	Spirochaetota	32587	P	283491	142	283633	0.01127
ERR3199645_1_kneaddata_paired	Cyanobacteria	9876	P	282972	17367	300339	0.01193
ERR3199645_1_kneaddata_paired	Desulfobacterota_A	11509	P	65344	760	66104	0.00263
ERR3199645_1_kneaddata_paired	Deferribacterota	10822	P	45050	160	45210	0.00180
ERR3199645_1_kneaddata_paired	Firmicutes_I	18140	P	556	0	556	0.00002
ERR3199645_1_kneaddata_paired	Firmicutes_B	17289	P	503	17	520	0.00002
ERR3199645_1_kneaddata_paired	Firmicutes_C	17613	P	181	0	181	0.00001
ERR3199645_1_kneaddata_paired	Thermotogota	33086	P	86	0	86	0.00000
ERR3199646_1_kneaddata_paired	Bacteroidota	4587	P	16105754	83338	16189092	0.69373
ERR3199646_1_kneaddata_paired	Firmicutes_A	14608	P	4828539	38959	4867498	0.20858
ERR3199646_1_kneaddata_paired	Firmicutes	12188	P	781023	9587	790610	0.03388
ERR3199646_1_kneaddata_paired	Verrucomicrobiota	33333	P	370416	3715	374131	0.01603
ERR3199646_1_kneaddata_paired	Campylobacterota	8700	P	320549	6	320555	0.01374
ERR3199646_1_kneaddata_paired	Actinobacteriota	615	P	218267	793	219060	0.00939
ERR3199646_1_kneaddata_paired	Proteobacteria	22518	P	163167	330	163497	0.00701
ERR3199646_1_kneaddata_paired	Cyanobacteria	9876	P	127575	10254	137829	0.00591
ERR3199646_1_kneaddata_paired	Spirochaetota	32587	P	118085	72	118157	0.00506
ERR3199646_1_kneaddata_paired	Deferribacterota	10822	P	91330	394	91724	0.00393
ERR3199646_1_kneaddata_paired	Desulfobacterota_A	11509	P	62019	686	62705	0.00269
ERR3199646_1_kneaddata_paired	Firmicutes_B	17289	P	440	18	458	0.00002
ERR3199646_1_kneaddata_paired	Elusimicrobiota	11888	P	398	0	398	0.00002
ERR3199646_1_kneaddata_paired	Firmicutes_I	18140	P	385	0	385	0.00002
ERR3199646_1_kneaddata_paired	Firmicutes_C	17613	P	77	0	77	0.00000
ERR3199646_1_kneaddata_paired	Thermotogota	33086	P	14	0	14	0.00000
ERR3199647_1_kneaddata_paired	Bacteroidota	4587	P	19411961	91847	19503808	0.69179
ERR3199647_1_kneaddata_paired	Firmicutes_A	14608	P	5245398	63751	5309149	0.18831
ERR3199647_1_kneaddata_paired	Firmicutes	12188	P	1769569	24440	1794009	0.06363
ERR3199647_1_kneaddata_paired	Actinobacteriota	615	P	550122	1246	551368	0.01956
ERR3199647_1_kneaddata_paired	Campylobacterota	8700	P	303688	7	303695	0.01077
ERR3199647_1_kneaddata_paired	Deferribacterota	10822	P	211426	988	212414	0.00753
ERR3199647_1_kneaddata_paired	Proteobacteria	22518	P	205960	350	206310	0.00732
ERR3199647_1_kneaddata_paired	Desulfobacterota_A	11509	P	142764	1880	144644	0.00513
ERR3199647_1_kneaddata_paired	Spirochaetota	32587	P	107343	71	107414	0.00381
ERR3199647_1_kneaddata_paired	Cyanobacteria	9876	P	39974	3300	43274	0.00153
ERR3199647_1_kneaddata_paired	Verrucomicrobiota	33333	P	9754	145	9899	0.00035
ERR3199647_1_kneaddata_paired	Elusimicrobiota	11888	P	6271	0	6271	0.00022
ERR3199647_1_kneaddata_paired	Firmicutes_I	18140	P	436	0	436	0.00002
ERR3199647_1_kneaddata_paired	Firmicutes_B	17289	P	406	18	424	0.00002
ERR3199647_1_kneaddata_paired	Firmicutes_C	17613	P	48	0	48	0.00000
ERR3199647_1_kneaddata_paired	Thermotogota	33086	P	8	0	8	0.00000
ERR3199648_1_kneaddata_paired	Bacteroidota	4587	P	23358595	106534	23465129	0.76433
ERR3199648_1_kneaddata_paired	Firmicutes_A	14608	P	3992338	68548	4060886	0.13228
ERR3199648_1_kneaddata_paired	Spirochaetota	32587	P	808704	632	809336	0.02636
ERR3199648_1_kneaddata_paired	Verrucomicrobiota	33333	P	540090	7087	547177	0.01782
ERR3199648_1_kneaddata_paired	Firmicutes	12188	P	487562	7940	495502	0.01614
ERR3199648_1_kneaddata_paired	Campylobacterota	8700	P	304690	35	304725	0.00993
ERR3199648_1_kneaddata_paired	Proteobacteria	22518	P	273326	1283	274609	0.00894
ERR3199648_1_kneaddata_paired	Actinobacteriota	615	P	218964	628	219592	0.00715
ERR3199648_1_kneaddata_paired	Desulfobacterota_A	11509	P	159571	2355	161926	0.00527
ERR3199648_1_kneaddata_paired	Cyanobacteria	9876	P	151330	15778	167108	0.00544
ERR3199648_1_kneaddata_paired	Deferribacterota	10822	P	104573	582	105155	0.00343
ERR3199648_1_kneaddata_paired	Elusimicrobiota	11888	P	88062	0	88062	0.00287
ERR3199648_1_kneaddata_paired	Firmicutes_B	17289	P	561	29	590	0.00002
ERR3199648_1_kneaddata_paired	Firmicutes_I	18140	P	173	0	173	0.00001
ERR3199648_1_kneaddata_paired	Firmicutes_C	17613	P	78	0	78	0.00000
ERR3199648_1_kneaddata_paired	Thermotogota	33086	P	8	0	8	0.00000
ERR3199649_1_kneaddata_paired	Bacteroidota	4587	P	16052562	72812	16125374	0.55250
ERR3199649_1_kneaddata_paired	Firmicutes_A	14608	P	6030595	62208	6092803	0.20876
ERR3199649_1_kneaddata_paired	Spirochaetota	32587	P	1644259	968	1645227	0.05637
ERR3199649_1_kneaddata_paired	Verrucomicrobiota	33333	P	1193576	11628	1205204	0.04129
ERR3199649_1_kneaddata_paired	Campylobacterota	8700	P	1192261	32	1192293	0.04085
ERR3199649_1_kneaddata_paired	Desulfobacterota_A	11509	P	835457	7429	842886	0.02888
ERR3199649_1_kneaddata_paired	Deferribacterota	10822	P	640446	2686	643132	0.02204
ERR3199649_1_kneaddata_paired	Elusimicrobiota	11888	P	452573	0	452573	0.01551
ERR3199649_1_kneaddata_paired	Proteobacteria	22518	P	364432	1630	366062	0.01254
ERR3199649_1_kneaddata_paired	Actinobacteriota	615	P	310538	1036	311574	0.01068
ERR3199649_1_kneaddata_paired	Firmicutes	12188	P	213709	2639	216348	0.00741
ERR3199649_1_kneaddata_paired	Cyanobacteria	9876	P	85387	6143	91530	0.00314
ERR3199649_1_kneaddata_paired	Firmicutes_B	17289	P	909	36	945	0.00003
ERR3199649_1_kneaddata_paired	Firmicutes_I	18140	P	202	0	202	0.00001
ERR3199649_1_kneaddata_paired	Firmicutes_C	17613	P	124	0	124	0.00000
ERR3199649_1_kneaddata_paired	Thermotogota	33086	P	22	0	22	0.00000
ERR3199650_1_kneaddata_paired	Bacteroidota	4587	P	18256973	66642	18323615	0.63794
ERR3199650_1_kneaddata_paired	Firmicutes_A	14608	P	7127700	66097	7193797	0.25045
ERR3199650_1_kneaddata_paired	Firmicutes	12188	P	1070923	14583	1085506	0.03779
ERR3199650_1_kneaddata_paired	Desulfobacterota_A	11509	P	363729	4605	368334	0.01282
ERR3199650_1_kneaddata_paired	Actinobacteriota	615	P	354439	607	355046	0.01236
ERR3199650_1_kneaddata_paired	Verrucomicrobiota	33333	P	327399	3452	330851	0.01152
ERR3199650_1_kneaddata_paired	Spirochaetota	32587	P	313173	194	313367	0.01091
ERR3199650_1_kneaddata_paired	Proteobacteria	22518	P	277487	883	278370	0.00969
ERR3199650_1_kneaddata_paired	Campylobacterota	8700	P	276652	19	276671	0.00963
ERR3199650_1_kneaddata_paired	Cyanobacteria	9876	P	116426	9786	126212	0.00439
ERR3199650_1_kneaddata_paired	Elusimicrobiota	11888	P	43874	0	43874	0.00153
ERR3199650_1_kneaddata_paired	Deferribacterota	10822	P	26340	115	26455	0.00092
ERR3199650_1_kneaddata_paired	Firmicutes_B	17289	P	560	23	583	0.00002
ERR3199650_1_kneaddata_paired	Firmicutes_I	18140	P	488	0	488	0.00002
ERR3199650_1_kneaddata_paired	Firmicutes_C	17613	P	69	0	69	0.00000
ERR3199650_1_kneaddata_paired	Thermotogota	33086	P	17	0	17	0.00000
ERR3199651_1_kneaddata_paired	Bacteroidota	4587	P	13867516	44241	13911757	0.46558
ERR3199651_1_kneaddata_paired	Firmicutes_A	14608	P	11497655	87372	11585027	0.38771
ERR3199651_1_kneaddata_paired	Firmicutes	12188	P	1008987	21533	1030520	0.03449
ERR3199651_1_kneaddata_paired	Spirochaetota	32587	P	696298	332	696630	0.02331
ERR3199651_1_kneaddata_paired	Desulfobacterota_A	11509	P	668617	6173	674790	0.02258
ERR3199651_1_kneaddata_paired	Verrucomicrobiota	33333	P	635243	5105	640348	0.02143
ERR3199651_1_kneaddata_paired	Actinobacteriota	615	P	490619	691	491310	0.01644
ERR3199651_1_kneaddata_paired	Campylobacterota	8700	P	300385	5	300390	0.01005
ERR3199651_1_kneaddata_paired	Proteobacteria	22518	P	249363	2258	251621	0.00842
ERR3199651_1_kneaddata_paired	Cyanobacteria	9876	P	122398	7499	129897	0.00435
ERR3199651_1_kneaddata_paired	Elusimicrobiota	11888	P	92234	0	92234	0.00309
ERR3199651_1_kneaddata_paired	Deferribacterota	10822	P	73853	251	74104	0.00248
ERR3199651_1_kneaddata_paired	Firmicutes_B	17289	P	1324	43	1367	0.00005
ERR3199651_1_kneaddata_paired	Firmicutes_I	18140	P	266	0	266	0.00001
ERR3199651_1_kneaddata_paired	Firmicutes_C	17613	P	221	0	221	0.00001
ERR3199651_1_kneaddata_paired	Thermotogota	33086	P	21	0	21	0.00000
ERR3199652_1_kneaddata_paired	Bacteroidota	4587	P	19152458	91705	19244163	0.69499
ERR3199652_1_kneaddata_paired	Firmicutes_A	14608	P	5674140	51115	5725255	0.20676
ERR3199652_1_kneaddata_paired	Verrucomicrobiota	33333	P	815517	9866	825383	0.02981
ERR3199652_1_kneaddata_paired	Firmicutes	12188	P	777458	28755	806213	0.02912
ERR3199652_1_kneaddata_paired	Actinobacteriota	615	P	425621	847	426468	0.01540
ERR3199652_1_kneaddata_paired	Proteobacteria	22518	P	162968	953	163921	0.00592
ERR3199652_1_kneaddata_paired	Desulfobacterota_A	11509	P	145222	2019	147241	0.00532
ERR3199652_1_kneaddata_paired	Campylobacterota	8700	P	129182	13	129195	0.00467
ERR3199652_1_kneaddata_paired	Elusimicrobiota	11888	P	94454	0	94454	0.00341
ERR3199652_1_kneaddata_paired	Cyanobacteria	9876	P	77291	6147	83438	0.00301
ERR3199652_1_kneaddata_paired	Deferribacterota	10822	P	36618	186	36804	0.00133
ERR3199652_1_kneaddata_paired	Spirochaetota	32587	P	6182	5	6187	0.00022
ERR3199652_1_kneaddata_paired	Firmicutes_B	17289	P	757	36	793	0.00003
ERR3199652_1_kneaddata_paired	Firmicutes_I	18140	P	341	0	341	0.00001
ERR3199652_1_kneaddata_paired	Firmicutes_C	17613	P	148	0	148	0.00001
ERR3199652_1_kneaddata_paired	Thermotogota	33086	P	12	0	12	0.00000
ERR3199653_1_kneaddata_paired	Bacteroidota	4587	P	17858588	76798	17935386	0.62864
ERR3199653_1_kneaddata_paired	Firmicutes_A	14608	P	7273381	43231	7316612	0.25645
ERR3199653_1_kneaddata_paired	Verrucomicrobiota	33333	P	1233961	11818	1245779	0.04367
ERR3199653_1_kneaddata_paired	Firmicutes	12188	P	951951	7569	959520	0.03363
ERR3199653_1_kneaddata_paired	Actinobacteriota	615	P	237023	382	237405	0.00832
ERR3199653_1_kneaddata_paired	Desulfobacterota_A	11509	P	203403	2315	205718	0.00721
ERR3199653_1_kneaddata_paired	Proteobacteria	22518	P	189111	2188	191299	0.00671
ERR3199653_1_kneaddata_paired	Campylobacterota	8700	P	168662	4	168666	0.00591
ERR3199653_1_kneaddata_paired	Cyanobacteria	9876	P	131384	9028	140412	0.00492
ERR3199653_1_kneaddata_paired	Elusimicrobiota	11888	P	73640	0	73640	0.00258
ERR3199653_1_kneaddata_paired	Spirochaetota	32587	P	28969	17	28986	0.00102
ERR3199653_1_kneaddata_paired	Deferribacterota	10822	P	25414	103	25517	0.00089
ERR3199653_1_kneaddata_paired	Firmicutes_I	18140	P	585	0	585	0.00002
ERR3199653_1_kneaddata_paired	Firmicutes_B	17289	P	547	21	568	0.00002
ERR3199653_1_kneaddata_paired	Firmicutes_C	17613	P	155	0	155	0.00001
ERR3199653_1_kneaddata_paired	Thermotogota	33086	P	33	0	33	0.00000
ERR3199654_1_kneaddata_paired	Bacteroidota	4587	P	18253870	67657	18321527	0.59517
ERR3199654_1_kneaddata_paired	Firmicutes_A	14608	P	9367470	130714	9498184	0.30855
ERR3199654_1_kneaddata_paired	Campylobacterota	8700	P	576391	49	576440	0.01873
ERR3199654_1_kneaddata_paired	Spirochaetota	32587	P	448097	285	448382	0.01457
ERR3199654_1_kneaddata_paired	Verrucomicrobiota	33333	P	358285	3869	362154	0.01176
ERR3199654_1_kneaddata_paired	Deferribacterota	10822	P	324242	1469	325711	0.01058
ERR3199654_1_kneaddata_paired	Desulfobacterota_A	11509	P	316883	4008	320891	0.01042
ERR3199654_1_kneaddata_paired	Firmicutes	12188	P	248941	3524	252465	0.00820
ERR3199654_1_kneaddata_paired	Actinobacteriota	615	P	198899	394	199293	0.00647
ERR3199654_1_kneaddata_paired	Proteobacteria	22518	P	188125	866	188991	0.00614
ERR3199654_1_kneaddata_paired	Cyanobacteria	9876	P	169787	14110	183897	0.00597
ERR3199654_1_kneaddata_paired	Elusimicrobiota	11888	P	104344	0	104344	0.00339
ERR3199654_1_kneaddata_paired	Firmicutes_B	17289	P	835	36	871	0.00003
ERR3199654_1_kneaddata_paired	Firmicutes_I	18140	P	196	0	196	0.00001
ERR3199654_1_kneaddata_paired	Firmicutes_C	17613	P	129	0	129	0.00000
ERR3199654_1_kneaddata_paired	Thermotogota	33086	P	17	0	17	0.00000
ERR3199655_1_kneaddata_paired	Bacteroidota	4587	P	18942439	75380	19017819	0.62154
ERR3199655_1_kneaddata_paired	Firmicutes_A	14608	P	8335204	69486	8404690	0.27468
ERR3199655_1_kneaddata_paired	Firmicutes	12188	P	1213786	26451	1240237	0.04053
ERR3199655_1_kneaddata_paired	Actinobacteriota	615	P	1131652	1592	1133244	0.03704
ERR3199655_1_kneaddata_paired	Spirochaetota	32587	P	224463	136	224599	0.00734
ERR3199655_1_kneaddata_paired	Proteobacteria	22518	P	145917	287	146204	0.00478
ERR3199655_1_kneaddata_paired	Campylobacterota	8700	P	136873	34	136907	0.00447
ERR3199655_1_kneaddata_paired	Desulfobacterota_A	11509	P	125691	1795	127486	0.00417
ERR3199655_1_kneaddata_paired	Verrucomicrobiota	33333	P	66220	688	66908	0.00219
ERR3199655_1_kneaddata_paired	Elusimicrobiota	11888	P	37646	0	37646	0.00123
ERR3199655_1_kneaddata_paired	Deferribacterota	10822	P	35223	151	35374	0.00116
ERR3199655_1_kneaddata_paired	Cyanobacteria	9876	P	23232	1251	24483	0.00080
ERR3199655_1_kneaddata_paired	Firmicutes_I	18140	P	1498	0	1498	0.00005
ERR3199655_1_kneaddata_paired	Firmicutes_B	17289	P	508	20	528	0.00002
ERR3199655_1_kneaddata_paired	Firmicutes_C	17613	P	79	0	79	0.00000
ERR3199655_1_kneaddata_paired	Thermotogota	33086	P	12	0	12	0.00000
ERR3199656_1_kneaddata_paired	Bacteroidota	4587	P	17107452	92916	17200368	0.61163
ERR3199656_1_kneaddata_paired	Firmicutes_A	14608	P	8484662	71198	8555860	0.30424
ERR3199656_1_kneaddata_paired	Firmicutes	12188	P	1335119	13891	1349010	0.04797
ERR3199656_1_kneaddata_paired	Spirochaetota	32587	P	276930	197	277127	0.00985
ERR3199656_1_kneaddata_paired	Campylobacterota	8700	P	197434	43	197477	0.00702
ERR3199656_1_kneaddata_paired	Verrucomicrobiota	33333	P	166198	2055	168253	0.00598
ERR3199656_1_kneaddata_paired	Desulfobacterota_A	11509	P	123434	2478	125912	0.00448
ERR3199656_1_kneaddata_paired	Actinobacteriota	615	P	94011	471	94482	0.00336
ERR3199656_1_kneaddata_paired	Deferribacterota	10822	P	70738	358	71096	0.00253
ERR3199656_1_kneaddata_paired	Proteobacteria	22518	P	65636	198	65834	0.00234
ERR3199656_1_kneaddata_paired	Cyanobacteria	9876	P	13597	872	14469	0.00051
ERR3199656_1_kneaddata_paired	Firmicutes_B	17289	P	1107	53	1160	0.00004
ERR3199656_1_kneaddata_paired	Elusimicrobiota	11888	P	727	0	727	0.00003
ERR3199656_1_kneaddata_paired	Firmicutes_I	18140	P	237	0	237	0.00001
ERR3199656_1_kneaddata_paired	Firmicutes_C	17613	P	119	0	119	0.00000
ERR3199656_1_kneaddata_paired	Thermotogota	33086	P	3	0	3	0.00000
ERR3199657_1_kneaddata_paired	Bacteroidota	4587	P	22206242	103036	22309278	0.74776
ERR3199657_1_kneaddata_paired	Firmicutes_A	14608	P	4140737	42256	4182993	0.14020
ERR3199657_1_kneaddata_paired	Firmicutes	12188	P	1441895	29445	1471340	0.04932
ERR3199657_1_kneaddata_paired	Actinobacteriota	615	P	925277	1655	926932	0.03107
ERR3199657_1_kneaddata_paired	Campylobacterota	8700	P	273307	67	273374	0.00916
ERR3199657_1_kneaddata_paired	Proteobacteria	22518	P	203061	371	203432	0.00682
ERR3199657_1_kneaddata_paired	Desulfobacterota_A	11509	P	136241	2021	138262	0.00463
ERR3199657_1_kneaddata_paired	Cyanobacteria	9876	P	122963	11294	134257	0.00450
ERR3199657_1_kneaddata_paired	Verrucomicrobiota	33333	P	73884	912	74796	0.00251
ERR3199657_1_kneaddata_paired	Spirochaetota	32587	P	63935	45	63980	0.00214
ERR3199657_1_kneaddata_paired	Deferribacterota	10822	P	29626	147	29773	0.00100
ERR3199657_1_kneaddata_paired	Elusimicrobiota	11888	P	24927	0	24927	0.00084
ERR3199657_1_kneaddata_paired	Firmicutes_I	18140	P	1050	0	1050	0.00004
ERR3199657_1_kneaddata_paired	Firmicutes_B	17289	P	394	18	412	0.00001
ERR3199657_1_kneaddata_paired	Firmicutes_C	17613	P	33	0	33	0.00000
ERR3199657_1_kneaddata_paired	Thermotogota	33086	P	8	0	8	0.00000
ERR3199658_1_kneaddata_paired	Bacteroidota	4587	P	14566735	63122	14629857	0.59130
ERR3199658_1_kneaddata_paired	Firmicutes_A	14608	P	5497788	53246	5551034	0.22436
ERR3199658_1_kneaddata_paired	Verrucomicrobiota	33333	P	1776056	17036	1793092	0.07247
ERR3199658_1_kneaddata_paired	Firmicutes	12188	P	721315	10368	731683	0.02957
ERR3199658_1_kneaddata_paired	Proteobacteria	22518	P	431867	3399	435266	0.01759
ERR3199658_1_kneaddata_paired	Elusimicrobiota	11888	P	428118	0	428118	0.01730
ERR3199658_1_kneaddata_paired	Actinobacteriota	615	P	293857	603	294460	0.01190
ERR3199658_1_kneaddata_paired	Spirochaetota	32587	P	243617	140	243757	0.00985
ERR3199658_1_kneaddata_paired	Campylobacterota	8700	P	233734	5	233739	0.00945
ERR3199658_1_kneaddata_paired	Cyanobacteria	9876	P	185879	13846	199725	0.00807
ERR3199658_1_kneaddata_paired	Desulfobacterota_A	11509	P	155018	1502	156520	0.00633
ERR3199658_1_kneaddata_paired	Deferribacterota	10822	P	42925	174	43099	0.00174
ERR3199658_1_kneaddata_paired	Firmicutes_B	17289	P	759	29	788	0.00003
ERR3199658_1_kneaddata_paired	Firmicutes_I	18140	P	404	0	404	0.00002
ERR3199658_1_kneaddata_paired	Firmicutes_C	17613	P	186	0	186	0.00001
ERR3199658_1_kneaddata_paired	Thermotogota	33086	P	33	0	33	0.00000
ERR3199659_1_kneaddata_paired	Bacteroidota	4587	P	18986000	68617	19054617	0.65615
ERR3199659_1_kneaddata_paired	Firmicutes_A	14608	P	4642413	31594	4674007	0.16095
ERR3199659_1_kneaddata_paired	Verrucomicrobiota	33333	P	2188723	19883	2208606	0.07605
ERR3199659_1_kneaddata_paired	Firmicutes	12188	P	1118041	15073	1133114	0.03902
ERR3199659_1_kneaddata_paired	Proteobacteria	22518	P	673254	11927	685181	0.02359
ERR3199659_1_kneaddata_paired	Actinobacteriota	615	P	432210	715	432925	0.01491
ERR3199659_1_kneaddata_paired	Elusimicrobiota	11888	P	296307	0	296307	0.01020
ERR3199659_1_kneaddata_paired	Cyanobacteria	9876	P	232410	15495	247905	0.00854
ERR3199659_1_kneaddata_paired	Spirochaetota	32587	P	125689	69	125758	0.00433
ERR3199659_1_kneaddata_paired	Desulfobacterota_A	11509	P	123097	1215	124312	0.00428
ERR3199659_1_kneaddata_paired	Campylobacterota	8700	P	48165	9	48174	0.00166
ERR3199659_1_kneaddata_paired	Deferribacterota	10822	P	6575	24	6599	0.00023
ERR3199659_1_kneaddata_paired	Firmicutes_B	17289	P	1383	50	1433	0.00005
ERR3199659_1_kneaddata_paired	Firmicutes_I	18140	P	895	0	895	0.00003
ERR3199659_1_kneaddata_paired	Firmicutes_C	17613	P	139	0	139	0.00000
ERR3199659_1_kneaddata_paired	Thermotogota	33086	P	88	0	88	0.00000
ERR3199660_1_kneaddata_paired	Bacteroidota	4587	P	7412647	27244	7439891	0.43305
ERR3199660_1_kneaddata_paired	Firmicutes_A	14608	P	3569929	22536	3592465	0.20911
ERR3199660_1_kneaddata_paired	Verrucomicrobiota	33333	P	3430348	26395	3456743	0.20121
ERR3199660_1_kneaddata_paired	Firmicutes	12188	P	563423	16852	580275	0.03378
ERR3199660_1_kneaddata_paired	Proteobacteria	22518	P	520237	403	520640	0.03030
ERR3199660_1_kneaddata_paired	Elusimicrobiota	11888	P	399083	0	399083	0.02323
ERR3199660_1_kneaddata_paired	Campylobacterota	8700	P	300288	116	300404	0.01749
ERR3199660_1_kneaddata_paired	Desulfobacterota_A	11509	P	271529	1690	273219	0.01590
ERR3199660_1_kneaddata_paired	Spirochaetota	32587	P	264619	123	264742	0.01541
ERR3199660_1_kneaddata_paired	Actinobacteriota	615	P	209981	515	210496	0.01225
ERR3199660_1_kneaddata_paired	Cyanobacteria	9876	P	99785	6116	105901	0.00616
ERR3199660_1_kneaddata_paired	Deferribacterota	10822	P	35207	116	35323	0.00206
ERR3199660_1_kneaddata_paired	Firmicutes_B	17289	P	636	20	656	0.00004
ERR3199660_1_kneaddata_paired	Firmicutes_I	18140	P	225	0	225	0.00001
ERR3199660_1_kneaddata_paired	Firmicutes_C	17613	P	100	0	100	0.00001
ERR3199660_1_kneaddata_paired	Thermotogota	33086	P	10	0	10	0.00000
ERR3199661_1_kneaddata_paired	Bacteroidota	4587	P	18816962	80645	18897607	0.61659
ERR3199661_1_kneaddata_paired	Firmicutes_A	14608	P	7688750	67913	7756663	0.25309
ERR3199661_1_kneaddata_paired	Firmicutes	12188	P	1329214	19494	1348708	0.04401
ERR3199661_1_kneaddata_paired	Actinobacteriota	615	P	716379	1329	717708	0.02342
ERR3199661_1_kneaddata_paired	Verrucomicrobiota	33333	P	531849	5694	537543	0.01754
ERR3199661_1_kneaddata_paired	Campylobacterota	8700	P	412119	7	412126	0.01345
ERR3199661_1_kneaddata_paired	Desulfobacterota_A	11509	P	273343	3516	276859	0.00903
ERR3199661_1_kneaddata_paired	Proteobacteria	22518	P	214456	2179	216635	0.00707
ERR3199661_1_kneaddata_paired	Spirochaetota	32587	P	180145	116	180261	0.00588
ERR3199661_1_kneaddata_paired	Deferribacterota	10822	P	138938	633	139571	0.00455
ERR3199661_1_kneaddata_paired	Cyanobacteria	9876	P	122031	9461	131492	0.00429
ERR3199661_1_kneaddata_paired	Elusimicrobiota	11888	P	31544	0	31544	0.00103
ERR3199661_1_kneaddata_paired	Firmicutes_B	17289	P	1000	43	1043	0.00003
ERR3199661_1_kneaddata_paired	Firmicutes_I	18140	P	402	0	402	0.00001
ERR3199661_1_kneaddata_paired	Firmicutes_C	17613	P	160	0	160	0.00001
ERR3199661_1_kneaddata_paired	Thermotogota	33086	P	14	0	14	0.00000
ERR3199662_1_kneaddata_paired	Bacteroidota	4587	P	8550907	38942	8589849	0.42490
ERR3199662_1_kneaddata_paired	Firmicutes_A	14608	P	5146537	22756	5169293	0.25570
ERR3199662_1_kneaddata_paired	Verrucomicrobiota	33333	P	3135662	23030	3158692	0.15624
ERR3199662_1_kneaddata_paired	Firmicutes	12188	P	665492	19836	685328	0.03390
ERR3199662_1_kneaddata_paired	Campylobacterota	8700	P	657149	77	657226	0.03251
ERR3199662_1_kneaddata_paired	Elusimicrobiota	11888	P	633609	0	633609	0.03134
ERR3199662_1_kneaddata_paired	Desulfobacterota_A	11509	P	343128	2458	345586	0.01709
ERR3199662_1_kneaddata_paired	Actinobacteriota	615	P	331140	628	331768	0.01641
ERR3199662_1_kneaddata_paired	Proteobacteria	22518	P	308950	130	309080	0.01529
ERR3199662_1_kneaddata_paired	Spirochaetota	32587	P	238502	106	238608	0.01180
ERR3199662_1_kneaddata_paired	Cyanobacteria	9876	P	54993	2785	57778	0.00286
ERR3199662_1_kneaddata_paired	Deferribacterota	10822	P	37871	117	37988	0.00188
ERR3199662_1_kneaddata_paired	Firmicutes_B	17289	P	759	22	781	0.00004
ERR3199662_1_kneaddata_paired	Firmicutes_I	18140	P	658	0	658	0.00003
ERR3199662_1_kneaddata_paired	Firmicutes_C	17613	P	126	0	126	0.00001
ERR3199662_1_kneaddata_paired	Thermotogota	33086	P	14	0	14	0.00000
ERR3199663_1_kneaddata_paired	Bacteroidota	4587	P	23939774	102095	24041869	0.77093
ERR3199663_1_kneaddata_paired	Firmicutes_A	14608	P	2883812	25928	2909740	0.09330
ERR3199663_1_kneaddata_paired	Verrucomicrobiota	33333	P	1278283	14169	1292452	0.04144
ERR3199663_1_kneaddata_paired	Firmicutes	12188	P	1180806	37277	1218083	0.03906
ERR3199663_1_kneaddata_paired	Actinobacteriota	615	P	816196	1271	817467	0.02621
ERR3199663_1_kneaddata_paired	Proteobacteria	22518	P	311481	1109	312590	0.01002
ERR3199663_1_kneaddata_paired	Cyanobacteria	9876	P	173640	15458	189098	0.00606
ERR3199663_1_kneaddata_paired	Spirochaetota	32587	P	135591	93	135684	0.00435
ERR3199663_1_kneaddata_paired	Elusimicrobiota	11888	P	133772	0	133772	0.00429
ERR3199663_1_kneaddata_paired	Desulfobacterota_A	11509	P	73878	932	74810	0.00240
ERR3199663_1_kneaddata_paired	Campylobacterota	8700	P	48079	2	48081	0.00154
ERR3199663_1_kneaddata_paired	Deferribacterota	10822	P	10766	50	10816	0.00035
ERR3199663_1_kneaddata_paired	Firmicutes_B	17289	P	452	20	472	0.00002
ERR3199663_1_kneaddata_paired	Firmicutes_I	18140	P	362	0	362	0.00001
ERR3199663_1_kneaddata_paired	Firmicutes_C	17613	P	54	0	54	0.00000
ERR3199663_1_kneaddata_paired	Thermotogota	33086	P	4	0	4	0.00000
ERR3199664_1_kneaddata_paired	Bacteroidota	4587	P	21319321	67052	21386373	0.69515
ERR3199664_1_kneaddata_paired	Firmicutes_A	14608	P	4898777	53400	4952177	0.16097
ERR3199664_1_kneaddata_paired	Firmicutes	12188	P	1209200	47487	1256687	0.04085
ERR3199664_1_kneaddata_paired	Verrucomicrobiota	33333	P	999181	9373	1008554	0.03278
ERR3199664_1_kneaddata_paired	Actinobacteriota	615	P	612584	907	613491	0.01994
ERR3199664_1_kneaddata_paired	Spirochaetota	32587	P	453727	251	453978	0.01476
ERR3199664_1_kneaddata_paired	Campylobacterota	8700	P	442996	56	443052	0.01440
ERR3199664_1_kneaddata_paired	Proteobacteria	22518	P	291184	555	291739	0.00948
ERR3199664_1_kneaddata_paired	Desulfobacterota_A	11509	P	134863	1378	136241	0.00443
ERR3199664_1_kneaddata_paired	Cyanobacteria	9876	P	90172	6437	96609	0.00314
ERR3199664_1_kneaddata_paired	Deferribacterota	10822	P	79877	314	80191	0.00261
ERR3199664_1_kneaddata_paired	Elusimicrobiota	11888	P	44816	0	44816	0.00146
ERR3199664_1_kneaddata_paired	Firmicutes_I	18140	P	469	0	469	0.00002
ERR3199664_1_kneaddata_paired	Firmicutes_B	17289	P	458	17	475	0.00002
ERR3199664_1_kneaddata_paired	Firmicutes_C	17613	P	57	0	57	0.00000
ERR3199664_1_kneaddata_paired	Thermotogota	33086	P	9	0	9	0.00000
ERR3199665_1_kneaddata_paired	Bacteroidota	4587	P	18139270	74409	18213679	0.65352
ERR3199665_1_kneaddata_paired	Firmicutes_A	14608	P	4743573	41798	4785371	0.17170
ERR3199665_1_kneaddata_paired	Actinobacteriota	615	P	1467978	2031	1470009	0.05274
ERR3199665_1_kneaddata_paired	Firmicutes	12188	P	1413912	35227	1449139	0.05200
ERR3199665_1_kneaddata_paired	Verrucomicrobiota	33333	P	1247186	12608	1259794	0.04520
ERR3199665_1_kneaddata_paired	Proteobacteria	22518	P	242237	614	242851	0.00871
ERR3199665_1_kneaddata_paired	Spirochaetota	32587	P	139405	83	139488	0.00500
ERR3199665_1_kneaddata_paired	Desulfobacterota_A	11509	P	133143	1351	134494	0.00483
ERR3199665_1_kneaddata_paired	Cyanobacteria	9876	P	76929	6130	83059	0.00298
ERR3199665_1_kneaddata_paired	Elusimicrobiota	11888	P	36166	0	36166	0.00130
ERR3199665_1_kneaddata_paired	Deferribacterota	10822	P	29568	125	29693	0.00107
ERR3199665_1_kneaddata_paired	Campylobacterota	8700	P	25454	1	25455	0.00091
ERR3199665_1_kneaddata_paired	Firmicutes_B	17289	P	504	20	524	0.00002
ERR3199665_1_kneaddata_paired	Firmicutes_I	18140	P	399	0	399	0.00001
ERR3199665_1_kneaddata_paired	Firmicutes_C	17613	P	48	0	48	0.00000
ERR3199665_1_kneaddata_paired	Thermotogota	33086	P	25	0	25	0.00000
ERR3199666_1_kneaddata_paired	Bacteroidota	4587	P	18650060	69935	18719995	0.65763
ERR3199666_1_kneaddata_paired	Firmicutes_A	14608	P	5419291	60405	5479696	0.19250
ERR3199666_1_kneaddata_paired	Verrucomicrobiota	33333	P	1886183	18262	1904445	0.06690
ERR3199666_1_kneaddata_paired	Actinobacteriota	615	P	735326	995	736321	0.02587
ERR3199666_1_kneaddata_paired	Firmicutes	12188	P	565581	6226	571807	0.02009
ERR3199666_1_kneaddata_paired	Campylobacterota	8700	P	273320	23	273343	0.00960
ERR3199666_1_kneaddata_paired	Proteobacteria	22518	P	233732	2004	235736	0.00828
ERR3199666_1_kneaddata_paired	Desulfobacterota_A	11509	P	198490	2096	200586	0.00705
ERR3199666_1_kneaddata_paired	Elusimicrobiota	11888	P	141140	0	141140	0.00496
ERR3199666_1_kneaddata_paired	Cyanobacteria	9876	P	133051	9909	142960	0.00502
ERR3199666_1_kneaddata_paired	Spirochaetota	32587	P	30924	18	30942	0.00109
ERR3199666_1_kneaddata_paired	Deferribacterota	10822	P	27843	114	27957	0.00098
ERR3199666_1_kneaddata_paired	Firmicutes_B	17289	P	459	18	477	0.00002
ERR3199666_1_kneaddata_paired	Firmicutes_I	18140	P	247	0	247	0.00001
ERR3199666_1_kneaddata_paired	Firmicutes_C	17613	P	209	0	209	0.00001
ERR3199666_1_kneaddata_paired	Thermotogota	33086	P	15	0	15	0.00000
ERR3199667_1_kneaddata_paired	Bacteroidota	4587	P	14356305	64960	14421265	0.54748
ERR3199667_1_kneaddata_paired	Firmicutes_A	14608	P	8536562	62564	8599126	0.32645
ERR3199667_1_kneaddata_paired	Firmicutes	12188	P	1478410	14903	1493313	0.05669
ERR3199667_1_kneaddata_paired	Verrucomicrobiota	33333	P	455201	4218	459419	0.01744
ERR3199667_1_kneaddata_paired	Actinobacteriota	615	P	393741	571	394312	0.01497
ERR3199667_1_kneaddata_paired	Desulfobacterota_A	11509	P	392957	4390	397347	0.01508
ERR3199667_1_kneaddata_paired	Campylobacterota	8700	P	229149	4	229153	0.00870
ERR3199667_1_kneaddata_paired	Cyanobacteria	9876	P	138487	10390	148877	0.00565
ERR3199667_1_kneaddata_paired	Proteobacteria	22518	P	84667	222	84889	0.00322
ERR3199667_1_kneaddata_paired	Spirochaetota	32587	P	70455	40	70495	0.00268
ERR3199667_1_kneaddata_paired	Deferribacterota	10822	P	39383	155	39538	0.00150
ERR3199667_1_kneaddata_paired	Elusimicrobiota	11888	P	2105	0	2105	0.00008
ERR3199667_1_kneaddata_paired	Firmicutes_B	17289	P	539	20	559	0.00002
ERR3199667_1_kneaddata_paired	Firmicutes_I	18140	P	388	0	388	0.00001
ERR3199667_1_kneaddata_paired	Firmicutes_C	17613	P	164	0	164	0.00001
ERR3199667_1_kneaddata_paired	Thermotogota	33086	P	31	0	31	0.00000
ERR3199668_1_kneaddata_paired	Bacteroidota	4587	P	21953007	97686	22050693	0.72261
ERR3199668_1_kneaddata_paired	Firmicutes_A	14608	P	3535133	47032	3582165	0.11739
ERR3199668_1_kneaddata_paired	Verrucomicrobiota	33333	P	2423850	20157	2444007	0.08009
ERR3199668_1_kneaddata_paired	Firmicutes	12188	P	890795	12710	903505	0.02961
ERR3199668_1_kneaddata_paired	Proteobacteria	22518	P	511664	4728	516392	0.01692
ERR3199668_1_kneaddata_paired	Actinobacteriota	615	P	369936	530	370466	0.01214
ERR3199668_1_kneaddata_paired	Spirochaetota	32587	P	206064	103	206167	0.00676
ERR3199668_1_kneaddata_paired	Cyanobacteria	9876	P	177191	10800	187991	0.00616
ERR3199668_1_kneaddata_paired	Campylobacterota	8700	P	95607	6	95613	0.00313
ERR3199668_1_kneaddata_paired	Desulfobacterota_A	11509	P	77055	848	77903	0.00255
ERR3199668_1_kneaddata_paired	Elusimicrobiota	11888	P	63171	0	63171	0.00207
ERR3199668_1_kneaddata_paired	Deferribacterota	10822	P	16341	57	16398	0.00054
ERR3199668_1_kneaddata_paired	Firmicutes_B	17289	P	489	16	505	0.00002
ERR3199668_1_kneaddata_paired	Firmicutes_C	17613	P	222	0	222	0.00001
ERR3199668_1_kneaddata_paired	Firmicutes_I	18140	P	206	0	206	0.00001
ERR3199668_1_kneaddata_paired	Thermotogota	33086	P	6	0	6	0.00000
ERR3199669_1_kneaddata_paired	Bacteroidota	4587	P	4248551	14437	4262988	0.43942
ERR3199669_1_kneaddata_paired	Firmicutes_A	14608	P	1736367	9558	1745925	0.17997
ERR3199669_1_kneaddata_paired	Verrucomicrobiota	33333	P	1071773	6739	1078512	0.11117
ERR3199669_1_kneaddata_paired	Firmicutes	12188	P	782572	20351	802923	0.08276
ERR3199669_1_kneaddata_paired	Proteobacteria	22518	P	584979	476	585455	0.06035
ERR3199669_1_kneaddata_paired	Actinobacteriota	615	P	294244	520	294764	0.03038
ERR3199669_1_kneaddata_paired	Campylobacterota	8700	P	282402	92	282494	0.02912
ERR3199669_1_kneaddata_paired	Desulfobacterota_A	11509	P	217687	969	218656	0.02254
ERR3199669_1_kneaddata_paired	Elusimicrobiota	11888	P	149527	0	149527	0.01541
ERR3199669_1_kneaddata_paired	Spirochaetota	32587	P	141464	53	141517	0.01459
ERR3199669_1_kneaddata_paired	Cyanobacteria	9876	P	109126	5398	114524	0.01181
ERR3199669_1_kneaddata_paired	Deferribacterota	10822	P	23386	62	23448	0.00242
ERR3199669_1_kneaddata_paired	Firmicutes_B	17289	P	357	9	366	0.00004
ERR3199669_1_kneaddata_paired	Firmicutes_I	18140	P	201	0	201	0.00002
ERR3199669_1_kneaddata_paired	Firmicutes_C	17613	P	51	0	51	0.00001
ERR3199669_1_kneaddata_paired	Thermotogota	33086	P	3	0	3	0.00000
ERR3199670_1_kneaddata_paired	Bacteroidota	4587	P	19266335	85700	19352035	0.71090
ERR3199670_1_kneaddata_paired	Firmicutes_A	14608	P	4169244	47702	4216946	0.15491
ERR3199670_1_kneaddata_paired	Firmicutes	12188	P	932471	8521	940992	0.03457
ERR3199670_1_kneaddata_paired	Spirochaetota	32587	P	684554	438	684992	0.02516
ERR3199670_1_kneaddata_paired	Verrucomicrobiota	33333	P	622069	6636	628705	0.02310
ERR3199670_1_kneaddata_paired	Actinobacteriota	615	P	354854	777	355631	0.01306
ERR3199670_1_kneaddata_paired	Cyanobacteria	9876	P	293996	25518	319514	0.01174
ERR3199670_1_kneaddata_paired	Campylobacterota	8700	P	259383	124	259507	0.00953
ERR3199670_1_kneaddata_paired	Proteobacteria	22518	P	242612	645	243257	0.00894
ERR3199670_1_kneaddata_paired	Elusimicrobiota	11888	P	124566	0	124566	0.00458
ERR3199670_1_kneaddata_paired	Desulfobacterota_A	11509	P	66221	911	67132	0.00247
ERR3199670_1_kneaddata_paired	Deferribacterota	10822	P	27753	126	27879	0.00102
ERR3199670_1_kneaddata_paired	Firmicutes_I	18140	P	258	0	258	0.00001
ERR3199670_1_kneaddata_paired	Firmicutes_B	17289	P	235	10	245	0.00001
ERR3199670_1_kneaddata_paired	Firmicutes_C	17613	P	111	0	111	0.00000
ERR3199670_1_kneaddata_paired	Thermotogota	33086	P	6	0	6	0.00000
ERR3199671_1_kneaddata_paired	Bacteroidota	4587	P	15345070	73833	15418903	0.56365
ERR3199671_1_kneaddata_paired	Firmicutes_A	14608	P	8645800	46845	8692645	0.31776
ERR3199671_1_kneaddata_paired	Verrucomicrobiota	33333	P	1220325	11433	1231758	0.04503
ERR3199671_1_kneaddata_paired	Firmicutes	12188	P	726861	4047	730908	0.02672
ERR3199671_1_kneaddata_paired	Desulfobacterota_A	11509	P	395147	4394	399541	0.01461
ERR3199671_1_kneaddata_paired	Proteobacteria	22518	P	257907	268	258175	0.00944
ERR3199671_1_kneaddata_paired	Campylobacterota	8700	P	245069	7	245076	0.00896
ERR3199671_1_kneaddata_paired	Actinobacteriota	615	P	201744	432	202176	0.00739
ERR3199671_1_kneaddata_paired	Spirochaetota	32587	P	87525	49	87574	0.00320
ERR3199671_1_kneaddata_paired	Cyanobacteria	9876	P	49006	3202	52208	0.00191
ERR3199671_1_kneaddata_paired	Deferribacterota	10822	P	35014	138	35152	0.00129
ERR3199671_1_kneaddata_paired	Firmicutes_B	17289	P	1018	38	1056	0.00004
ERR3199671_1_kneaddata_paired	Firmicutes_I	18140	P	188	0	188	0.00001
ERR3199671_1_kneaddata_paired	Firmicutes_C	17613	P	147	0	147	0.00001
ERR3199671_1_kneaddata_paired	Elusimicrobiota	11888	P	61	0	61	0.00000
ERR3199671_1_kneaddata_paired	Thermotogota	33086	P	23	0	23	0.00000
ERR3199672_1_kneaddata_paired	Bacteroidota	4587	P	21266000	77093	21343093	0.77473
ERR3199672_1_kneaddata_paired	Firmicutes_A	14608	P	2874701	39502	2914203	0.10578
ERR3199672_1_kneaddata_paired	Firmicutes	12188	P	1034301	27481	1061782	0.03854
ERR3199672_1_kneaddata_paired	Verrucomicrobiota	33333	P	752339	8196	760535	0.02761
ERR3199672_1_kneaddata_paired	Actinobacteriota	615	P	444504	800	445304	0.01616
ERR3199672_1_kneaddata_paired	Proteobacteria	22518	P	295685	517	296202	0.01075
ERR3199672_1_kneaddata_paired	Spirochaetota	32587	P	285851	185	286036	0.01038
ERR3199672_1_kneaddata_paired	Campylobacterota	8700	P	205552	78	205630	0.00746
ERR3199672_1_kneaddata_paired	Desulfobacterota_A	11509	P	143424	1572	144996	0.00526
ERR3199672_1_kneaddata_paired	Cyanobacteria	9876	P	59148	3806	62954	0.00229
ERR3199672_1_kneaddata_paired	Deferribacterota	10822	P	14918	68	14986	0.00054
ERR3199672_1_kneaddata_paired	Elusimicrobiota	11888	P	12601	0	12601	0.00046
ERR3199672_1_kneaddata_paired	Firmicutes_B	17289	P	337	14	351	0.00001
ERR3199672_1_kneaddata_paired	Firmicutes_I	18140	P	327	0	327	0.00001
ERR3199672_1_kneaddata_paired	Firmicutes_C	17613	P	33	0	33	0.00000
ERR3199672_1_kneaddata_paired	Thermotogota	33086	P	5	0	5	0.00000
ERR3199673_1_kneaddata_paired	Bacteroidota	4587	P	17392234	65654	17457888	0.62590
ERR3199673_1_kneaddata_paired	Firmicutes_A	14608	P	6408166	41691	6449857	0.23124
ERR3199673_1_kneaddata_paired	Firmicutes	12188	P	1273082	17250	1290332	0.04626
ERR3199673_1_kneaddata_paired	Verrucomicrobiota	33333	P	733357	7531	740888	0.02656
ERR3199673_1_kneaddata_paired	Spirochaetota	32587	P	518568	311	518879	0.01860
ERR3199673_1_kneaddata_paired	Proteobacteria	22518	P	296623	1827	298450	0.01070
ERR3199673_1_kneaddata_paired	Cyanobacteria	9876	P	293507	24410	317917	0.01140
ERR3199673_1_kneaddata_paired	Actinobacteriota	615	P	262716	414	263130	0.00943
ERR3199673_1_kneaddata_paired	Campylobacterota	8700	P	216966	91	217057	0.00778
ERR3199673_1_kneaddata_paired	Desulfobacterota_A	11509	P	199561	2114	201675	0.00723
ERR3199673_1_kneaddata_paired	Elusimicrobiota	11888	P	85102	0	85102	0.00305
ERR3199673_1_kneaddata_paired	Deferribacterota	10822	P	50146	214	50360	0.00181
ERR3199673_1_kneaddata_paired	Firmicutes_I	18140	P	518	0	518	0.00002
ERR3199673_1_kneaddata_paired	Firmicutes_B	17289	P	454	18	472	0.00002
ERR3199673_1_kneaddata_paired	Firmicutes_C	17613	P	118	0	118	0.00000
ERR3199673_1_kneaddata_paired	Thermotogota	33086	P	26	0	26	0.00000
ERR3199674_1_kneaddata_paired	Bacteroidota	4587	P	16266976	65817	16332793	0.55859
ERR3199674_1_kneaddata_paired	Firmicutes_A	14608	P	6757576	64595	6822171	0.23332
ERR3199674_1_kneaddata_paired	Verrucomicrobiota	33333	P	3551017	20739	3571756	0.12216
ERR3199674_1_kneaddata_paired	Spirochaetota	32587	P	625962	221	626183	0.02142
ERR3199674_1_kneaddata_paired	Elusimicrobiota	11888	P	606256	0	606256	0.02073
ERR3199674_1_kneaddata_paired	Desulfobacterota_A	11509	P	320803	2208	323011	0.01105
ERR3199674_1_kneaddata_paired	Cyanobacteria	9876	P	310561	11435	321996	0.01101
ERR3199674_1_kneaddata_paired	Proteobacteria	22518	P	290159	4582	294741	0.01008
ERR3199674_1_kneaddata_paired	Actinobacteriota	615	P	125785	332	126117	0.00431
ERR3199674_1_kneaddata_paired	Firmicutes	12188	P	114832	792	115624	0.00395
ERR3199674_1_kneaddata_paired	Deferribacterota	10822	P	74075	186	74261	0.00254
ERR3199674_1_kneaddata_paired	Campylobacterota	8700	P	22628	3	22631	0.00077
ERR3199674_1_kneaddata_paired	Firmicutes_B	17289	P	1175	28	1203	0.00004
ERR3199674_1_kneaddata_paired	Firmicutes_I	18140	P	364	0	364	0.00001
ERR3199674_1_kneaddata_paired	Firmicutes_C	17613	P	261	0	261	0.00001
ERR3199674_1_kneaddata_paired	Thermotogota	33086	P	43	0	43	0.00000
ERR3199675_1_kneaddata_paired	Bacteroidota	4587	P	22411889	102790	22514679	0.76160
ERR3199675_1_kneaddata_paired	Firmicutes_A	14608	P	2590787	38054	2628841	0.08893
ERR3199675_1_kneaddata_paired	Verrucomicrobiota	33333	P	1134605	16482	1151087	0.03894
ERR3199675_1_kneaddata_paired	Proteobacteria	22518	P	842430	18893	861323	0.02914
ERR3199675_1_kneaddata_paired	Actinobacteriota	615	P	715301	1336	716637	0.02424
ERR3199675_1_kneaddata_paired	Firmicutes	12188	P	693474	9140	702614	0.02377
ERR3199675_1_kneaddata_paired	Cyanobacteria	9876	P	309138	25567	334705	0.01132
ERR3199675_1_kneaddata_paired	Elusimicrobiota	11888	P	267166	0	267166	0.00904
ERR3199675_1_kneaddata_paired	Desulfobacterota_A	11509	P	169474	2586	172060	0.00582
ERR3199675_1_kneaddata_paired	Campylobacterota	8700	P	129815	46	129861	0.00439
ERR3199675_1_kneaddata_paired	Spirochaetota	32587	P	59657	52	59709	0.00202
ERR3199675_1_kneaddata_paired	Deferribacterota	10822	P	22682	138	22820	0.00077
ERR3199675_1_kneaddata_paired	Firmicutes_B	17289	P	353	20	373	0.00001
ERR3199675_1_kneaddata_paired	Firmicutes_I	18140	P	178	0	178	0.00001
ERR3199675_1_kneaddata_paired	Firmicutes_C	17613	P	81	0	81	0.00000
ERR3199675_1_kneaddata_paired	Thermotogota	33086	P	14	0	14	0.00000
ERR3199676_1_kneaddata_paired	Bacteroidota	4587	P	20410256	90074	20500330	0.77118
ERR3199676_1_kneaddata_paired	Firmicutes_A	14608	P	3183859	59682	3243541	0.12201
ERR3199676_1_kneaddata_paired	Verrucomicrobiota	33333	P	1010351	11114	1021465	0.03843
ERR3199676_1_kneaddata_paired	Firmicutes	12188	P	734552	8483	743035	0.02795
ERR3199676_1_kneaddata_paired	Spirochaetota	32587	P	217148	143	217291	0.00817
ERR3199676_1_kneaddata_paired	Campylobacterota	8700	P	178907	31	178938	0.00673
ERR3199676_1_kneaddata_paired	Actinobacteriota	615	P	163576	414	163990	0.00617
ERR3199676_1_kneaddata_paired	Proteobacteria	22518	P	159672	844	160516	0.00604
ERR3199676_1_kneaddata_paired	Deferribacterota	10822	P	127964	601	128565	0.00484
ERR3199676_1_kneaddata_paired	Cyanobacteria	9876	P	102066	8771	110837	0.00417
ERR3199676_1_kneaddata_paired	Desulfobacterota_A	11509	P	76282	1069	77351	0.00291
ERR3199676_1_kneaddata_paired	Elusimicrobiota	11888	P	36663	0	36663	0.00138
ERR3199676_1_kneaddata_paired	Firmicutes_B	17289	P	452	20	472	0.00002
ERR3199676_1_kneaddata_paired	Firmicutes_I	18140	P	151	0	151	0.00001
ERR3199676_1_kneaddata_paired	Firmicutes_C	17613	P	64	0	64	0.00000
ERR3199676_1_kneaddata_paired	Thermotogota	33086	P	4	0	4	0.00000
ERR3199677_1_kneaddata_paired	Bacteroidota	4587	P	18341099	64872	18405971	0.65897
ERR3199677_1_kneaddata_paired	Firmicutes_A	14608	P	4111239	31786	4143025	0.14833
ERR3199677_1_kneaddata_paired	Firmicutes	12188	P	1858434	49307	1907741	0.06830
ERR3199677_1_kneaddata_paired	Verrucomicrobiota	33333	P	1559578	14092	1573670	0.05634
ERR3199677_1_kneaddata_paired	Actinobacteriota	615	P	875663	1123	876786	0.03139
ERR3199677_1_kneaddata_paired	Proteobacteria	22518	P	381644	2898	384542	0.01377
ERR3199677_1_kneaddata_paired	Cyanobacteria	9876	P	151627	10080	161707	0.00579
ERR3199677_1_kneaddata_paired	Desulfobacterota_A	11509	P	134016	1413	135429	0.00485
ERR3199677_1_kneaddata_paired	Campylobacterota	8700	P	121814	3	121817	0.00436
ERR3199677_1_kneaddata_paired	Spirochaetota	32587	P	109415	59	109474	0.00392
ERR3199677_1_kneaddata_paired	Elusimicrobiota	11888	P	91880	0	91880	0.00329
ERR3199677_1_kneaddata_paired	Deferribacterota	10822	P	18327	69	18396	0.00066
ERR3199677_1_kneaddata_paired	Firmicutes_I	18140	P	479	0	479	0.00002
ERR3199677_1_kneaddata_paired	Firmicutes_B	17289	P	442	16	458	0.00002
ERR3199677_1_kneaddata_paired	Firmicutes_C	17613	P	101	0	101	0.00000
ERR3199677_1_kneaddata_paired	Thermotogota	33086	P	7	0	7	0.00000
ERR3199678_1_kneaddata_paired	Bacteroidota	4587	P	21719531	108227	21827758	0.81911
ERR3199678_1_kneaddata_paired	Firmicutes_A	14608	P	2691065	29038	2720103	0.10207
ERR3199678_1_kneaddata_paired	Verrucomicrobiota	33333	P	450271	6091	456362	0.01713
ERR3199678_1_kneaddata_paired	Spirochaetota	32587	P	386555	313	386868	0.01452
ERR3199678_1_kneaddata_paired	Firmicutes	12188	P	383826	7266	391092	0.01468
ERR3199678_1_kneaddata_paired	Proteobacteria	22518	P	313024	5558	318582	0.01196
ERR3199678_1_kneaddata_paired	Campylobacterota	8700	P	200768	90	200858	0.00754
ERR3199678_1_kneaddata_paired	Desulfobacterota_A	11509	P	105011	1529	106540	0.00400
ERR3199678_1_kneaddata_paired	Actinobacteriota	615	P	99103	303	99406	0.00373
ERR3199678_1_kneaddata_paired	Cyanobacteria	9876	P	77780	8433	86213	0.00324
ERR3199678_1_kneaddata_paired	Elusimicrobiota	11888	P	41470	0	41470	0.00156
ERR3199678_1_kneaddata_paired	Deferribacterota	10822	P	12313	70	12383	0.00046
ERR3199678_1_kneaddata_paired	Firmicutes_B	17289	P	289	15	304	0.00001
ERR3199678_1_kneaddata_paired	Firmicutes_I	18140	P	231	0	231	0.00001
ERR3199678_1_kneaddata_paired	Firmicutes_C	17613	P	47	0	47	0.00000
ERR3199678_1_kneaddata_paired	Thermotogota	33086	P	9	0	9	0.00000
ERR3199679_1_kneaddata_paired	Bacteroidota	4587	P	23305993	138764	23444757	0.74482
ERR3199679_1_kneaddata_paired	Firmicutes_A	14608	P	5444340	39628	5483968	0.17422
ERR3199679_1_kneaddata_paired	Firmicutes	12188	P	956119	18254	974373	0.03096
ERR3199679_1_kneaddata_paired	Actinobacteriota	615	P	420343	1289	421632	0.01339
ERR3199679_1_kneaddata_paired	Proteobacteria	22518	P	282621	2458	285079	0.00906
ERR3199679_1_kneaddata_paired	Elusimicrobiota	11888	P	219738	0	219738	0.00698
ERR3199679_1_kneaddata_paired	Desulfobacterota_A	11509	P	208666	3674	212340	0.00675
ERR3199679_1_kneaddata_paired	Verrucomicrobiota	33333	P	193273	2703	195976	0.00623
ERR3199679_1_kneaddata_paired	Campylobacterota	8700	P	130878	31	130909	0.00416
ERR3199679_1_kneaddata_paired	Cyanobacteria	9876	P	46632	3715	50347	0.00160
ERR3199679_1_kneaddata_paired	Spirochaetota	32587	P	38413	32	38445	0.00122
ERR3199679_1_kneaddata_paired	Deferribacterota	10822	P	18061	104	18165	0.00058
ERR3199679_1_kneaddata_paired	Firmicutes_B	17289	P	525	29	554	0.00002
ERR3199679_1_kneaddata_paired	Firmicutes_I	18140	P	511	0	511	0.00002
ERR3199679_1_kneaddata_paired	Firmicutes_C	17613	P	80	0	80	0.00000
ERR3199679_1_kneaddata_paired	Thermotogota	33086	P	14	0	14	0.00000
ERR3199680_1_kneaddata_paired	Bacteroidota	4587	P	15622344	74313	15696657	0.55937
ERR3199680_1_kneaddata_paired	Firmicutes_A	14608	P	4150242	24159	4174401	0.14876
ERR3199680_1_kneaddata_paired	Verrucomicrobiota	33333	P	3749854	27622	3777476	0.13462
ERR3199680_1_kneaddata_paired	Proteobacteria	22518	P	1895848	1510	1897358	0.06762
ERR3199680_1_kneaddata_paired	Elusimicrobiota	11888	P	796579	0	796579	0.02839
ERR3199680_1_kneaddata_paired	Cyanobacteria	9876	P	474923	27217	502140	0.01789
ERR3199680_1_kneaddata_paired	Actinobacteriota	615	P	383747	538	384285	0.01369
ERR3199680_1_kneaddata_paired	Firmicutes	12188	P	375905	4190	380095	0.01355
ERR3199680_1_kneaddata_paired	Campylobacterota	8700	P	187397	42	187439	0.00668
ERR3199680_1_kneaddata_paired	Spirochaetota	32587	P	114998	51	115049	0.00410
ERR3199680_1_kneaddata_paired	Deferribacterota	10822	P	85402	268	85670	0.00305
ERR3199680_1_kneaddata_paired	Desulfobacterota_A	11509	P	62454	658	63112	0.00225
ERR3199680_1_kneaddata_paired	Firmicutes_B	17289	P	457	13	470	0.00002
ERR3199680_1_kneaddata_paired	Firmicutes_I	18140	P	268	0	268	0.00001
ERR3199680_1_kneaddata_paired	Firmicutes_C	17613	P	173	0	173	0.00001
ERR3199680_1_kneaddata_paired	Thermotogota	33086	P	21	0	21	0.00000
ERR3199681_1_kneaddata_paired	Bacteroidota	4587	P	13174382	54599	13228981	0.52019
ERR3199681_1_kneaddata_paired	Firmicutes_A	14608	P	4072030	18427	4090457	0.16085
ERR3199681_1_kneaddata_paired	Verrucomicrobiota	33333	P	2062103	13487	2075590	0.08162
ERR3199681_1_kneaddata_paired	Elusimicrobiota	11888	P	1749967	0	1749967	0.06881
ERR3199681_1_kneaddata_paired	Firmicutes	12188	P	1536744	6639	1543383	0.06069
ERR3199681_1_kneaddata_paired	Cyanobacteria	9876	P	1145281	58142	1203423	0.04732
ERR3199681_1_kneaddata_paired	Proteobacteria	22518	P	891830	866	892696	0.03510
ERR3199681_1_kneaddata_paired	Spirochaetota	32587	P	270494	107	270601	0.01064
ERR3199681_1_kneaddata_paired	Actinobacteriota	615	P	137824	282	138106	0.00543
ERR3199681_1_kneaddata_paired	Campylobacterota	8700	P	101653	2	101655	0.00400
ERR3199681_1_kneaddata_paired	Deferribacterota	10822	P	90176	249	90425	0.00356
ERR3199681_1_kneaddata_paired	Desulfobacterota_A	11509	P	42365	418	42783	0.00168
ERR3199681_1_kneaddata_paired	Firmicutes_B	17289	P	1717	45	1762	0.00007
ERR3199681_1_kneaddata_paired	Firmicutes_I	18140	P	679	0	679	0.00003
ERR3199681_1_kneaddata_paired	Firmicutes_C	17613	P	378	0	378	0.00001
ERR3199681_1_kneaddata_paired	Thermotogota	33086	P	65	0	65	0.00000
ERR3199682_1_kneaddata_paired	Bacteroidota	4587	P	17820381	81055	17901436	0.66992
ERR3199682_1_kneaddata_paired	Firmicutes_A	14608	P	5587734	52763	5640497	0.21108
ERR3199682_1_kneaddata_paired	Firmicutes	12188	P	991503	6622	998125	0.03735
ERR3199682_1_kneaddata_paired	Verrucomicrobiota	33333	P	977423	9539	986962	0.03693
ERR3199682_1_kneaddata_paired	Actinobacteriota	615	P	436182	971	437153	0.01636
ERR3199682_1_kneaddata_paired	Desulfobacterota_A	11509	P	145939	1666	147605	0.00552
ERR3199682_1_kneaddata_paired	Campylobacterota	8700	P	143792	14	143806	0.00538
ERR3199682_1_kneaddata_paired	Spirochaetota	32587	P	137665	81	137746	0.00515
ERR3199682_1_kneaddata_paired	Proteobacteria	22518	P	103836	601	104437	0.00391
ERR3199682_1_kneaddata_paired	Deferribacterota	10822	P	98416	410	98826	0.00370
ERR3199682_1_kneaddata_paired	Cyanobacteria	9876	P	72284	5588	77872	0.00291
ERR3199682_1_kneaddata_paired	Elusimicrobiota	11888	P	45996	0	45996	0.00172
ERR3199682_1_kneaddata_paired	Firmicutes_B	17289	P	1025	40	1065	0.00004
ERR3199682_1_kneaddata_paired	Firmicutes_I	18140	P	192	0	192	0.00001
ERR3199682_1_kneaddata_paired	Firmicutes_C	17613	P	53	0	53	0.00000
ERR3199682_1_kneaddata_paired	Thermotogota	33086	P	11	0	11	0.00000
ERR3199683_1_kneaddata_paired	Bacteroidota	4587	P	13297037	50337	13347374	0.51315
ERR3199683_1_kneaddata_paired	Firmicutes_A	14608	P	8946957	52193	8999150	0.34598
ERR3199683_1_kneaddata_paired	Firmicutes	12188	P	1604740	17640	1622380	0.06237
ERR3199683_1_kneaddata_paired	Verrucomicrobiota	33333	P	1006036	9148	1015184	0.03903
ERR3199683_1_kneaddata_paired	Actinobacteriota	615	P	330991	502	331493	0.01274
ERR3199683_1_kneaddata_paired	Proteobacteria	22518	P	205526	742	206268	0.00793
ERR3199683_1_kneaddata_paired	Desulfobacterota_A	11509	P	147035	1641	148676	0.00572
ERR3199683_1_kneaddata_paired	Cyanobacteria	9876	P	136269	9005	145274	0.00559
ERR3199683_1_kneaddata_paired	Campylobacterota	8700	P	123930	13	123943	0.00477
ERR3199683_1_kneaddata_paired	Deferribacterota	10822	P	34649	134	34783	0.00134
ERR3199683_1_kneaddata_paired	Elusimicrobiota	11888	P	34244	0	34244	0.00132
ERR3199683_1_kneaddata_paired	Spirochaetota	32587	P	797	1	798	0.00003
ERR3199683_1_kneaddata_paired	Firmicutes_B	17289	P	546	20	566	0.00002
ERR3199683_1_kneaddata_paired	Firmicutes_I	18140	P	408	0	408	0.00002
ERR3199683_1_kneaddata_paired	Firmicutes_C	17613	P	165	0	165	0.00001
ERR3199683_1_kneaddata_paired	Thermotogota	33086	P	20	0	20	0.00000
ERR3199684_1_kneaddata_paired	Bacteroidota	4587	P	12799948	53726	12853674	0.44719
ERR3199684_1_kneaddata_paired	Firmicutes_A	14608	P	11357110	71024	11428134	0.39760
ERR3199684_1_kneaddata_paired	Campylobacterota	8700	P	965840	63	965903	0.03360
ERR3199684_1_kneaddata_paired	Deferribacterota	10822	P	798236	3557	801793	0.02790
ERR3199684_1_kneaddata_paired	Desulfobacterota_A	11509	P	771793	9392	781185	0.02718
ERR3199684_1_kneaddata_paired	Verrucomicrobiota	33333	P	546847	5758	552605	0.01923
ERR3199684_1_kneaddata_paired	Firmicutes	12188	P	494043	6590	500633	0.01742
ERR3199684_1_kneaddata_paired	Spirochaetota	32587	P	330944	208	331152	0.01152
ERR3199684_1_kneaddata_paired	Proteobacteria	22518	P	199201	2172	201373	0.00701
ERR3199684_1_kneaddata_paired	Actinobacteriota	615	P	191071	441	191512	0.00666
ERR3199684_1_kneaddata_paired	Elusimicrobiota	11888	P	79546	0	79546	0.00277
ERR3199684_1_kneaddata_paired	Cyanobacteria	9876	P	50061	3720	53781	0.00187
ERR3199684_1_kneaddata_paired	Firmicutes_B	17289	P	1048	44	1092	0.00004
ERR3199684_1_kneaddata_paired	Firmicutes_I	18140	P	450	0	450	0.00002
ERR3199684_1_kneaddata_paired	Firmicutes_C	17613	P	216	0	216	0.00001
ERR3199684_1_kneaddata_paired	Thermotogota	33086	P	16	0	16	0.00000
ERR3199685_1_kneaddata_paired	Bacteroidota	4587	P	21238831	94207	21333038	0.71001
ERR3199685_1_kneaddata_paired	Firmicutes_A	14608	P	5592071	55623	5647694	0.18797
ERR3199685_1_kneaddata_paired	Spirochaetota	32587	P	1147674	885	1148559	0.03823
ERR3199685_1_kneaddata_paired	Firmicutes	12188	P	465002	9707	474709	0.01580
ERR3199685_1_kneaddata_paired	Verrucomicrobiota	33333	P	252690	3296	255986	0.00852
ERR3199685_1_kneaddata_paired	Campylobacterota	8700	P	218446	15	218461	0.00727
ERR3199685_1_kneaddata_paired	Proteobacteria	22518	P	216362	328	216690	0.00721
ERR3199685_1_kneaddata_paired	Desulfobacterota_A	11509	P	198610	3209	201819	0.00672
ERR3199685_1_kneaddata_paired	Actinobacteriota	615	P	195753	707	196460	0.00654
ERR3199685_1_kneaddata_paired	Cyanobacteria	9876	P	170979	18030	189009	0.00629
ERR3199685_1_kneaddata_paired	Elusimicrobiota	11888	P	83331	0	83331	0.00277
ERR3199685_1_kneaddata_paired	Deferribacterota	10822	P	78553	431	78984	0.00263
ERR3199685_1_kneaddata_paired	Firmicutes_B	17289	P	846	44	890	0.00003
ERR3199685_1_kneaddata_paired	Firmicutes_I	18140	P	158	0	158	0.00001
ERR3199685_1_kneaddata_paired	Firmicutes_C	17613	P	94	0	94	0.00000
ERR3199685_1_kneaddata_paired	Thermotogota	33086	P	13	0	13	0.00000
ERR3199686_1_kneaddata_paired	Firmicutes_A	14608	P	17770774	166084	17936858	0.61395
ERR3199686_1_kneaddata_paired	Bacteroidota	4587	P	8340534	22162	8362696	0.28624
ERR3199686_1_kneaddata_paired	Spirochaetota	32587	P	1104868	413	1105281	0.03783
ERR3199686_1_kneaddata_paired	Firmicutes	12188	P	776931	5084	782015	0.02677
ERR3199686_1_kneaddata_paired	Actinobacteriota	615	P	324265	406	324671	0.01111
ERR3199686_1_kneaddata_paired	Desulfobacterota_A	11509	P	237504	1820	239324	0.00819
ERR3199686_1_kneaddata_paired	Cyanobacteria	9876	P	131008	6400	137408	0.00470
ERR3199686_1_kneaddata_paired	Proteobacteria	22518	P	93351	346	93697	0.00321
ERR3199686_1_kneaddata_paired	Campylobacterota	8700	P	83711	1	83712	0.00287
ERR3199686_1_kneaddata_paired	Deferribacterota	10822	P	78304	208	78512	0.00269
ERR3199686_1_kneaddata_paired	Verrucomicrobiota	33333	P	67948	445	68393	0.00234
ERR3199686_1_kneaddata_paired	Firmicutes_B	17289	P	1765	44	1809	0.00006
ERR3199686_1_kneaddata_paired	Elusimicrobiota	11888	P	679	0	679	0.00002
ERR3199686_1_kneaddata_paired	Firmicutes_I	18140	P	220	0	220	0.00001
ERR3199686_1_kneaddata_paired	Firmicutes_C	17613	P	142	0	142	0.00000
ERR3199686_1_kneaddata_paired	Thermotogota	33086	P	35	0	35	0.00000
ERR3199687_1_kneaddata_paired	Bacteroidota	4587	P	21966976	89385	22056361	0.72859
ERR3199687_1_kneaddata_paired	Firmicutes_A	14608	P	3824559	44714	3869273	0.12781
ERR3199687_1_kneaddata_paired	Verrucomicrobiota	33333	P	1266138	14579	1280717	0.04231
ERR3199687_1_kneaddata_paired	Firmicutes	12188	P	1126159	22772	1148931	0.03795
ERR3199687_1_kneaddata_paired	Actinobacteriota	615	P	587617	1049	588666	0.01945
ERR3199687_1_kneaddata_paired	Proteobacteria	22518	P	472143	3192	475335	0.01570
ERR3199687_1_kneaddata_paired	Spirochaetota	32587	P	360619	245	360864	0.01192
ERR3199687_1_kneaddata_paired	Campylobacterota	8700	P	119823	4	119827	0.00396
ERR3199687_1_kneaddata_paired	Desulfobacterota_A	11509	P	117480	1583	119063	0.00393
ERR3199687_1_kneaddata_paired	Cyanobacteria	9876	P	114694	10222	124916	0.00413
ERR3199687_1_kneaddata_paired	Elusimicrobiota	11888	P	98102	0	98102	0.00324
ERR3199687_1_kneaddata_paired	Deferribacterota	10822	P	29157	140	29297	0.00097
ERR3199687_1_kneaddata_paired	Firmicutes_B	17289	P	639	29	668	0.00002
ERR3199687_1_kneaddata_paired	Firmicutes_I	18140	P	598	0	598	0.00002
ERR3199687_1_kneaddata_paired	Firmicutes_C	17613	P	108	0	108	0.00000
ERR3199687_1_kneaddata_paired	Thermotogota	33086	P	14	0	14	0.00000
ERR3199688_1_kneaddata_paired	Bacteroidota	4587	P	19600399	72757	19673156	0.62380
ERR3199688_1_kneaddata_paired	Firmicutes_A	14608	P	7561232	64939	7626171	0.24181
ERR3199688_1_kneaddata_paired	Firmicutes	12188	P	1179533	14457	1193990	0.03786
ERR3199688_1_kneaddata_paired	Actinobacteriota	615	P	867332	1324	868656	0.02754
ERR3199688_1_kneaddata_paired	Campylobacterota	8700	P	751726	101	751827	0.02384
ERR3199688_1_kneaddata_paired	Desulfobacterota_A	11509	P	750189	9515	759704	0.02409
ERR3199688_1_kneaddata_paired	Proteobacteria	22518	P	164552	202	164754	0.00522
ERR3199688_1_kneaddata_paired	Verrucomicrobiota	33333	P	138397	1410	139807	0.00443
ERR3199688_1_kneaddata_paired	Cyanobacteria	9876	P	130807	9575	140382	0.00445
ERR3199688_1_kneaddata_paired	Spirochaetota	32587	P	123044	72	123116	0.00390
ERR3199688_1_kneaddata_paired	Deferribacterota	10822	P	56073	233	56306	0.00179
ERR3199688_1_kneaddata_paired	Elusimicrobiota	11888	P	38087	0	38087	0.00121
ERR3199688_1_kneaddata_paired	Firmicutes_B	17289	P	769	30	799	0.00003
ERR3199688_1_kneaddata_paired	Firmicutes_I	18140	P	712	0	712	0.00002
ERR3199688_1_kneaddata_paired	Firmicutes_C	17613	P	85	0	85	0.00000
ERR3199688_1_kneaddata_paired	Thermotogota	33086	P	10	0	10	0.00000
ERR3199689_1_kneaddata_paired	Bacteroidota	4587	P	11308784	50615	11359399	0.48803
ERR3199689_1_kneaddata_paired	Firmicutes_A	14608	P	9160430	48227	9208657	0.39562
ERR3199689_1_kneaddata_paired	Firmicutes	12188	P	1476952	16041	1492993	0.06414
ERR3199689_1_kneaddata_paired	Spirochaetota	32587	P	371921	236	372157	0.01599
ERR3199689_1_kneaddata_paired	Actinobacteriota	615	P	234632	693	235325	0.01011
ERR3199689_1_kneaddata_paired	Desulfobacterota_A	11509	P	187777	3539	191316	0.00822
ERR3199689_1_kneaddata_paired	Campylobacterota	8700	P	164939	11	164950	0.00709
ERR3199689_1_kneaddata_paired	Verrucomicrobiota	33333	P	113712	1214	114926	0.00494
ERR3199689_1_kneaddata_paired	Proteobacteria	22518	P	69558	160	69718	0.00300
ERR3199689_1_kneaddata_paired	Cyanobacteria	9876	P	33525	2047	35572	0.00153
ERR3199689_1_kneaddata_paired	Deferribacterota	10822	P	18712	83	18795	0.00081
ERR3199689_1_kneaddata_paired	Elusimicrobiota	11888	P	11418	0	11418	0.00049
ERR3199689_1_kneaddata_paired	Firmicutes_B	17289	P	594	25	619	0.00003
ERR3199689_1_kneaddata_paired	Firmicutes_I	18140	P	253	0	253	0.00001
ERR3199689_1_kneaddata_paired	Firmicutes_C	17613	P	108	0	108	0.00000
ERR3199689_1_kneaddata_paired	Thermotogota	33086	P	20	0	20	0.00000
ERR3199690_1_kneaddata_paired	Bacteroidota	4587	P	22219748	93070	22312818	0.72358
ERR3199690_1_kneaddata_paired	Firmicutes_A	14608	P	4820684	64316	4885000	0.15842
ERR3199690_1_kneaddata_paired	Verrucomicrobiota	33333	P	1061751	10318	1072069	0.03477
ERR3199690_1_kneaddata_paired	Firmicutes	12188	P	698023	19545	717568	0.02327
ERR3199690_1_kneaddata_paired	Spirochaetota	32587	P	501894	293	502187	0.01629
ERR3199690_1_kneaddata_paired	Actinobacteriota	615	P	374322	663	374985	0.01216
ERR3199690_1_kneaddata_paired	Campylobacterota	8700	P	277262	18	277280	0.00899
ERR3199690_1_kneaddata_paired	Proteobacteria	22518	P	245183	2470	247653	0.00803
ERR3199690_1_kneaddata_paired	Cyanobacteria	9876	P	154295	11289	165584	0.00537
ERR3199690_1_kneaddata_paired	Desulfobacterota_A	11509	P	128153	1468	129621	0.00420
ERR3199690_1_kneaddata_paired	Elusimicrobiota	11888	P	106616	0	106616	0.00346
ERR3199690_1_kneaddata_paired	Deferribacterota	10822	P	43787	181	43968	0.00143
ERR3199690_1_kneaddata_paired	Firmicutes_B	17289	P	760	30	790	0.00003
ERR3199690_1_kneaddata_paired	Firmicutes_I	18140	P	250	0	250	0.00001
ERR3199690_1_kneaddata_paired	Firmicutes_C	17613	P	165	0	165	0.00001
ERR3199690_1_kneaddata_paired	Thermotogota	33086	P	4	0	4	0.00000
ERR3199691_1_kneaddata_paired	Bacteroidota	4587	P	17283162	77000	17360162	0.60892
ERR3199691_1_kneaddata_paired	Firmicutes_A	14608	P	8274344	108274	8382618	0.29403
ERR3199691_1_kneaddata_paired	Firmicutes	12188	P	635944	8523	644467	0.02261
ERR3199691_1_kneaddata_paired	Campylobacterota	8700	P	482757	62	482819	0.01694
ERR3199691_1_kneaddata_paired	Spirochaetota	32587	P	475877	269	476146	0.01670
ERR3199691_1_kneaddata_paired	Actinobacteriota	615	P	410661	901	411562	0.01444
ERR3199691_1_kneaddata_paired	Verrucomicrobiota	33333	P	200678	1940	202618	0.00711
ERR3199691_1_kneaddata_paired	Deferribacterota	10822	P	146885	591	147476	0.00517
ERR3199691_1_kneaddata_paired	Proteobacteria	22518	P	131935	406	132341	0.00464
ERR3199691_1_kneaddata_paired	Desulfobacterota_A	11509	P	127574	1567	129141	0.00453
ERR3199691_1_kneaddata_paired	Cyanobacteria	9876	P	74574	5507	80081	0.00281
ERR3199691_1_kneaddata_paired	Elusimicrobiota	11888	P	59266	0	59266	0.00208
ERR3199691_1_kneaddata_paired	Firmicutes_B	17289	P	696	26	722	0.00003
ERR3199691_1_kneaddata_paired	Firmicutes_I	18140	P	224	0	224	0.00001
ERR3199691_1_kneaddata_paired	Firmicutes_C	17613	P	97	0	97	0.00000
ERR3199691_1_kneaddata_paired	Thermotogota	33086	P	12	0	12	0.00000
ERR3199692_1_kneaddata_paired	Bacteroidota	4587	P	6225946	31942	6257888	0.40457
ERR3199692_1_kneaddata_paired	Firmicutes_A	14608	P	3609859	13795	3623654	0.23427
ERR3199692_1_kneaddata_paired	Verrucomicrobiota	33333	P	3187746	20951	3208697	0.20744
ERR3199692_1_kneaddata_paired	Firmicutes	12188	P	492636	4052	496688	0.03211
ERR3199692_1_kneaddata_paired	Campylobacterota	8700	P	473236	47	473283	0.03060
ERR3199692_1_kneaddata_paired	Proteobacteria	22518	P	420060	142	420202	0.02717
ERR3199692_1_kneaddata_paired	Desulfobacterota_A	11509	P	394901	2322	397223	0.02568
ERR3199692_1_kneaddata_paired	Actinobacteriota	615	P	235916	829	236745	0.01531
ERR3199692_1_kneaddata_paired	Elusimicrobiota	11888	P	158944	0	158944	0.01028
ERR3199692_1_kneaddata_paired	Deferribacterota	10822	P	123013	346	123359	0.00798
ERR3199692_1_kneaddata_paired	Spirochaetota	32587	P	56253	22	56275	0.00364
ERR3199692_1_kneaddata_paired	Cyanobacteria	9876	P	13618	348	13966	0.00090
ERR3199692_1_kneaddata_paired	Firmicutes_B	17289	P	733	19	752	0.00005
ERR3199692_1_kneaddata_paired	Firmicutes_I	18140	P	246	0	246	0.00002
ERR3199692_1_kneaddata_paired	Firmicutes_C	17613	P	149	0	149	0.00001
ERR3199692_1_kneaddata_paired	Thermotogota	33086	P	27	0	27	0.00000
ERR3199693_1_kneaddata_paired	Bacteroidota	4587	P	20084155	89808	20173963	0.69941
ERR3199693_1_kneaddata_paired	Firmicutes_A	14608	P	3090394	30200	3120594	0.10819
ERR3199693_1_kneaddata_paired	Firmicutes	12188	P	2078237	27489	2105726	0.07300
ERR3199693_1_kneaddata_paired	Actinobacteriota	615	P	1396437	2189	1398626	0.04849
ERR3199693_1_kneaddata_paired	Verrucomicrobiota	33333	P	758295	9701	767996	0.02663
ERR3199693_1_kneaddata_paired	Spirochaetota	32587	P	633349	480	633829	0.02197
ERR3199693_1_kneaddata_paired	Proteobacteria	22518	P	230029	2289	232318	0.00805
ERR3199693_1_kneaddata_paired	Desulfobacterota_A	11509	P	152292	2096	154388	0.00535
ERR3199693_1_kneaddata_paired	Cyanobacteria	9876	P	110124	10137	120261	0.00417
ERR3199693_1_kneaddata_paired	Campylobacterota	8700	P	92652	18	92670	0.00321
ERR3199693_1_kneaddata_paired	Deferribacterota	10822	P	33737	181	33918	0.00118
ERR3199693_1_kneaddata_paired	Elusimicrobiota	11888	P	9044	0	9044	0.00031
ERR3199693_1_kneaddata_paired	Firmicutes_I	18140	P	599	0	599	0.00002
ERR3199693_1_kneaddata_paired	Firmicutes_B	17289	P	370	19	389	0.00001
ERR3199693_1_kneaddata_paired	Firmicutes_C	17613	P	40	0	40	0.00000
ERR3199693_1_kneaddata_paired	Thermotogota	33086	P	34	0	34	0.00000
ERR3199694_1_kneaddata_paired	Bacteroidota	4587	P	14671322	61146	14732468	0.55491
ERR3199694_1_kneaddata_paired	Firmicutes_A	14608	P	7746551	39377	7785928	0.29326
ERR3199694_1_kneaddata_paired	Spirochaetota	32587	P	1594338	823	1595161	0.06008
ERR3199694_1_kneaddata_paired	Firmicutes	12188	P	1232459	16063	1248522	0.04703
ERR3199694_1_kneaddata_paired	Actinobacteriota	615	P	331857	680	332537	0.01253
ERR3199694_1_kneaddata_paired	Desulfobacterota_A	11509	P	223320	3030	226350	0.00853
ERR3199694_1_kneaddata_paired	Verrucomicrobiota	33333	P	204281	1796	206077	0.00776
ERR3199694_1_kneaddata_paired	Proteobacteria	22518	P	202243	280	202523	0.00763
ERR3199694_1_kneaddata_paired	Elusimicrobiota	11888	P	103435	0	103435	0.00390
ERR3199694_1_kneaddata_paired	Deferribacterota	10822	P	64345	236	64581	0.00243
ERR3199694_1_kneaddata_paired	Campylobacterota	8700	P	26200	15	26215	0.00099
ERR3199694_1_kneaddata_paired	Cyanobacteria	9876	P	22205	1162	23367	0.00088
ERR3199694_1_kneaddata_paired	Firmicutes_B	17289	P	843	29	872	0.00003
ERR3199694_1_kneaddata_paired	Firmicutes_C	17613	P	819	1	820	0.00003
ERR3199694_1_kneaddata_paired	Firmicutes_I	18140	P	464	0	464	0.00002
ERR3199694_1_kneaddata_paired	Thermotogota	33086	P	7	0	7	0.00000
ERR3199695_1_kneaddata_paired	Bacteroidota	4587	P	16746218	92482	16838700	0.61594
ERR3199695_1_kneaddata_paired	Firmicutes_A	14608	P	6105994	32860	6138854	0.22455
ERR3199695_1_kneaddata_paired	Verrucomicrobiota	33333	P	1412332	15327	1427659	0.05222
ERR3199695_1_kneaddata_paired	Firmicutes	12188	P	1028036	10595	1038631	0.03799
ERR3199695_1_kneaddata_paired	Spirochaetota	32587	P	623756	408	624164	0.02283
ERR3199695_1_kneaddata_paired	Elusimicrobiota	11888	P	356992	0	356992	0.01306
ERR3199695_1_kneaddata_paired	Actinobacteriota	615	P	341429	611	342040	0.01251
ERR3199695_1_kneaddata_paired	Proteobacteria	22518	P	187731	1257	188988	0.00691
ERR3199695_1_kneaddata_paired	Desulfobacterota_A	11509	P	158086	1679	159765	0.00584
ERR3199695_1_kneaddata_paired	Cyanobacteria	9876	P	95573	7965	103538	0.00379
ERR3199695_1_kneaddata_paired	Campylobacterota	8700	P	93228	25	93253	0.00341
ERR3199695_1_kneaddata_paired	Deferribacterota	10822	P	24115	111	24226	0.00089
ERR3199695_1_kneaddata_paired	Firmicutes_B	17289	P	825	36	861	0.00003
ERR3199695_1_kneaddata_paired	Firmicutes_I	18140	P	353	0	353	0.00001
ERR3199695_1_kneaddata_paired	Firmicutes_C	17613	P	101	0	101	0.00000
ERR3199695_1_kneaddata_paired	Thermotogota	33086	P	29	0	29	0.00000
ERR3199696_1_kneaddata_paired	Bacteroidota	4587	P	22062840	84992	22147832	0.78563
ERR3199696_1_kneaddata_paired	Firmicutes_A	14608	P	3026761	20430	3047191	0.10809
ERR3199696_1_kneaddata_paired	Firmicutes	12188	P	1251215	64070	1315285	0.04666
ERR3199696_1_kneaddata_paired	Actinobacteriota	615	P	566082	735	566817	0.02011
ERR3199696_1_kneaddata_paired	Verrucomicrobiota	33333	P	446038	4560	450598	0.01598
ERR3199696_1_kneaddata_paired	Proteobacteria	22518	P	329510	851	330361	0.01172
ERR3199696_1_kneaddata_paired	Campylobacterota	8700	P	87362	2	87364	0.00310
ERR3199696_1_kneaddata_paired	Desulfobacterota_A	11509	P	77175	959	78134	0.00277
ERR3199696_1_kneaddata_paired	Spirochaetota	32587	P	67112	40	67152	0.00238
ERR3199696_1_kneaddata_paired	Cyanobacteria	9876	P	62973	4823	67796	0.00240
ERR3199696_1_kneaddata_paired	Elusimicrobiota	11888	P	18417	0	18417	0.00065
ERR3199696_1_kneaddata_paired	Deferribacterota	10822	P	13507	57	13564	0.00048
ERR3199696_1_kneaddata_paired	Firmicutes_B	17289	P	321	12	333	0.00001
ERR3199696_1_kneaddata_paired	Firmicutes_I	18140	P	307	0	307	0.00001
ERR3199696_1_kneaddata_paired	Firmicutes_C	17613	P	35	0	35	0.00000
ERR3199696_1_kneaddata_paired	Thermotogota	33086	P	2	0	2	0.00000
ERR3199697_1_kneaddata_paired	Bacteroidota	4587	P	13759192	50687	13809879	0.50306
ERR3199697_1_kneaddata_paired	Firmicutes_A	14608	P	10659752	63260	10723012	0.39061
ERR3199697_1_kneaddata_paired	Spirochaetota	32587	P	779896	395	780291	0.02842
ERR3199697_1_kneaddata_paired	Desulfobacterota_A	11509	P	567909	5899	573808	0.02090
ERR3199697_1_kneaddata_paired	Firmicutes	12188	P	506848	4391	511239	0.01862
ERR3199697_1_kneaddata_paired	Campylobacterota	8700	P	260858	19	260877	0.00950
ERR3199697_1_kneaddata_paired	Proteobacteria	22518	P	222634	305	222939	0.00812
ERR3199697_1_kneaddata_paired	Cyanobacteria	9876	P	165147	11291	176438	0.00643
ERR3199697_1_kneaddata_paired	Actinobacteriota	615	P	133825	305	134130	0.00489
ERR3199697_1_kneaddata_paired	Deferribacterota	10822	P	120264	433	120697	0.00440
ERR3199697_1_kneaddata_paired	Verrucomicrobiota	33333	P	103762	880	104642	0.00381
ERR3199697_1_kneaddata_paired	Elusimicrobiota	11888	P	32196	0	32196	0.00117
ERR3199697_1_kneaddata_paired	Firmicutes_B	17289	P	1201	41	1242	0.00005
ERR3199697_1_kneaddata_paired	Firmicutes_I	18140	P	425	0	425	0.00002
ERR3199697_1_kneaddata_paired	Firmicutes_C	17613	P	159	0	159	0.00001
ERR3199697_1_kneaddata_paired	Thermotogota	33086	P	18	0	18	0.00000
ERR3357520_1_kneaddata_paired	Firmicutes_A	14608	P	174643	1846	176489	0.45506
ERR3357520_1_kneaddata_paired	Bacteroidota	4587	P	127543	1857	129400	0.33365
ERR3357520_1_kneaddata_paired	Firmicutes	12188	P	56496	686	57182	0.14744
ERR3357520_1_kneaddata_paired	Desulfobacterota_A	11509	P	13069	21	13090	0.03375
ERR3357520_1_kneaddata_paired	Actinobacteriota	615	P	6981	34	7015	0.01809
ERR3357520_1_kneaddata_paired	Cyanobacteria	9876	P	3899	19	3918	0.01010
ERR3357520_1_kneaddata_paired	Verrucomicrobiota	33333	P	500	11	511	0.00132
ERR3357520_1_kneaddata_paired	Spirochaetota	32587	P	81	0	81	0.00021
ERR3357520_1_kneaddata_paired	Proteobacteria	22518	P	76	0	76	0.00020
ERR3357520_1_kneaddata_paired	Deferribacterota	10822	P	30	0	30	0.00008
ERR3357520_1_kneaddata_paired	Campylobacterota	8700	P	20	0	20	0.00005
ERR3357520_1_kneaddata_paired	Firmicutes_B	17289	P	11	0	11	0.00003
ERR3357520_1_kneaddata_paired	Firmicutes_C	17613	P	5	0	5	0.00001
ERR3357520_1_kneaddata_paired	Firmicutes_I	18140	P	4	0	4	0.00001
ERR3357520_1_kneaddata_paired	Elusimicrobiota	11888	P	2	0	2	0.00001
ERR3357521_1_kneaddata_paired	Firmicutes_A	14608	P	7323873	56078	7379951	0.78060
ERR3357521_1_kneaddata_paired	Bacteroidota	4587	P	1661433	13755	1675188	0.17719
ERR3357521_1_kneaddata_paired	Firmicutes	12188	P	189098	1962	191060	0.02021
ERR3357521_1_kneaddata_paired	Verrucomicrobiota	33333	P	109590	1394	110984	0.01174
ERR3357521_1_kneaddata_paired	Desulfobacterota_A	11509	P	37351	158	37509	0.00397
ERR3357521_1_kneaddata_paired	Deferribacterota	10822	P	31128	105	31233	0.00330
ERR3357521_1_kneaddata_paired	Proteobacteria	22518	P	13340	72	13412	0.00142
ERR3357521_1_kneaddata_paired	Actinobacteriota	615	P	12277	33	12310	0.00130
ERR3357521_1_kneaddata_paired	Cyanobacteria	9876	P	1640	33	1673	0.00018
ERR3357521_1_kneaddata_paired	Spirochaetota	32587	P	325	0	325	0.00003
ERR3357521_1_kneaddata_paired	Firmicutes_B	17289	P	258	8	266	0.00003
ERR3357521_1_kneaddata_paired	Campylobacterota	8700	P	188	0	188	0.00002
ERR3357521_1_kneaddata_paired	Firmicutes_C	17613	P	56	0	56	0.00001
ERR3357521_1_kneaddata_paired	Firmicutes_I	18140	P	43	0	43	0.00000
ERR3357521_1_kneaddata_paired	Thermotogota	33086	P	22	0	22	0.00000
ERR3357521_1_kneaddata_paired	Elusimicrobiota	11888	P	18	0	18	0.00000
ERR3357522_1_kneaddata_paired	Firmicutes_A	14608	P	2239982	23558	2263540	0.58084
ERR3357522_1_kneaddata_paired	Bacteroidota	4587	P	1365723	14433	1380156	0.35416
ERR3357522_1_kneaddata_paired	Firmicutes	12188	P	142554	1527	144081	0.03697
ERR3357522_1_kneaddata_paired	Verrucomicrobiota	33333	P	70315	1166	71481	0.01834
ERR3357522_1_kneaddata_paired	Proteobacteria	22518	P	12640	89	12729	0.00327
ERR3357522_1_kneaddata_paired	Deferribacterota	10822	P	8983	39	9022	0.00232
ERR3357522_1_kneaddata_paired	Desulfobacterota_A	11509	P	7371	63	7434	0.00191
ERR3357522_1_kneaddata_paired	Actinobacteriota	615	P	7366	23	7389	0.00190
ERR3357522_1_kneaddata_paired	Cyanobacteria	9876	P	787	14	801	0.00021
ERR3357522_1_kneaddata_paired	Campylobacterota	8700	P	123	0	123	0.00003
ERR3357522_1_kneaddata_paired	Spirochaetota	32587	P	109	0	109	0.00003
ERR3357522_1_kneaddata_paired	Firmicutes_B	17289	P	98	4	102	0.00003
ERR3357522_1_kneaddata_paired	Firmicutes_C	17613	P	25	0	25	0.00001
ERR3357522_1_kneaddata_paired	Firmicutes_I	18140	P	16	0	16	0.00000
ERR3357522_1_kneaddata_paired	Thermotogota	33086	P	10	0	10	0.00000
ERR3357522_1_kneaddata_paired	Elusimicrobiota	11888	P	7	0	7	0.00000
ERR3357523_1_kneaddata_paired	Firmicutes_A	14608	P	194325	1913	196238	0.43717
ERR3357523_1_kneaddata_paired	Bacteroidota	4587	P	122354	1613	123967	0.27617
ERR3357523_1_kneaddata_paired	Firmicutes	12188	P	108456	1017	109473	0.24388
ERR3357523_1_kneaddata_paired	Desulfobacterota_A	11509	P	10825	14	10839	0.02415
ERR3357523_1_kneaddata_paired	Actinobacteriota	615	P	5042	19	5061	0.01128
ERR3357523_1_kneaddata_paired	Cyanobacteria	9876	P	2384	13	2397	0.00534
ERR3357523_1_kneaddata_paired	Proteobacteria	22518	P	571	0	571	0.00127
ERR3357523_1_kneaddata_paired	Verrucomicrobiota	33333	P	206	4	210	0.00047
ERR3357523_1_kneaddata_paired	Spirochaetota	32587	P	73	0	73	0.00016
ERR3357523_1_kneaddata_paired	Deferribacterota	10822	P	19	0	19	0.00004
ERR3357523_1_kneaddata_paired	Campylobacterota	8700	P	13	0	13	0.00003
ERR3357523_1_kneaddata_paired	Firmicutes_B	17289	P	11	0	11	0.00003
ERR3357523_1_kneaddata_paired	Firmicutes_I	18140	P	3	0	3	0.00001
ERR3357523_1_kneaddata_paired	Elusimicrobiota	11888	P	1	0	1	0.00000
ERR3357523_1_kneaddata_paired	Firmicutes_C	17613	P	1	0	1	0.00000
ERR3357524_1_kneaddata_paired	Firmicutes_A	14608	P	7671230	50525	7721755	0.82286
ERR3357524_1_kneaddata_paired	Bacteroidota	4587	P	1286019	13028	1299047	0.13843
ERR3357524_1_kneaddata_paired	Firmicutes	12188	P	229685	3556	233241	0.02486
ERR3357524_1_kneaddata_paired	Deferribacterota	10822	P	69738	410	70148	0.00748
ERR3357524_1_kneaddata_paired	Desulfobacterota_A	11509	P	27681	280	27961	0.00298
ERR3357524_1_kneaddata_paired	Proteobacteria	22518	P	13987	147	14134	0.00151
ERR3357524_1_kneaddata_paired	Verrucomicrobiota	33333	P	8970	235	9205	0.00098
ERR3357524_1_kneaddata_paired	Actinobacteriota	615	P	4544	19	4563	0.00049
ERR3357524_1_kneaddata_paired	Cyanobacteria	9876	P	1985	105	2090	0.00022
ERR3357524_1_kneaddata_paired	Firmicutes_B	17289	P	1020	59	1079	0.00012
ERR3357524_1_kneaddata_paired	Spirochaetota	32587	P	364	1	365	0.00004
ERR3357524_1_kneaddata_paired	Campylobacterota	8700	P	233	0	233	0.00002
ERR3357524_1_kneaddata_paired	Firmicutes_C	17613	P	116	0	116	0.00001
ERR3357524_1_kneaddata_paired	Firmicutes_I	18140	P	59	0	59	0.00001
ERR3357524_1_kneaddata_paired	Thermotogota	33086	P	25	0	25	0.00000
ERR3357524_1_kneaddata_paired	Elusimicrobiota	11888	P	14	0	14	0.00000
ERR3357525_1_kneaddata_paired	Firmicutes_A	14608	P	1341838	13044	1354882	0.48874
ERR3357525_1_kneaddata_paired	Bacteroidota	4587	P	1097138	13799	1110937	0.40074
ERR3357525_1_kneaddata_paired	Firmicutes	12188	P	257411	3606	261017	0.09416
ERR3357525_1_kneaddata_paired	Deferribacterota	10822	P	18405	137	18542	0.00669
ERR3357525_1_kneaddata_paired	Proteobacteria	22518	P	9849	118	9967	0.00360
ERR3357525_1_kneaddata_paired	Verrucomicrobiota	33333	P	7086	207	7293	0.00263
ERR3357525_1_kneaddata_paired	Actinobacteriota	615	P	5349	27	5376	0.00194
ERR3357525_1_kneaddata_paired	Desulfobacterota_A	11509	P	2478	52	2530	0.00091
ERR3357525_1_kneaddata_paired	Cyanobacteria	9876	P	951	34	985	0.00036
ERR3357525_1_kneaddata_paired	Firmicutes_B	17289	P	363	27	390	0.00014
ERR3357525_1_kneaddata_paired	Campylobacterota	8700	P	118	0	118	0.00004
ERR3357525_1_kneaddata_paired	Spirochaetota	32587	P	108	0	108	0.00004
ERR3357525_1_kneaddata_paired	Firmicutes_C	17613	P	18	0	18	0.00001
ERR3357525_1_kneaddata_paired	Firmicutes_I	18140	P	15	0	15	0.00001
ERR3357525_1_kneaddata_paired	Thermotogota	33086	P	7	0	7	0.00000
ERR3357525_1_kneaddata_paired	Elusimicrobiota	11888	P	4	0	4	0.00000
ERR3357526_1_kneaddata_paired	Firmicutes_A	14608	P	7294516	45586	7340102	0.67069
ERR3357526_1_kneaddata_paired	Bacteroidota	4587	P	2757934	17934	2775868	0.25364
ERR3357526_1_kneaddata_paired	Firmicutes	12188	P	623954	4433	628387	0.05742
ERR3357526_1_kneaddata_paired	Verrucomicrobiota	33333	P	96258	1112	97370	0.00890
ERR3357526_1_kneaddata_paired	Desulfobacterota_A	11509	P	52342	108	52450	0.00479
ERR3357526_1_kneaddata_paired	Actinobacteriota	615	P	29282	65	29347	0.00268
ERR3357526_1_kneaddata_paired	Deferribacterota	10822	P	10979	34	11013	0.00101
ERR3357526_1_kneaddata_paired	Proteobacteria	22518	P	4690	22	4712	0.00043
ERR3357526_1_kneaddata_paired	Cyanobacteria	9876	P	3165	73	3238	0.00030
ERR3357526_1_kneaddata_paired	Firmicutes_B	17289	P	796	24	820	0.00007
ERR3357526_1_kneaddata_paired	Spirochaetota	32587	P	414	0	414	0.00004
ERR3357526_1_kneaddata_paired	Campylobacterota	8700	P	233	0	233	0.00002
ERR3357526_1_kneaddata_paired	Firmicutes_C	17613	P	55	0	55	0.00001
ERR3357526_1_kneaddata_paired	Firmicutes_I	18140	P	47	0	47	0.00000
ERR3357526_1_kneaddata_paired	Thermotogota	33086	P	22	0	22	0.00000
ERR3357526_1_kneaddata_paired	Elusimicrobiota	11888	P	4	0	4	0.00000
ERR3357527_1_kneaddata_paired	Firmicutes_A	14608	P	17263306	162908	17426214	0.51041
ERR3357527_1_kneaddata_paired	Bacteroidota	4587	P	14893835	123830	15017665	0.43987
ERR3357527_1_kneaddata_paired	Firmicutes	12188	P	1037633	11870	1049503	0.03074
ERR3357527_1_kneaddata_paired	Actinobacteriota	615	P	268916	2801	271717	0.00796
ERR3357527_1_kneaddata_paired	Desulfobacterota_A	11509	P	172665	1367	174032	0.00510
ERR3357527_1_kneaddata_paired	Cyanobacteria	9876	P	85748	1061	86809	0.00254
ERR3357527_1_kneaddata_paired	Proteobacteria	22518	P	85104	389	85493	0.00250
ERR3357527_1_kneaddata_paired	Deferribacterota	10822	P	25173	163	25336	0.00074
ERR3357527_1_kneaddata_paired	Verrucomicrobiota	33333	P	1914	170	2084	0.00006
ERR3357527_1_kneaddata_paired	Spirochaetota	32587	P	953	1	954	0.00003
ERR3357527_1_kneaddata_paired	Firmicutes_B	17289	P	570	36	606	0.00002
ERR3357527_1_kneaddata_paired	Campylobacterota	8700	P	397	0	397	0.00001
ERR3357527_1_kneaddata_paired	Firmicutes_C	17613	P	276	1	277	0.00001
ERR3357527_1_kneaddata_paired	Firmicutes_I	18140	P	204	0	204	0.00001
ERR3357527_1_kneaddata_paired	Elusimicrobiota	11888	P	70	0	70	0.00000
ERR3357527_1_kneaddata_paired	Thermotogota	33086	P	37	0	37	0.00000
ERR3357528_1_kneaddata_paired	Firmicutes_A	14608	P	1222514	10552	1233066	0.56189
ERR3357528_1_kneaddata_paired	Bacteroidota	4587	P	760664	6045	766709	0.34938
ERR3357528_1_kneaddata_paired	Firmicutes	12188	P	95749	798	96547	0.04400
ERR3357528_1_kneaddata_paired	Actinobacteriota	615	P	46015	477	46492	0.02119
ERR3357528_1_kneaddata_paired	Desulfobacterota_A	11509	P	27027	109	27136	0.01237
ERR3357528_1_kneaddata_paired	Cyanobacteria	9876	P	17465	95	17560	0.00800
ERR3357528_1_kneaddata_paired	Proteobacteria	22518	P	3985	12	3997	0.00182
ERR3357528_1_kneaddata_paired	Deferribacterota	10822	P	2638	16	2654	0.00121
ERR3357528_1_kneaddata_paired	Spirochaetota	32587	P	121	0	121	0.00006
ERR3357528_1_kneaddata_paired	Verrucomicrobiota	33333	P	111	8	119	0.00005
ERR3357528_1_kneaddata_paired	Campylobacterota	8700	P	40	0	40	0.00002
ERR3357528_1_kneaddata_paired	Firmicutes_B	17289	P	21	1	22	0.00001
ERR3357528_1_kneaddata_paired	Firmicutes_I	18140	P	13	0	13	0.00001
ERR3357528_1_kneaddata_paired	Firmicutes_C	17613	P	11	0	11	0.00001
ERR3357528_1_kneaddata_paired	Elusimicrobiota	11888	P	4	0	4	0.00000
ERR3357528_1_kneaddata_paired	Thermotogota	33086	P	2	0	2	0.00000
ERR3357529_1_kneaddata_paired	Bacteroidota	4587	P	3918124	33029	3951153	0.59339
ERR3357529_1_kneaddata_paired	Firmicutes_A	14608	P	2227525	23938	2251463	0.33813
ERR3357529_1_kneaddata_paired	Firmicutes	12188	P	300385	2742	303127	0.04552
ERR3357529_1_kneaddata_paired	Actinobacteriota	615	P	82792	989	83781	0.01258
ERR3357529_1_kneaddata_paired	Proteobacteria	22518	P	26700	93	26793	0.00402
ERR3357529_1_kneaddata_paired	Cyanobacteria	9876	P	20726	375	21101	0.00317
ERR3357529_1_kneaddata_paired	Desulfobacterota_A	11509	P	16246	206	16452	0.00247
ERR3357529_1_kneaddata_paired	Deferribacterota	10822	P	4269	28	4297	0.00065
ERR3357529_1_kneaddata_paired	Verrucomicrobiota	33333	P	148	11	159	0.00002
ERR3357529_1_kneaddata_paired	Spirochaetota	32587	P	90	0	90	0.00001
ERR3357529_1_kneaddata_paired	Campylobacterota	8700	P	86	0	86	0.00001
ERR3357529_1_kneaddata_paired	Firmicutes_B	17289	P	62	4	66	0.00001
ERR3357529_1_kneaddata_paired	Firmicutes_I	18140	P	39	0	39	0.00001
ERR3357529_1_kneaddata_paired	Firmicutes_C	17613	P	37	0	37	0.00001
ERR3357529_1_kneaddata_paired	Elusimicrobiota	11888	P	14	0	14	0.00000
ERR3357529_1_kneaddata_paired	Thermotogota	33086	P	3	0	3	0.00000
ERR3357530_1_kneaddata_paired	Firmicutes_A	14608	P	6289536	42542	6332078	0.78862
ERR3357530_1_kneaddata_paired	Bacteroidota	4587	P	1483507	9695	1493202	0.18597
ERR3357530_1_kneaddata_paired	Firmicutes	12188	P	77171	1389	78560	0.00978
ERR3357530_1_kneaddata_paired	Desulfobacterota_A	11509	P	36715	275	36990	0.00461
ERR3357530_1_kneaddata_paired	Actinobacteriota	615	P	32759	249	33008	0.00411
ERR3357530_1_kneaddata_paired	Cyanobacteria	9876	P	28124	324	28448	0.00354
ERR3357530_1_kneaddata_paired	Deferribacterota	10822	P	15361	76	15437	0.00192
ERR3357530_1_kneaddata_paired	Proteobacteria	22518	P	10175	43	10218	0.00127
ERR3357530_1_kneaddata_paired	Verrucomicrobiota	33333	P	576	39	615	0.00008
ERR3357530_1_kneaddata_paired	Firmicutes_B	17289	P	202	10	212	0.00003
ERR3357530_1_kneaddata_paired	Spirochaetota	32587	P	199	0	199	0.00002
ERR3357530_1_kneaddata_paired	Firmicutes_I	18140	P	137	0	137	0.00002
ERR3357530_1_kneaddata_paired	Campylobacterota	8700	P	100	0	100	0.00001
ERR3357530_1_kneaddata_paired	Firmicutes_C	17613	P	96	0	96	0.00001
ERR3357530_1_kneaddata_paired	Thermotogota	33086	P	14	0	14	0.00000
ERR3357530_1_kneaddata_paired	Elusimicrobiota	11888	P	6	0	6	0.00000
ERR3357531_1_kneaddata_paired	Firmicutes_A	14608	P	2794151	20329	2814480	0.51555
ERR3357531_1_kneaddata_paired	Bacteroidota	4587	P	2322411	15535	2337946	0.42826
ERR3357531_1_kneaddata_paired	Firmicutes	12188	P	217995	1820	219815	0.04027
ERR3357531_1_kneaddata_paired	Actinobacteriota	615	P	34205	278	34483	0.00632
ERR3357531_1_kneaddata_paired	Desulfobacterota_A	11509	P	18848	136	18984	0.00348
ERR3357531_1_kneaddata_paired	Cyanobacteria	9876	P	15174	197	15371	0.00282
ERR3357531_1_kneaddata_paired	Proteobacteria	22518	P	14800	34	14834	0.00272
ERR3357531_1_kneaddata_paired	Deferribacterota	10822	P	2729	13	2742	0.00050
ERR3357531_1_kneaddata_paired	Verrucomicrobiota	33333	P	153	8	161	0.00003
ERR3357531_1_kneaddata_paired	Spirochaetota	32587	P	132	0	132	0.00002
ERR3357531_1_kneaddata_paired	Campylobacterota	8700	P	85	0	85	0.00002
ERR3357531_1_kneaddata_paired	Firmicutes_B	17289	P	83	4	87	0.00002
ERR3357531_1_kneaddata_paired	Firmicutes_I	18140	P	41	0	41	0.00001
ERR3357531_1_kneaddata_paired	Firmicutes_C	17613	P	32	0	32	0.00001
ERR3357531_1_kneaddata_paired	Elusimicrobiota	11888	P	7	0	7	0.00000
ERR3357531_1_kneaddata_paired	Thermotogota	33086	P	5	0	5	0.00000
ERR3357532_1_kneaddata_paired	Firmicutes_A	14608	P	1668673	17628	1686301	0.56884
ERR3357532_1_kneaddata_paired	Bacteroidota	4587	P	966726	12964	979690	0.33048
ERR3357532_1_kneaddata_paired	Firmicutes	12188	P	211083	3419	214502	0.07236
ERR3357532_1_kneaddata_paired	Desulfobacterota_A	11509	P	45716	120	45836	0.01546
ERR3357532_1_kneaddata_paired	Actinobacteriota	615	P	31122	353	31475	0.01062
ERR3357532_1_kneaddata_paired	Deferribacterota	10822	P	2804	20	2824	0.00095
ERR3357532_1_kneaddata_paired	Cyanobacteria	9876	P	2096	29	2125	0.00072
ERR3357532_1_kneaddata_paired	Proteobacteria	22518	P	1101	17	1118	0.00038
ERR3357532_1_kneaddata_paired	Spirochaetota	32587	P	294	0	294	0.00010
ERR3357532_1_kneaddata_paired	Verrucomicrobiota	33333	P	119	11	130	0.00004
ERR3357532_1_kneaddata_paired	Firmicutes_B	17289	P	93	6	99	0.00003
ERR3357532_1_kneaddata_paired	Campylobacterota	8700	P	48	0	48	0.00002
ERR3357532_1_kneaddata_paired	Firmicutes_C	17613	P	12	0	12	0.00000
ERR3357532_1_kneaddata_paired	Elusimicrobiota	11888	P	9	0	9	0.00000
ERR3357532_1_kneaddata_paired	Firmicutes_I	18140	P	9	0	9	0.00000
ERR3357532_1_kneaddata_paired	Thermotogota	33086	P	2	0	2	0.00000
ERR3357533_1_kneaddata_paired	Firmicutes_A	14608	P	5634726	43591	5678317	0.75268
ERR3357533_1_kneaddata_paired	Bacteroidota	4587	P	1480033	18303	1498336	0.19861
ERR3357533_1_kneaddata_paired	Firmicutes	12188	P	243309	3868	247177	0.03276
ERR3357533_1_kneaddata_paired	Deferribacterota	10822	P	49869	328	50197	0.00665
ERR3357533_1_kneaddata_paired	Desulfobacterota_A	11509	P	35697	257	35954	0.00477
ERR3357533_1_kneaddata_paired	Proteobacteria	22518	P	15805	180	15985	0.00212
ERR3357533_1_kneaddata_paired	Actinobacteriota	615	P	7864	79	7943	0.00105
ERR3357533_1_kneaddata_paired	Cyanobacteria	9876	P	7478	692	8170	0.00108
ERR3357533_1_kneaddata_paired	Firmicutes_B	17289	P	672	44	716	0.00009
ERR3357533_1_kneaddata_paired	Verrucomicrobiota	33333	P	594	58	652	0.00009
ERR3357533_1_kneaddata_paired	Spirochaetota	32587	P	406	1	407	0.00005
ERR3357533_1_kneaddata_paired	Campylobacterota	8700	P	148	0	148	0.00002
ERR3357533_1_kneaddata_paired	Firmicutes_C	17613	P	86	0	86	0.00001
ERR3357533_1_kneaddata_paired	Firmicutes_I	18140	P	42	0	42	0.00001
ERR3357533_1_kneaddata_paired	Thermotogota	33086	P	14	0	14	0.00000
ERR3357533_1_kneaddata_paired	Elusimicrobiota	11888	P	10	0	10	0.00000
ERR3357534_1_kneaddata_paired	Firmicutes_A	14608	P	1962584	19409	1981993	0.50184
ERR3357534_1_kneaddata_paired	Bacteroidota	4587	P	1657449	22055	1679504	0.42525
ERR3357534_1_kneaddata_paired	Firmicutes	12188	P	226440	3538	229978	0.05823
ERR3357534_1_kneaddata_paired	Actinobacteriota	615	P	14424	164	14588	0.00369
ERR3357534_1_kneaddata_paired	Proteobacteria	22518	P	14351	177	14528	0.00368
ERR3357534_1_kneaddata_paired	Deferribacterota	10822	P	10797	78	10875	0.00275
ERR3357534_1_kneaddata_paired	Desulfobacterota_A	11509	P	9938	109	10047	0.00254
ERR3357534_1_kneaddata_paired	Cyanobacteria	9876	P	6264	662	6926	0.00175
ERR3357534_1_kneaddata_paired	Firmicutes_B	17289	P	428	31	459	0.00012
ERR3357534_1_kneaddata_paired	Spirochaetota	32587	P	177	0	177	0.00004
ERR3357534_1_kneaddata_paired	Verrucomicrobiota	33333	P	175	18	193	0.00005
ERR3357534_1_kneaddata_paired	Campylobacterota	8700	P	121	0	121	0.00003
ERR3357534_1_kneaddata_paired	Firmicutes_C	17613	P	39	0	39	0.00001
ERR3357534_1_kneaddata_paired	Firmicutes_I	18140	P	20	0	20	0.00001
ERR3357534_1_kneaddata_paired	Elusimicrobiota	11888	P	8	0	8	0.00000
ERR3357534_1_kneaddata_paired	Thermotogota	33086	P	1	0	1	0.00000
ERR3357535_1_kneaddata_paired	Firmicutes	12188	P	71523	888	72411	0.37858
ERR3357535_1_kneaddata_paired	Firmicutes_A	14608	P	55950	524	56474	0.29526
ERR3357535_1_kneaddata_paired	Bacteroidota	4587	P	50870	835	51705	0.27033
ERR3357535_1_kneaddata_paired	Desulfobacterota_A	11509	P	3927	6	3933	0.02057
ERR3357535_1_kneaddata_paired	Actinobacteriota	615	P	3858	30	3888	0.02033
ERR3357535_1_kneaddata_paired	Cyanobacteria	9876	P	2594	10	2604	0.01362
ERR3357535_1_kneaddata_paired	Deferribacterota	10822	P	150	0	150	0.00079
ERR3357535_1_kneaddata_paired	Proteobacteria	22518	P	63	0	63	0.00033
ERR3357535_1_kneaddata_paired	Spirochaetota	32587	P	17	0	17	0.00009
ERR3357535_1_kneaddata_paired	Verrucomicrobiota	33333	P	9	0	9	0.00005
ERR3357535_1_kneaddata_paired	Campylobacterota	8700	P	4	0	4	0.00002
ERR3357535_1_kneaddata_paired	Firmicutes_B	17289	P	4	0	4	0.00002
ERR3357535_1_kneaddata_paired	Thermotogota	33086	P	2	0	2	0.00001
ERR3357535_1_kneaddata_paired	Firmicutes_C	17613	P	1	0	1	0.00001
ERR3357536_1_kneaddata_paired	Firmicutes_A	14608	P	5699331	44749	5744080	0.76061
ERR3357536_1_kneaddata_paired	Bacteroidota	4587	P	1368122	16136	1384258	0.18330
ERR3357536_1_kneaddata_paired	Firmicutes	12188	P	277604	4377	281981	0.03734
ERR3357536_1_kneaddata_paired	Deferribacterota	10822	P	65392	415	65807	0.00871
ERR3357536_1_kneaddata_paired	Desulfobacterota_A	11509	P	46994	337	47331	0.00627
ERR3357536_1_kneaddata_paired	Actinobacteriota	615	P	11575	102	11677	0.00155
ERR3357536_1_kneaddata_paired	Proteobacteria	22518	P	11066	140	11206	0.00148
ERR3357536_1_kneaddata_paired	Cyanobacteria	9876	P	2856	189	3045	0.00040
ERR3357536_1_kneaddata_paired	Firmicutes_B	17289	P	946	59	1005	0.00013
ERR3357536_1_kneaddata_paired	Verrucomicrobiota	33333	P	783	75	858	0.00011
ERR3357536_1_kneaddata_paired	Spirochaetota	32587	P	409	1	410	0.00005
ERR3357536_1_kneaddata_paired	Campylobacterota	8700	P	172	0	172	0.00002
ERR3357536_1_kneaddata_paired	Firmicutes_C	17613	P	74	0	74	0.00001
ERR3357536_1_kneaddata_paired	Firmicutes_I	18140	P	27	0	27	0.00000
ERR3357536_1_kneaddata_paired	Thermotogota	33086	P	24	0	24	0.00000
ERR3357536_1_kneaddata_paired	Elusimicrobiota	11888	P	16	0	16	0.00000
ERR3357537_1_kneaddata_paired	Firmicutes_A	14608	P	1652595	15904	1668499	0.48892
ERR3357537_1_kneaddata_paired	Bacteroidota	4587	P	1405825	16677	1422502	0.41684
ERR3357537_1_kneaddata_paired	Firmicutes	12188	P	279004	4033	283037	0.08294
ERR3357537_1_kneaddata_paired	Actinobacteriota	615	P	14400	132	14532	0.00426
ERR3357537_1_kneaddata_paired	Desulfobacterota_A	11509	P	10342	102	10444	0.00306
ERR3357537_1_kneaddata_paired	Proteobacteria	22518	P	5784	72	5856	0.00172
ERR3357537_1_kneaddata_paired	Deferribacterota	10822	P	5279	34	5313	0.00156
ERR3357537_1_kneaddata_paired	Cyanobacteria	9876	P	1475	107	1582	0.00046
ERR3357537_1_kneaddata_paired	Firmicutes_B	17289	P	352	23	375	0.00011
ERR3357537_1_kneaddata_paired	Verrucomicrobiota	33333	P	175	16	191	0.00006
ERR3357537_1_kneaddata_paired	Spirochaetota	32587	P	113	0	113	0.00003
ERR3357537_1_kneaddata_paired	Campylobacterota	8700	P	94	0	94	0.00003
ERR3357537_1_kneaddata_paired	Firmicutes_C	17613	P	28	0	28	0.00001
ERR3357537_1_kneaddata_paired	Elusimicrobiota	11888	P	11	0	11	0.00000
ERR3357537_1_kneaddata_paired	Firmicutes_I	18140	P	8	0	8	0.00000
ERR3357537_1_kneaddata_paired	Thermotogota	33086	P	6	0	6	0.00000
ERR3357538_1_kneaddata_paired	Firmicutes_A	14608	P	7242155	49035	7291190	0.66400
ERR3357538_1_kneaddata_paired	Bacteroidota	4587	P	2744403	26982	2771385	0.25239
ERR3357538_1_kneaddata_paired	Firmicutes	12188	P	724982	8304	733286	0.06678
ERR3357538_1_kneaddata_paired	Desulfobacterota_A	11509	P	103370	243	103613	0.00944
ERR3357538_1_kneaddata_paired	Actinobacteriota	615	P	65701	473	66174	0.00603
ERR3357538_1_kneaddata_paired	Deferribacterota	10822	P	7922	39	7961	0.00073
ERR3357538_1_kneaddata_paired	Cyanobacteria	9876	P	2262	91	2353	0.00021
ERR3357538_1_kneaddata_paired	Proteobacteria	22518	P	2165	33	2198	0.00020
ERR3357538_1_kneaddata_paired	Firmicutes_B	17289	P	979	48	1027	0.00009
ERR3357538_1_kneaddata_paired	Spirochaetota	32587	P	624	0	624	0.00006
ERR3357538_1_kneaddata_paired	Verrucomicrobiota	33333	P	485	35	520	0.00005
ERR3357538_1_kneaddata_paired	Campylobacterota	8700	P	205	0	205	0.00002
ERR3357538_1_kneaddata_paired	Firmicutes_C	17613	P	81	0	81	0.00001
ERR3357538_1_kneaddata_paired	Firmicutes_I	18140	P	68	0	68	0.00001
ERR3357538_1_kneaddata_paired	Thermotogota	33086	P	24	0	24	0.00000
ERR3357538_1_kneaddata_paired	Elusimicrobiota	11888	P	15	0	15	0.00000
ERR3357539_1_kneaddata_paired	Firmicutes	12188	P	11803	139	11942	0.61094
ERR3357539_1_kneaddata_paired	Firmicutes_A	14608	P	3870	54	3924	0.20075
ERR3357539_1_kneaddata_paired	Bacteroidota	4587	P	2966	53	3019	0.15447
ERR3357539_1_kneaddata_paired	Cyanobacteria	9876	P	521	3	524	0.02682
ERR3357539_1_kneaddata_paired	Actinobacteriota	615	P	92	0	92	0.00474
ERR3357539_1_kneaddata_paired	Deferribacterota	10822	P	13	0	13	0.00067
ERR3357539_1_kneaddata_paired	Desulfobacterota_A	11509	P	13	0	13	0.00067
ERR3357539_1_kneaddata_paired	Proteobacteria	22518	P	12	0	12	0.00061
ERR3357539_1_kneaddata_paired	Spirochaetota	32587	P	3	0	3	0.00015
ERR3357539_1_kneaddata_paired	Verrucomicrobiota	33333	P	2	0	2	0.00011
ERR3357539_1_kneaddata_paired	Firmicutes_B	17289	P	1	0	1	0.00006
ERR3357540_1_kneaddata_paired	Firmicutes_A	14608	P	6504250	28847	6533097	0.81245
ERR3357540_1_kneaddata_paired	Bacteroidota	4587	P	1166196	12751	1178947	0.14661
ERR3357540_1_kneaddata_paired	Firmicutes	12188	P	153042	2036	155078	0.01929
ERR3357540_1_kneaddata_paired	Deferribacterota	10822	P	98937	355	99292	0.01235
ERR3357540_1_kneaddata_paired	Desulfobacterota_A	11509	P	34509	211	34720	0.00432
ERR3357540_1_kneaddata_paired	Actinobacteriota	615	P	22468	81	22549	0.00280
ERR3357540_1_kneaddata_paired	Cyanobacteria	9876	P	13381	141	13522	0.00168
ERR3357540_1_kneaddata_paired	Proteobacteria	22518	P	2592	8	2600	0.00032
ERR3357540_1_kneaddata_paired	Verrucomicrobiota	33333	P	453	21	474	0.00006
ERR3357540_1_kneaddata_paired	Firmicutes_B	17289	P	452	16	468	0.00006
ERR3357540_1_kneaddata_paired	Spirochaetota	32587	P	143	0	143	0.00002
ERR3357540_1_kneaddata_paired	Campylobacterota	8700	P	137	0	137	0.00002
ERR3357540_1_kneaddata_paired	Firmicutes_C	17613	P	85	0	85	0.00001
ERR3357540_1_kneaddata_paired	Firmicutes_I	18140	P	69	0	69	0.00001
ERR3357540_1_kneaddata_paired	Thermotogota	33086	P	11	0	11	0.00000
ERR3357540_1_kneaddata_paired	Elusimicrobiota	11888	P	6	0	6	0.00000
ERR3357541_1_kneaddata_paired	Firmicutes_A	14608	P	3370282	16324	3386606	0.60680
ERR3357541_1_kneaddata_paired	Bacteroidota	4587	P	1839781	18782	1858563	0.33301
ERR3357541_1_kneaddata_paired	Firmicutes	12188	P	245941	2211	248152	0.04446
ERR3357541_1_kneaddata_paired	Deferribacterota	10822	P	27932	94	28026	0.00502
ERR3357541_1_kneaddata_paired	Actinobacteriota	615	P	22574	82	22656	0.00406
ERR3357541_1_kneaddata_paired	Desulfobacterota_A	11509	P	17826	111	17937	0.00321
ERR3357541_1_kneaddata_paired	Cyanobacteria	9876	P	14374	94	14468	0.00259
ERR3357541_1_kneaddata_paired	Proteobacteria	22518	P	3778	7	3785	0.00068
ERR3357541_1_kneaddata_paired	Verrucomicrobiota	33333	P	263	11	274	0.00005
ERR3357541_1_kneaddata_paired	Firmicutes_B	17289	P	241	8	249	0.00004
ERR3357541_1_kneaddata_paired	Spirochaetota	32587	P	106	0	106	0.00002
ERR3357541_1_kneaddata_paired	Campylobacterota	8700	P	99	0	99	0.00002
ERR3357541_1_kneaddata_paired	Firmicutes_I	18140	P	64	0	64	0.00001
ERR3357541_1_kneaddata_paired	Firmicutes_C	17613	P	44	0	44	0.00001
ERR3357541_1_kneaddata_paired	Thermotogota	33086	P	11	0	11	0.00000
ERR3357541_1_kneaddata_paired	Elusimicrobiota	11888	P	5	0	5	0.00000
ERR3357542_1_kneaddata_paired	Firmicutes	12188	P	6857	97	6954	0.40330
ERR3357542_1_kneaddata_paired	Firmicutes_A	14608	P	4773	55	4828	0.28005
ERR3357542_1_kneaddata_paired	Bacteroidota	4587	P	4286	58	4344	0.25197
ERR3357542_1_kneaddata_paired	Cyanobacteria	9876	P	1030	5	1035	0.06008
ERR3357542_1_kneaddata_paired	Actinobacteriota	615	P	24	0	24	0.00140
ERR3357542_1_kneaddata_paired	Deferribacterota	10822	P	19	0	19	0.00111
ERR3357542_1_kneaddata_paired	Proteobacteria	22518	P	19	0	19	0.00110
ERR3357542_1_kneaddata_paired	Desulfobacterota_A	11509	P	10	0	10	0.00058
ERR3357542_1_kneaddata_paired	Campylobacterota	8700	P	3	0	3	0.00017
ERR3357542_1_kneaddata_paired	Spirochaetota	32587	P	3	0	3	0.00017
ERR3357542_1_kneaddata_paired	Firmicutes_I	18140	P	1	0	1	0.00006
ERR3357543_1_kneaddata_paired	Firmicutes_A	14608	P	7516984	41487	7558471	0.82858
ERR3357543_1_kneaddata_paired	Bacteroidota	4587	P	1172742	11916	1184658	0.12986
ERR3357543_1_kneaddata_paired	Firmicutes	12188	P	248604	2744	251348	0.02755
ERR3357543_1_kneaddata_paired	Deferribacterota	10822	P	73413	316	73729	0.00808
ERR3357543_1_kneaddata_paired	Actinobacteriota	615	P	22457	124	22581	0.00248
ERR3357543_1_kneaddata_paired	Desulfobacterota_A	11509	P	22166	235	22401	0.00246
ERR3357543_1_kneaddata_paired	Cyanobacteria	9876	P	5759	77	5836	0.00064
ERR3357543_1_kneaddata_paired	Proteobacteria	22518	P	1910	10	1920	0.00021
ERR3357543_1_kneaddata_paired	Firmicutes_B	17289	P	462	19	481	0.00005
ERR3357543_1_kneaddata_paired	Verrucomicrobiota	33333	P	399	20	419	0.00005
ERR3357543_1_kneaddata_paired	Spirochaetota	32587	P	161	0	161	0.00002
ERR3357543_1_kneaddata_paired	Campylobacterota	8700	P	80	0	80	0.00001
ERR3357543_1_kneaddata_paired	Firmicutes_I	18140	P	79	0	79	0.00001
ERR3357543_1_kneaddata_paired	Firmicutes_C	17613	P	62	0	62	0.00001
ERR3357543_1_kneaddata_paired	Elusimicrobiota	11888	P	9	0	9	0.00000
ERR3357543_1_kneaddata_paired	Thermotogota	33086	P	8	0	8	0.00000
ERR3357544_1_kneaddata_paired	Firmicutes_A	14608	P	2949549	17497	2967046	0.80413
ERR3357544_1_kneaddata_paired	Bacteroidota	4587	P	517593	5613	523206	0.14180
ERR3357544_1_kneaddata_paired	Firmicutes	12188	P	137019	1509	138528	0.03754
ERR3357544_1_kneaddata_paired	Deferribacterota	10822	P	39037	179	39216	0.01063
ERR3357544_1_kneaddata_paired	Actinobacteriota	615	P	10063	56	10119	0.00274
ERR3357544_1_kneaddata_paired	Desulfobacterota_A	11509	P	7984	92	8076	0.00219
ERR3357544_1_kneaddata_paired	Cyanobacteria	9876	P	2251	38	2289	0.00062
ERR3357544_1_kneaddata_paired	Proteobacteria	22518	P	793	3	796	0.00022
ERR3357544_1_kneaddata_paired	Firmicutes_B	17289	P	172	7	179	0.00005
ERR3357544_1_kneaddata_paired	Verrucomicrobiota	33333	P	117	6	123	0.00003
ERR3357544_1_kneaddata_paired	Spirochaetota	32587	P	69	0	69	0.00002
ERR3357544_1_kneaddata_paired	Campylobacterota	8700	P	51	0	51	0.00001
ERR3357544_1_kneaddata_paired	Firmicutes_I	18140	P	28	0	28	0.00001
ERR3357544_1_kneaddata_paired	Firmicutes_C	17613	P	25	0	25	0.00001
ERR3357544_1_kneaddata_paired	Thermotogota	33086	P	8	0	8	0.00000
ERR3357544_1_kneaddata_paired	Elusimicrobiota	11888	P	2	0	2	0.00000
ERR3357545_1_kneaddata_paired	Firmicutes_A	14608	P	10254097	42247	10296344	0.78888
ERR3357545_1_kneaddata_paired	Bacteroidota	4587	P	2084118	18445	2102563	0.16109
ERR3357545_1_kneaddata_paired	Firmicutes	12188	P	423820	3540	427360	0.03274
ERR3357545_1_kneaddata_paired	Deferribacterota	10822	P	121056	385	121441	0.00930
ERR3357545_1_kneaddata_paired	Desulfobacterota_A	11509	P	43158	223	43381	0.00332
ERR3357545_1_kneaddata_paired	Actinobacteriota	615	P	42815	147	42962	0.00329
ERR3357545_1_kneaddata_paired	Cyanobacteria	9876	P	11731	141	11872	0.00091
ERR3357545_1_kneaddata_paired	Proteobacteria	22518	P	4261	11	4272	0.00033
ERR3357545_1_kneaddata_paired	Firmicutes_B	17289	P	621	19	640	0.00005
ERR3357545_1_kneaddata_paired	Verrucomicrobiota	33333	P	482	17	499	0.00004
ERR3357545_1_kneaddata_paired	Spirochaetota	32587	P	193	0	193	0.00001
ERR3357545_1_kneaddata_paired	Campylobacterota	8700	P	144	0	144	0.00001
ERR3357545_1_kneaddata_paired	Firmicutes_C	17613	P	105	0	105	0.00001
ERR3357545_1_kneaddata_paired	Firmicutes_I	18140	P	101	0	101	0.00001
ERR3357545_1_kneaddata_paired	Thermotogota	33086	P	16	0	16	0.00000
ERR3357545_1_kneaddata_paired	Elusimicrobiota	11888	P	7	0	7	0.00000
ERR3357546_1_kneaddata_paired	Firmicutes_A	14608	P	852949	10529	863478	0.75131
ERR3357546_1_kneaddata_paired	Firmicutes	12188	P	186306	2364	188670	0.16416
ERR3357546_1_kneaddata_paired	Bacteroidota	4587	P	81908	1408	83316	0.07249
ERR3357546_1_kneaddata_paired	Actinobacteriota	615	P	8400	34	8434	0.00734
ERR3357546_1_kneaddata_paired	Deferribacterota	10822	P	2506	16	2522	0.00220
ERR3357546_1_kneaddata_paired	Cyanobacteria	9876	P	2282	12	2294	0.00200
ERR3357546_1_kneaddata_paired	Proteobacteria	22518	P	225	0	225	0.00020
ERR3357546_1_kneaddata_paired	Campylobacterota	8700	P	89	0	89	0.00008
ERR3357546_1_kneaddata_paired	Verrucomicrobiota	33333	P	87	3	90	0.00008
ERR3357546_1_kneaddata_paired	Desulfobacterota_A	11509	P	86	19	105	0.00009
ERR3357546_1_kneaddata_paired	Firmicutes_B	17289	P	34	2	36	0.00003
ERR3357546_1_kneaddata_paired	Firmicutes_I	18140	P	9	0	9	0.00001
ERR3357546_1_kneaddata_paired	Firmicutes_C	17613	P	7	0	7	0.00001
ERR3357546_1_kneaddata_paired	Thermotogota	33086	P	7	0	7	0.00001
ERR3357546_1_kneaddata_paired	Spirochaetota	32587	P	6	0	6	0.00001
ERR3357546_1_kneaddata_paired	Elusimicrobiota	11888	P	1	0	1	0.00000
ERR3357547_1_kneaddata_paired	Firmicutes_A	14608	P	10729998	64706	10794704	0.89893
ERR3357547_1_kneaddata_paired	Bacteroidota	4587	P	1028528	10559	1039087	0.08653
ERR3357547_1_kneaddata_paired	Firmicutes	12188	P	93891	3215	97106	0.00809
ERR3357547_1_kneaddata_paired	Deferribacterota	10822	P	65097	229	65326	0.00544
ERR3357547_1_kneaddata_paired	Actinobacteriota	615	P	7736	16	7752	0.00065
ERR3357547_1_kneaddata_paired	Desulfobacterota_A	11509	P	1169	164	1333	0.00011
ERR3357547_1_kneaddata_paired	Cyanobacteria	9876	P	976	11	987	0.00008
ERR3357547_1_kneaddata_paired	Verrucomicrobiota	33333	P	666	13	679	0.00006
ERR3357547_1_kneaddata_paired	Proteobacteria	22518	P	541	4	545	0.00005
ERR3357547_1_kneaddata_paired	Firmicutes_B	17289	P	362	12	374	0.00003
ERR3357547_1_kneaddata_paired	Thermotogota	33086	P	127	0	127	0.00001
ERR3357547_1_kneaddata_paired	Spirochaetota	32587	P	98	0	98	0.00001
ERR3357547_1_kneaddata_paired	Campylobacterota	8700	P	91	0	91	0.00001
ERR3357547_1_kneaddata_paired	Firmicutes_C	17613	P	65	0	65	0.00001
ERR3357547_1_kneaddata_paired	Firmicutes_I	18140	P	49	0	49	0.00000
ERR3357547_1_kneaddata_paired	Elusimicrobiota	11888	P	1	0	1	0.00000
ERR3357548_1_kneaddata_paired	Firmicutes_A	14608	P	3471560	21825	3493385	0.68122
ERR3357548_1_kneaddata_paired	Bacteroidota	4587	P	1296411	11026	1307437	0.25496
ERR3357548_1_kneaddata_paired	Firmicutes	12188	P	284482	2057	286539	0.05588
ERR3357548_1_kneaddata_paired	Deferribacterota	10822	P	21599	65	21664	0.00422
ERR3357548_1_kneaddata_paired	Actinobacteriota	615	P	16909	30	16939	0.00330
ERR3357548_1_kneaddata_paired	Cyanobacteria	9876	P	801	6	807	0.00016
ERR3357548_1_kneaddata_paired	Proteobacteria	22518	P	445	2	447	0.00009
ERR3357548_1_kneaddata_paired	Desulfobacterota_A	11509	P	306	34	340	0.00007
ERR3357548_1_kneaddata_paired	Verrucomicrobiota	33333	P	157	2	159	0.00003
ERR3357548_1_kneaddata_paired	Campylobacterota	8700	P	150	0	150	0.00003
ERR3357548_1_kneaddata_paired	Firmicutes_B	17289	P	99	2	101	0.00002
ERR3357548_1_kneaddata_paired	Spirochaetota	32587	P	52	0	52	0.00001
ERR3357548_1_kneaddata_paired	Firmicutes_I	18140	P	23	0	23	0.00000
ERR3357548_1_kneaddata_paired	Thermotogota	33086	P	23	0	23	0.00000
ERR3357548_1_kneaddata_paired	Firmicutes_C	17613	P	20	0	20	0.00000
ERR3357548_1_kneaddata_paired	Elusimicrobiota	11888	P	2	0	2	0.00000
ERR3357549_1_kneaddata_paired	Firmicutes_A	14608	P	18315921	76589	18392510	0.93758
ERR3357549_1_kneaddata_paired	Bacteroidota	4587	P	911173	3648	914821	0.04663
ERR3357549_1_kneaddata_paired	Firmicutes	12188	P	261795	3198	264993	0.01351
ERR3357549_1_kneaddata_paired	Deferribacterota	10822	P	34474	77	34551	0.00176
ERR3357549_1_kneaddata_paired	Actinobacteriota	615	P	3402	10	3412	0.00017
ERR3357549_1_kneaddata_paired	Desulfobacterota_A	11509	P	2426	227	2653	0.00014
ERR3357549_1_kneaddata_paired	Cyanobacteria	9876	P	1530	11	1541	0.00008
ERR3357549_1_kneaddata_paired	Proteobacteria	22518	P	838	3	841	0.00004
ERR3357549_1_kneaddata_paired	Verrucomicrobiota	33333	P	740	6	746	0.00004
ERR3357549_1_kneaddata_paired	Firmicutes_B	17289	P	295	6	301	0.00002
ERR3357549_1_kneaddata_paired	Campylobacterota	8700	P	252	0	252	0.00001
ERR3357549_1_kneaddata_paired	Spirochaetota	32587	P	129	0	129	0.00001
ERR3357549_1_kneaddata_paired	Firmicutes_C	17613	P	112	0	112	0.00001
ERR3357549_1_kneaddata_paired	Firmicutes_I	18140	P	108	0	108	0.00001
ERR3357549_1_kneaddata_paired	Thermotogota	33086	P	36	0	36	0.00000
ERR3357549_1_kneaddata_paired	Elusimicrobiota	11888	P	7	0	7	0.00000
ERR3357550_1_kneaddata_paired	Firmicutes_A	14608	P	29885516	197510	30083026	0.82446
ERR3357550_1_kneaddata_paired	Bacteroidota	4587	P	5667006	48342	5715348	0.15664
ERR3357550_1_kneaddata_paired	Firmicutes	12188	P	569125	8220	577345	0.01582
ERR3357550_1_kneaddata_paired	Deferribacterota	10822	P	83412	281	83693	0.00229
ERR3357550_1_kneaddata_paired	Actinobacteriota	615	P	12005	58	12063	0.00033
ERR3357550_1_kneaddata_paired	Desulfobacterota_A	11509	P	4758	679	5437	0.00015
ERR3357550_1_kneaddata_paired	Cyanobacteria	9876	P	4757	65	4822	0.00013
ERR3357550_1_kneaddata_paired	Proteobacteria	22518	P	1532	10	1542	0.00004
ERR3357550_1_kneaddata_paired	Verrucomicrobiota	33333	P	1442	29	1471	0.00004
ERR3357550_1_kneaddata_paired	Campylobacterota	8700	P	1229	0	1229	0.00003
ERR3357550_1_kneaddata_paired	Firmicutes_B	17289	P	1074	35	1109	0.00003
ERR3357550_1_kneaddata_paired	Firmicutes_I	18140	P	377	0	377	0.00001
ERR3357550_1_kneaddata_paired	Spirochaetota	32587	P	262	0	262	0.00001
ERR3357550_1_kneaddata_paired	Firmicutes_C	17613	P	195	0	195	0.00001
ERR3357550_1_kneaddata_paired	Thermotogota	33086	P	181	0	181	0.00000
ERR3357550_1_kneaddata_paired	Elusimicrobiota	11888	P	12	0	12	0.00000
ERR3357551_1_kneaddata_paired	Firmicutes_A	14608	P	8489302	71977	8561279	0.61461
ERR3357551_1_kneaddata_paired	Bacteroidota	4587	P	5081255	36045	5117300	0.36737
ERR3357551_1_kneaddata_paired	Firmicutes	12188	P	79714	1478	81192	0.00583
ERR3357551_1_kneaddata_paired	Desulfobacterota_A	11509	P	76294	1311	77605	0.00557
ERR3357551_1_kneaddata_paired	Proteobacteria	22518	P	33789	144	33933	0.00244
ERR3357551_1_kneaddata_paired	Actinobacteriota	615	P	33202	269	33471	0.00240
ERR3357551_1_kneaddata_paired	Cyanobacteria	9876	P	12801	198	12999	0.00093
ERR3357551_1_kneaddata_paired	Verrucomicrobiota	33333	P	9777	883	10660	0.00077
ERR3357551_1_kneaddata_paired	Firmicutes_B	17289	P	392	22	414	0.00003
ERR3357551_1_kneaddata_paired	Campylobacterota	8700	P	217	0	217	0.00002
ERR3357551_1_kneaddata_paired	Firmicutes_C	17613	P	130	0	130	0.00001
ERR3357551_1_kneaddata_paired	Firmicutes_I	18140	P	110	0	110	0.00001
ERR3357551_1_kneaddata_paired	Spirochaetota	32587	P	105	0	105	0.00001
ERR3357551_1_kneaddata_paired	Deferribacterota	10822	P	90	0	90	0.00001
ERR3357551_1_kneaddata_paired	Thermotogota	33086	P	25	0	25	0.00000
ERR3357551_1_kneaddata_paired	Elusimicrobiota	11888	P	11	0	11	0.00000
ERR3357552_1_kneaddata_paired	Firmicutes_A	14608	P	16291472	111955	16403427	0.67070
ERR3357552_1_kneaddata_paired	Bacteroidota	4587	P	7453479	41926	7495405	0.30647
ERR3357552_1_kneaddata_paired	Firmicutes	12188	P	228520	3210	231730	0.00947
ERR3357552_1_kneaddata_paired	Desulfobacterota_A	11509	P	169293	2189	171482	0.00701
ERR3357552_1_kneaddata_paired	Proteobacteria	22518	P	64330	198	64528	0.00264
ERR3357552_1_kneaddata_paired	Actinobacteriota	615	P	55477	346	55823	0.00228
ERR3357552_1_kneaddata_paired	Cyanobacteria	9876	P	16926	227	17153	0.00070
ERR3357552_1_kneaddata_paired	Verrucomicrobiota	33333	P	14456	1021	15477	0.00063
ERR3357552_1_kneaddata_paired	Firmicutes_B	17289	P	764	35	799	0.00003
ERR3357552_1_kneaddata_paired	Campylobacterota	8700	P	381	0	381	0.00002
ERR3357552_1_kneaddata_paired	Deferribacterota	10822	P	374	0	374	0.00002
ERR3357552_1_kneaddata_paired	Spirochaetota	32587	P	224	0	224	0.00001
ERR3357552_1_kneaddata_paired	Firmicutes_C	17613	P	189	0	189	0.00001
ERR3357552_1_kneaddata_paired	Firmicutes_I	18140	P	148	0	148	0.00001
ERR3357552_1_kneaddata_paired	Thermotogota	33086	P	56	0	56	0.00000
ERR3357552_1_kneaddata_paired	Elusimicrobiota	11888	P	17	0	17	0.00000
ERR3357553_1_kneaddata_paired	Bacteroidota	4587	P	75593	649	76242	0.54047
ERR3357553_1_kneaddata_paired	Firmicutes	12188	P	33500	173	33673	0.23871
ERR3357553_1_kneaddata_paired	Firmicutes_A	14608	P	26910	452	27362	0.19397
ERR3357553_1_kneaddata_paired	Actinobacteriota	615	P	1864	17	1881	0.01334
ERR3357553_1_kneaddata_paired	Proteobacteria	22518	P	852	2	854	0.00606
ERR3357553_1_kneaddata_paired	Cyanobacteria	9876	P	558	4	562	0.00399
ERR3357553_1_kneaddata_paired	Desulfobacterota_A	11509	P	443	10	453	0.00321
ERR3357553_1_kneaddata_paired	Verrucomicrobiota	33333	P	26	1	27	0.00020
ERR3357553_1_kneaddata_paired	Spirochaetota	32587	P	4	0	4	0.00003
ERR3357553_1_kneaddata_paired	Deferribacterota	10822	P	2	0	2	0.00001
ERR3357553_1_kneaddata_paired	Campylobacterota	8700	P	1	0	1	0.00001
ERR3357553_1_kneaddata_paired	Firmicutes_I	18140	P	1	0	1	0.00001
ERR3357554_1_kneaddata_paired	Firmicutes_A	14608	P	7895813	53597	7949410	0.73650
ERR3357554_1_kneaddata_paired	Bacteroidota	4587	P	2496288	14776	2511064	0.23265
ERR3357554_1_kneaddata_paired	Firmicutes	12188	P	181837	1809	183646	0.01701
ERR3357554_1_kneaddata_paired	Desulfobacterota_A	11509	P	69144	911	70055	0.00649
ERR3357554_1_kneaddata_paired	Cyanobacteria	9876	P	30194	271	30465	0.00282
ERR3357554_1_kneaddata_paired	Actinobacteriota	615	P	26257	139	26396	0.00245
ERR3357554_1_kneaddata_paired	Proteobacteria	22518	P	20182	62	20244	0.00188
ERR3357554_1_kneaddata_paired	Verrucomicrobiota	33333	P	1099	73	1172	0.00011
ERR3357554_1_kneaddata_paired	Firmicutes_B	17289	P	367	16	383	0.00004
ERR3357554_1_kneaddata_paired	Firmicutes_C	17613	P	231	0	231	0.00002
ERR3357554_1_kneaddata_paired	Campylobacterota	8700	P	114	0	114	0.00001
ERR3357554_1_kneaddata_paired	Deferribacterota	10822	P	110	0	110	0.00001
ERR3357554_1_kneaddata_paired	Spirochaetota	32587	P	103	0	103	0.00001
ERR3357554_1_kneaddata_paired	Firmicutes_I	18140	P	57	0	57	0.00001
ERR3357554_1_kneaddata_paired	Thermotogota	33086	P	21	0	21	0.00000
ERR3357554_1_kneaddata_paired	Elusimicrobiota	11888	P	3	0	3	0.00000
ERR3357555_1_kneaddata_paired	Firmicutes_A	14608	P	2981197	26212	3007409	0.56126
ERR3357555_1_kneaddata_paired	Bacteroidota	4587	P	2104004	14684	2118688	0.39540
ERR3357555_1_kneaddata_paired	Firmicutes	12188	P	152580	1289	153869	0.02872
ERR3357555_1_kneaddata_paired	Desulfobacterota_A	11509	P	27019	454	27473	0.00513
ERR3357555_1_kneaddata_paired	Cyanobacteria	9876	P	19029	236	19265	0.00360
ERR3357555_1_kneaddata_paired	Proteobacteria	22518	P	16390	60	16450	0.00307
ERR3357555_1_kneaddata_paired	Actinobacteriota	615	P	13702	97	13799	0.00258
ERR3357555_1_kneaddata_paired	Verrucomicrobiota	33333	P	784	66	850	0.00016
ERR3357555_1_kneaddata_paired	Firmicutes_B	17289	P	157	8	165	0.00003
ERR3357555_1_kneaddata_paired	Firmicutes_C	17613	P	98	0	98	0.00002
ERR3357555_1_kneaddata_paired	Campylobacterota	8700	P	72	0	72	0.00001
ERR3357555_1_kneaddata_paired	Spirochaetota	32587	P	70	0	70	0.00001
ERR3357555_1_kneaddata_paired	Deferribacterota	10822	P	44	0	44	0.00001
ERR3357555_1_kneaddata_paired	Firmicutes_I	18140	P	27	0	27	0.00001
ERR3357555_1_kneaddata_paired	Thermotogota	33086	P	10	0	10	0.00000
ERR3357555_1_kneaddata_paired	Elusimicrobiota	11888	P	3	0	3	0.00000
ERR3357556_1_kneaddata_paired	Firmicutes_A	14608	P	19728832	160707	19889539	0.72851
ERR3357556_1_kneaddata_paired	Bacteroidota	4587	P	6482787	55530	6538317	0.23948
ERR3357556_1_kneaddata_paired	Firmicutes	12188	P	367603	5903	373506	0.01368
ERR3357556_1_kneaddata_paired	Desulfobacterota_A	11509	P	256992	5552	262544	0.00962
ERR3357556_1_kneaddata_paired	Proteobacteria	22518	P	109216	677	109893	0.00403
ERR3357556_1_kneaddata_paired	Cyanobacteria	9876	P	94145	2209	96354	0.00353
ERR3357556_1_kneaddata_paired	Actinobacteriota	615	P	24315	296	24611	0.00090
ERR3357556_1_kneaddata_paired	Verrucomicrobiota	33333	P	2490	255	2745	0.00010
ERR3357556_1_kneaddata_paired	Firmicutes_B	17289	P	1435	102	1537	0.00006
ERR3357556_1_kneaddata_paired	Campylobacterota	8700	P	924	0	924	0.00003
ERR3357556_1_kneaddata_paired	Spirochaetota	32587	P	619	2	621	0.00002
ERR3357556_1_kneaddata_paired	Deferribacterota	10822	P	422	1	423	0.00002
ERR3357556_1_kneaddata_paired	Firmicutes_I	18140	P	311	0	311	0.00001
ERR3357556_1_kneaddata_paired	Firmicutes_C	17613	P	187	0	187	0.00001
ERR3357556_1_kneaddata_paired	Thermotogota	33086	P	122	0	122	0.00000
ERR3357556_1_kneaddata_paired	Elusimicrobiota	11888	P	16	0	16	0.00000
ERR3357557_1_kneaddata_paired	Bacteroidota	4587	P	56191	683	56874	0.42771
ERR3357557_1_kneaddata_paired	Firmicutes_A	14608	P	42949	485	43434	0.32664
ERR3357557_1_kneaddata_paired	Firmicutes	12188	P	26127	112	26239	0.19733
ERR3357557_1_kneaddata_paired	Cyanobacteria	9876	P	3039	17	3056	0.02298
ERR3357557_1_kneaddata_paired	Actinobacteriota	615	P	2025	27	2052	0.01544
ERR3357557_1_kneaddata_paired	Proteobacteria	22518	P	661	6	667	0.00502
ERR3357557_1_kneaddata_paired	Desulfobacterota_A	11509	P	391	7	398	0.00300
ERR3357557_1_kneaddata_paired	Deferribacterota	10822	P	238	1	239	0.00180
ERR3357557_1_kneaddata_paired	Spirochaetota	32587	P	4	0	4	0.00003
ERR3357557_1_kneaddata_paired	Campylobacterota	8700	P	3	0	3	0.00002
ERR3357557_1_kneaddata_paired	Firmicutes_C	17613	P	1	0	1	0.00001
ERR3357557_1_kneaddata_paired	Verrucomicrobiota	33333	P	1	0	1	0.00001
ERR3357558_1_kneaddata_paired	Firmicutes_A	14608	P	6793022	50827	6843849	0.81069
ERR3357558_1_kneaddata_paired	Bacteroidota	4587	P	1327751	10838	1338589	0.15856
ERR3357558_1_kneaddata_paired	Firmicutes	12188	P	127242	1693	128935	0.01527
ERR3357558_1_kneaddata_paired	Desulfobacterota_A	11509	P	64364	1170	65534	0.00776
ERR3357558_1_kneaddata_paired	Cyanobacteria	9876	P	25284	236	25520	0.00302
ERR3357558_1_kneaddata_paired	Actinobacteriota	615	P	16297	143	16440	0.00195
ERR3357558_1_kneaddata_paired	Deferribacterota	10822	P	16122	87	16209	0.00192
ERR3357558_1_kneaddata_paired	Proteobacteria	22518	P	5950	28	5978	0.00071
ERR3357558_1_kneaddata_paired	Verrucomicrobiota	33333	P	337	26	363	0.00004
ERR3357558_1_kneaddata_paired	Firmicutes_B	17289	P	224	12	236	0.00003
ERR3357558_1_kneaddata_paired	Campylobacterota	8700	P	125	0	125	0.00001
ERR3357558_1_kneaddata_paired	Spirochaetota	32587	P	84	0	84	0.00001
ERR3357558_1_kneaddata_paired	Firmicutes_C	17613	P	71	0	71	0.00001
ERR3357558_1_kneaddata_paired	Firmicutes_I	18140	P	44	0	44	0.00001
ERR3357558_1_kneaddata_paired	Thermotogota	33086	P	13	0	13	0.00000
ERR3357558_1_kneaddata_paired	Elusimicrobiota	11888	P	3	0	3	0.00000
ERR3357559_1_kneaddata_paired	Firmicutes_A	14608	P	2568663	21786	2590449	0.58932
ERR3357559_1_kneaddata_paired	Bacteroidota	4587	P	1562574	13202	1575776	0.35849
ERR3357559_1_kneaddata_paired	Firmicutes	12188	P	163200	1204	164404	0.03740
ERR3357559_1_kneaddata_paired	Desulfobacterota_A	11509	P	18984	367	19351	0.00440
ERR3357559_1_kneaddata_paired	Cyanobacteria	9876	P	17536	119	17655	0.00402
ERR3357559_1_kneaddata_paired	Actinobacteriota	615	P	16208	151	16359	0.00372
ERR3357559_1_kneaddata_paired	Proteobacteria	22518	P	7202	29	7231	0.00165
ERR3357559_1_kneaddata_paired	Deferribacterota	10822	P	4006	22	4028	0.00092
ERR3357559_1_kneaddata_paired	Verrucomicrobiota	33333	P	124	10	134	0.00003
ERR3357559_1_kneaddata_paired	Firmicutes_B	17289	P	81	4	85	0.00002
ERR3357559_1_kneaddata_paired	Campylobacterota	8700	P	74	0	74	0.00002
ERR3357559_1_kneaddata_paired	Spirochaetota	32587	P	42	0	42	0.00001
ERR3357559_1_kneaddata_paired	Firmicutes_C	17613	P	24	0	24	0.00001
ERR3357559_1_kneaddata_paired	Firmicutes_I	18140	P	24	0	24	0.00001
ERR3357559_1_kneaddata_paired	Thermotogota	33086	P	5	0	5	0.00000
ERR3357559_1_kneaddata_paired	Elusimicrobiota	11888	P	3	0	3	0.00000
ERR3357560_1_kneaddata_paired	Bacteroidota	4587	P	181520	1925	183445	0.42729
ERR3357560_1_kneaddata_paired	Firmicutes_A	14608	P	174619	1712	176331	0.41071
ERR3357560_1_kneaddata_paired	Firmicutes	12188	P	56439	327	56766	0.13222
ERR3357560_1_kneaddata_paired	Actinobacteriota	615	P	4108	49	4157	0.00968
ERR3357560_1_kneaddata_paired	Cyanobacteria	9876	P	3468	19	3487	0.00812
ERR3357560_1_kneaddata_paired	Desulfobacterota_A	11509	P	2703	59	2762	0.00643
ERR3357560_1_kneaddata_paired	Proteobacteria	22518	P	1541	7	1548	0.00361
ERR3357560_1_kneaddata_paired	Deferribacterota	10822	P	785	5	790	0.00184
ERR3357560_1_kneaddata_paired	Verrucomicrobiota	33333	P	10	0	10	0.00002
ERR3357560_1_kneaddata_paired	Campylobacterota	8700	P	9	0	9	0.00002
ERR3357560_1_kneaddata_paired	Spirochaetota	32587	P	9	0	9	0.00002
ERR3357560_1_kneaddata_paired	Firmicutes_B	17289	P	3	0	3	0.00001
ERR3357560_1_kneaddata_paired	Firmicutes_I	18140	P	3	0	3	0.00001
ERR3357560_1_kneaddata_paired	Firmicutes_C	17613	P	2	0	2	0.00000
ERR3357560_1_kneaddata_paired	Thermotogota	33086	P	1	0	1	0.00000
ERR3357561_1_kneaddata_paired	Firmicutes_A	14608	P	7409281	56278	7465559	0.76520
ERR3357561_1_kneaddata_paired	Bacteroidota	4587	P	1949623	12860	1962483	0.20115
ERR3357561_1_kneaddata_paired	Firmicutes	12188	P	151502	1839	153341	0.01572
ERR3357561_1_kneaddata_paired	Desulfobacterota_A	11509	P	70486	1250	71736	0.00735
ERR3357561_1_kneaddata_paired	Cyanobacteria	9876	P	39350	550	39900	0.00409
ERR3357561_1_kneaddata_paired	Deferribacterota	10822	P	25235	141	25376	0.00260
ERR3357561_1_kneaddata_paired	Proteobacteria	22518	P	22281	156	22437	0.00230
ERR3357561_1_kneaddata_paired	Actinobacteriota	615	P	14130	143	14273	0.00146
ERR3357561_1_kneaddata_paired	Verrucomicrobiota	33333	P	386	28	414	0.00004
ERR3357561_1_kneaddata_paired	Firmicutes_B	17289	P	263	14	277	0.00003
ERR3357561_1_kneaddata_paired	Spirochaetota	32587	P	173	0	173	0.00002
ERR3357561_1_kneaddata_paired	Campylobacterota	8700	P	164	0	164	0.00002
ERR3357561_1_kneaddata_paired	Firmicutes_C	17613	P	99	0	99	0.00001
ERR3357561_1_kneaddata_paired	Firmicutes_I	18140	P	88	0	88	0.00001
ERR3357561_1_kneaddata_paired	Thermotogota	33086	P	34	0	34	0.00000
ERR3357561_1_kneaddata_paired	Elusimicrobiota	11888	P	9	0	9	0.00000
ERR3357562_1_kneaddata_paired	Bacteroidota	4587	P	2362786	20150	2382936	0.53191
ERR3357562_1_kneaddata_paired	Firmicutes_A	14608	P	1747884	18610	1766494	0.39431
ERR3357562_1_kneaddata_paired	Firmicutes	12188	P	226276	1995	228271	0.05095
ERR3357562_1_kneaddata_paired	Cyanobacteria	9876	P	39111	930	40041	0.00894
ERR3357562_1_kneaddata_paired	Proteobacteria	22518	P	29538	282	29820	0.00666
ERR3357562_1_kneaddata_paired	Actinobacteriota	615	P	12817	162	12979	0.00290
ERR3357562_1_kneaddata_paired	Desulfobacterota_A	11509	P	12810	328	13138	0.00293
ERR3357562_1_kneaddata_paired	Deferribacterota	10822	P	5723	43	5766	0.00129
ERR3357562_1_kneaddata_paired	Campylobacterota	8700	P	154	0	154	0.00003
ERR3357562_1_kneaddata_paired	Firmicutes_B	17289	P	95	7	102	0.00002
ERR3357562_1_kneaddata_paired	Spirochaetota	32587	P	93	0	93	0.00002
ERR3357562_1_kneaddata_paired	Verrucomicrobiota	33333	P	85	7	92	0.00002
ERR3357562_1_kneaddata_paired	Firmicutes_I	18140	P	37	0	37	0.00001
ERR3357562_1_kneaddata_paired	Firmicutes_C	17613	P	30	0	30	0.00001
ERR3357562_1_kneaddata_paired	Thermotogota	33086	P	11	0	11	0.00000
ERR3357562_1_kneaddata_paired	Elusimicrobiota	11888	P	2	0	2	0.00000
ERR3357563_1_kneaddata_paired	Firmicutes_A	14608	P	7990586	49888	8040474	0.71029
ERR3357563_1_kneaddata_paired	Bacteroidota	4587	P	2747741	16098	2763839	0.24415
ERR3357563_1_kneaddata_paired	Firmicutes	12188	P	339650	2206	341856	0.03020
ERR3357563_1_kneaddata_paired	Desulfobacterota_A	11509	P	67643	932	68575	0.00606
ERR3357563_1_kneaddata_paired	Cyanobacteria	9876	P	34014	325	34339	0.00303
ERR3357563_1_kneaddata_paired	Actinobacteriota	615	P	28936	205	29141	0.00257
ERR3357563_1_kneaddata_paired	Proteobacteria	22518	P	22692	105	22797	0.00201
ERR3357563_1_kneaddata_paired	Deferribacterota	10822	P	17852	79	17931	0.00158
ERR3357563_1_kneaddata_paired	Verrucomicrobiota	33333	P	331	19	350	0.00003
ERR3357563_1_kneaddata_paired	Firmicutes_B	17289	P	225	9	234	0.00002
ERR3357563_1_kneaddata_paired	Campylobacterota	8700	P	193	0	193	0.00002
ERR3357563_1_kneaddata_paired	Spirochaetota	32587	P	114	0	114	0.00001
ERR3357563_1_kneaddata_paired	Firmicutes_C	17613	P	77	0	77	0.00001
ERR3357563_1_kneaddata_paired	Firmicutes_I	18140	P	70	0	70	0.00001
ERR3357563_1_kneaddata_paired	Thermotogota	33086	P	18	0	18	0.00000
ERR3357563_1_kneaddata_paired	Elusimicrobiota	11888	P	7	0	7	0.00000
ERR3357564_1_kneaddata_paired	Firmicutes_A	14608	P	10286931	51984	10338915	0.62881
ERR3357564_1_kneaddata_paired	Bacteroidota	4587	P	5275292	62500	5337792	0.32464
ERR3357564_1_kneaddata_paired	Firmicutes	12188	P	321769	4530	326299	0.01985
ERR3357564_1_kneaddata_paired	Campylobacterota	8700	P	181033	5	181038	0.01101
ERR3357564_1_kneaddata_paired	Desulfobacterota_A	11509	P	124017	296	124313	0.00756
ERR3357564_1_kneaddata_paired	Actinobacteriota	615	P	71685	505	72190	0.00439
ERR3357564_1_kneaddata_paired	Deferribacterota	10822	P	28455	4	28459	0.00173
ERR3357564_1_kneaddata_paired	Proteobacteria	22518	P	25071	33	25104	0.00153
ERR3357564_1_kneaddata_paired	Cyanobacteria	9876	P	5779	77	5856	0.00036
ERR3357564_1_kneaddata_paired	Spirochaetota	32587	P	568	0	568	0.00003
ERR3357564_1_kneaddata_paired	Verrucomicrobiota	33333	P	453	19	472	0.00003
ERR3357564_1_kneaddata_paired	Firmicutes_B	17289	P	443	14	457	0.00003
ERR3357564_1_kneaddata_paired	Firmicutes_I	18140	P	280	0	280	0.00002
ERR3357564_1_kneaddata_paired	Firmicutes_C	17613	P	151	0	151	0.00001
ERR3357564_1_kneaddata_paired	Thermotogota	33086	P	100	0	100	0.00001
ERR3357564_1_kneaddata_paired	Elusimicrobiota	11888	P	21	0	21	0.00000
ERR3357565_1_kneaddata_paired	Firmicutes_A	14608	P	12773455	48343	12821798	0.65511
ERR3357565_1_kneaddata_paired	Bacteroidota	4587	P	5379866	47838	5427704	0.27732
ERR3357565_1_kneaddata_paired	Firmicutes	12188	P	728400	7619	736019	0.03761
ERR3357565_1_kneaddata_paired	Campylobacterota	8700	P	273393	6	273399	0.01397
ERR3357565_1_kneaddata_paired	Desulfobacterota_A	11509	P	131216	218	131434	0.00672
ERR3357565_1_kneaddata_paired	Deferribacterota	10822	P	79532	8	79540	0.00406
ERR3357565_1_kneaddata_paired	Actinobacteriota	615	P	64240	321	64561	0.00330
ERR3357565_1_kneaddata_paired	Proteobacteria	22518	P	26848	26	26874	0.00137
ERR3357565_1_kneaddata_paired	Cyanobacteria	9876	P	8346	108	8454	0.00043
ERR3357565_1_kneaddata_paired	Spirochaetota	32587	P	719	0	719	0.00004
ERR3357565_1_kneaddata_paired	Firmicutes_B	17289	P	512	12	524	0.00003
ERR3357565_1_kneaddata_paired	Verrucomicrobiota	33333	P	364	10	374	0.00002
ERR3357565_1_kneaddata_paired	Firmicutes_I	18140	P	348	0	348	0.00002
ERR3357565_1_kneaddata_paired	Firmicutes_C	17613	P	142	0	142	0.00001
ERR3357565_1_kneaddata_paired	Thermotogota	33086	P	69	0	69	0.00000
ERR3357565_1_kneaddata_paired	Elusimicrobiota	11888	P	23	0	23	0.00000
ERR3357566_1_kneaddata_paired	Firmicutes	12188	P	103705	614	104319	0.34504
ERR3357566_1_kneaddata_paired	Firmicutes_A	14608	P	90301	829	91130	0.30141
ERR3357566_1_kneaddata_paired	Bacteroidota	4587	P	82141	1198	83339	0.27565
ERR3357566_1_kneaddata_paired	Actinobacteriota	615	P	13127	108	13235	0.04378
ERR3357566_1_kneaddata_paired	Desulfobacterota_A	11509	P	5326	6	5332	0.01764
ERR3357566_1_kneaddata_paired	Cyanobacteria	9876	P	3404	14	3418	0.01131
ERR3357566_1_kneaddata_paired	Proteobacteria	22518	P	1242	3	1245	0.00412
ERR3357566_1_kneaddata_paired	Campylobacterota	8700	P	214	0	214	0.00071
ERR3357566_1_kneaddata_paired	Deferribacterota	10822	P	59	0	59	0.00020
ERR3357566_1_kneaddata_paired	Spirochaetota	32587	P	19	0	19	0.00006
ERR3357566_1_kneaddata_paired	Verrucomicrobiota	33333	P	13	0	13	0.00004
ERR3357566_1_kneaddata_paired	Firmicutes_B	17289	P	8	0	8	0.00003
ERR3357566_1_kneaddata_paired	Firmicutes_I	18140	P	5	0	5	0.00002
ERR3357566_1_kneaddata_paired	Firmicutes_C	17613	P	1	0	1	0.00000
ERR3357566_1_kneaddata_paired	Thermotogota	33086	P	1	0	1	0.00000
ERR3357567_1_kneaddata_paired	Firmicutes_A	14608	P	7756951	37470	7794421	0.79887
ERR3357567_1_kneaddata_paired	Bacteroidota	4587	P	1464784	21369	1486153	0.15232
ERR3357567_1_kneaddata_paired	Firmicutes	12188	P	199756	2737	202493	0.02075
ERR3357567_1_kneaddata_paired	Campylobacterota	8700	P	129079	4	129083	0.01323
ERR3357567_1_kneaddata_paired	Deferribacterota	10822	P	62034	12	62046	0.00636
ERR3357567_1_kneaddata_paired	Desulfobacterota_A	11509	P	45751	213	45964	0.00471
ERR3357567_1_kneaddata_paired	Actinobacteriota	615	P	27876	164	28040	0.00287
ERR3357567_1_kneaddata_paired	Proteobacteria	22518	P	4076	25	4101	0.00042
ERR3357567_1_kneaddata_paired	Cyanobacteria	9876	P	2981	84	3065	0.00031
ERR3357567_1_kneaddata_paired	Firmicutes_B	17289	P	398	13	411	0.00004
ERR3357567_1_kneaddata_paired	Spirochaetota	32587	P	336	0	336	0.00003
ERR3357567_1_kneaddata_paired	Verrucomicrobiota	33333	P	275	10	285	0.00003
ERR3357567_1_kneaddata_paired	Firmicutes_I	18140	P	243	0	243	0.00002
ERR3357567_1_kneaddata_paired	Firmicutes_C	17613	P	141	0	141	0.00001
ERR3357567_1_kneaddata_paired	Thermotogota	33086	P	29	0	29	0.00000
ERR3357567_1_kneaddata_paired	Elusimicrobiota	11888	P	3	0	3	0.00000
ERR3357568_1_kneaddata_paired	Firmicutes_A	14608	P	3621242	17120	3638362	0.76691
ERR3357568_1_kneaddata_paired	Bacteroidota	4587	P	882777	12312	895089	0.18867
ERR3357568_1_kneaddata_paired	Firmicutes	12188	P	102549	1209	103758	0.02187
ERR3357568_1_kneaddata_paired	Campylobacterota	8700	P	34356	1	34357	0.00724
ERR3357568_1_kneaddata_paired	Deferribacterota	10822	P	25202	4	25206	0.00531
ERR3357568_1_kneaddata_paired	Desulfobacterota_A	11509	P	23554	102	23656	0.00499
ERR3357568_1_kneaddata_paired	Actinobacteriota	615	P	18899	111	19010	0.00401
ERR3357568_1_kneaddata_paired	Proteobacteria	22518	P	2688	13	2701	0.00057
ERR3357568_1_kneaddata_paired	Cyanobacteria	9876	P	1341	38	1379	0.00029
ERR3357568_1_kneaddata_paired	Firmicutes_B	17289	P	159	5	164	0.00003
ERR3357568_1_kneaddata_paired	Spirochaetota	32587	P	151	0	151	0.00003
ERR3357568_1_kneaddata_paired	Verrucomicrobiota	33333	P	123	5	128	0.00003
ERR3357568_1_kneaddata_paired	Firmicutes_I	18140	P	115	0	115	0.00002
ERR3357568_1_kneaddata_paired	Firmicutes_C	17613	P	51	0	51	0.00001
ERR3357568_1_kneaddata_paired	Thermotogota	33086	P	17	0	17	0.00000
ERR3357568_1_kneaddata_paired	Elusimicrobiota	11888	P	4	0	4	0.00000
ERR3357569_1_kneaddata_paired	Bacteroidota	4587	P	18273856	218220	18492076	0.64708
ERR3357569_1_kneaddata_paired	Firmicutes_A	14608	P	7770041	70271	7840312	0.27435
ERR3357569_1_kneaddata_paired	Campylobacterota	8700	P	821735	23	821758	0.02876
ERR3357569_1_kneaddata_paired	Firmicutes	12188	P	724418	5744	730162	0.02555
ERR3357569_1_kneaddata_paired	Desulfobacterota_A	11509	P	310891	1328	312219	0.01093
ERR3357569_1_kneaddata_paired	Proteobacteria	22518	P	235572	455	236027	0.00826
ERR3357569_1_kneaddata_paired	Deferribacterota	10822	P	137302	26	137328	0.00481
ERR3357569_1_kneaddata_paired	Cyanobacteria	9876	P	4470	153	4623	0.00016
ERR3357569_1_kneaddata_paired	Spirochaetota	32587	P	1260	1	1261	0.00004
ERR3357569_1_kneaddata_paired	Actinobacteriota	615	P	1050	2	1052	0.00004
ERR3357569_1_kneaddata_paired	Verrucomicrobiota	33333	P	241	3	244	0.00001
ERR3357569_1_kneaddata_paired	Firmicutes_I	18140	P	232	0	232	0.00001
ERR3357569_1_kneaddata_paired	Firmicutes_C	17613	P	187	0	187	0.00001
ERR3357569_1_kneaddata_paired	Firmicutes_B	17289	P	151	5	156	0.00001
ERR3357569_1_kneaddata_paired	Thermotogota	33086	P	42	0	42	0.00000
ERR3357569_1_kneaddata_paired	Elusimicrobiota	11888	P	18	0	18	0.00000
ERR3357570_1_kneaddata_paired	Firmicutes	12188	P	20996	247	21243	0.61589
ERR3357570_1_kneaddata_paired	Bacteroidota	4587	P	6201	71	6272	0.18185
ERR3357570_1_kneaddata_paired	Firmicutes_A	14608	P	5044	58	5102	0.14794
ERR3357570_1_kneaddata_paired	Cyanobacteria	9876	P	1392	6	1398	0.04055
ERR3357570_1_kneaddata_paired	Verrucomicrobiota	33333	P	308	7	315	0.00915
ERR3357570_1_kneaddata_paired	Proteobacteria	22518	P	113	0	113	0.00329
ERR3357570_1_kneaddata_paired	Actinobacteriota	615	P	19	0	19	0.00055
ERR3357570_1_kneaddata_paired	Desulfobacterota_A	11509	P	19	0	19	0.00055
ERR3357570_1_kneaddata_paired	Deferribacterota	10822	P	2	0	2	0.00006
ERR3357570_1_kneaddata_paired	Firmicutes_I	18140	P	2	0	2	0.00006
ERR3357570_1_kneaddata_paired	Spirochaetota	32587	P	2	0	2	0.00006
ERR3357570_1_kneaddata_paired	Campylobacterota	8700	P	1	0	1	0.00003
ERR3357570_1_kneaddata_paired	Firmicutes_B	17289	P	1	0	1	0.00003
ERR3357571_1_kneaddata_paired	Firmicutes_A	14608	P	6712805	74809	6787614	0.54461
ERR3357571_1_kneaddata_paired	Bacteroidota	4587	P	4627809	46410	4674219	0.37504
ERR3357571_1_kneaddata_paired	Verrucomicrobiota	33333	P	610464	9868	620332	0.04977
ERR3357571_1_kneaddata_paired	Proteobacteria	22518	P	169099	1031	170130	0.01365
ERR3357571_1_kneaddata_paired	Desulfobacterota_A	11509	P	124847	316	125163	0.01004
ERR3357571_1_kneaddata_paired	Firmicutes	12188	P	69158	602	69760	0.00560
ERR3357571_1_kneaddata_paired	Actinobacteriota	615	P	14257	29	14286	0.00115
ERR3357571_1_kneaddata_paired	Cyanobacteria	9876	P	969	14	983	0.00008
ERR3357571_1_kneaddata_paired	Spirochaetota	32587	P	322	0	322	0.00003
ERR3357571_1_kneaddata_paired	Campylobacterota	8700	P	243	0	243	0.00002
ERR3357571_1_kneaddata_paired	Firmicutes_C	17613	P	140	0	140	0.00001
ERR3357571_1_kneaddata_paired	Thermotogota	33086	P	58	0	58	0.00000
ERR3357571_1_kneaddata_paired	Deferribacterota	10822	P	39	0	39	0.00000
ERR3357571_1_kneaddata_paired	Firmicutes_I	18140	P	21	0	21	0.00000
ERR3357571_1_kneaddata_paired	Firmicutes_B	17289	P	3	0	3	0.00000
ERR3357571_1_kneaddata_paired	Elusimicrobiota	11888	P	1	0	1	0.00000
ERR3357572_1_kneaddata_paired	Bacteroidota	4587	P	3761510	29612	3791122	0.64007
ERR3357572_1_kneaddata_paired	Firmicutes_A	14608	P	1257806	9288	1267094	0.21393
ERR3357572_1_kneaddata_paired	Verrucomicrobiota	33333	P	615253	8094	623347	0.10524
ERR3357572_1_kneaddata_paired	Proteobacteria	22518	P	111820	531	112351	0.01897
ERR3357572_1_kneaddata_paired	Firmicutes	12188	P	84592	602	85194	0.01438
ERR3357572_1_kneaddata_paired	Desulfobacterota_A	11509	P	32451	65	32516	0.00549
ERR3357572_1_kneaddata_paired	Actinobacteriota	615	P	9993	17	10010	0.00169
ERR3357572_1_kneaddata_paired	Cyanobacteria	9876	P	954	11	965	0.00016
ERR3357572_1_kneaddata_paired	Campylobacterota	8700	P	215	0	215	0.00004
ERR3357572_1_kneaddata_paired	Spirochaetota	32587	P	89	0	89	0.00002
ERR3357572_1_kneaddata_paired	Thermotogota	33086	P	40	0	40	0.00001
ERR3357572_1_kneaddata_paired	Deferribacterota	10822	P	37	0	37	0.00001
ERR3357572_1_kneaddata_paired	Firmicutes_I	18140	P	18	0	18	0.00000
ERR3357572_1_kneaddata_paired	Firmicutes_C	17613	P	13	0	13	0.00000
ERR3357572_1_kneaddata_paired	Firmicutes_B	17289	P	2	0	2	0.00000
ERR3357573_1_kneaddata_paired	Firmicutes_A	14608	P	13682448	118344	13800792	0.59883
ERR3357573_1_kneaddata_paired	Bacteroidota	4587	P	8308902	94824	8403726	0.36464
ERR3357573_1_kneaddata_paired	Firmicutes	12188	P	542324	19837	562161	0.02439
ERR3357573_1_kneaddata_paired	Desulfobacterota_A	11509	P	133857	390	134247	0.00583
ERR3357573_1_kneaddata_paired	Deferribacterota	10822	P	65656	455	66111	0.00287
ERR3357573_1_kneaddata_paired	Actinobacteriota	615	P	49753	369	50122	0.00217
ERR3357573_1_kneaddata_paired	Proteobacteria	22518	P	10011	66	10077	0.00044
ERR3357573_1_kneaddata_paired	Cyanobacteria	9876	P	8173	216	8389	0.00036
ERR3357573_1_kneaddata_paired	Verrucomicrobiota	33333	P	7272	231	7503	0.00033
ERR3357573_1_kneaddata_paired	Firmicutes_B	17289	P	1578	107	1685	0.00007
ERR3357573_1_kneaddata_paired	Spirochaetota	32587	P	738	1	739	0.00003
ERR3357573_1_kneaddata_paired	Campylobacterota	8700	P	371	0	371	0.00002
ERR3357573_1_kneaddata_paired	Firmicutes_C	17613	P	176	0	176	0.00001
ERR3357573_1_kneaddata_paired	Firmicutes_I	18140	P	158	0	158	0.00001
ERR3357573_1_kneaddata_paired	Thermotogota	33086	P	107	0	107	0.00000
ERR3357573_1_kneaddata_paired	Elusimicrobiota	11888	P	10	0	10	0.00000
ERR3357574_1_kneaddata_paired	Firmicutes_A	14608	P	13605607	69601	13675208	0.62164
ERR3357574_1_kneaddata_paired	Bacteroidota	4587	P	7430513	50341	7480854	0.34006
ERR3357574_1_kneaddata_paired	Firmicutes	12188	P	526715	10975	537690	0.02444
ERR3357574_1_kneaddata_paired	Desulfobacterota_A	11509	P	149850	189	150039	0.00682
ERR3357574_1_kneaddata_paired	Actinobacteriota	615	P	66552	287	66839	0.00304
ERR3357574_1_kneaddata_paired	Deferribacterota	10822	P	64082	267	64349	0.00293
ERR3357574_1_kneaddata_paired	Proteobacteria	22518	P	7860	30	7890	0.00036
ERR3357574_1_kneaddata_paired	Verrucomicrobiota	33333	P	7300	129	7429	0.00034
ERR3357574_1_kneaddata_paired	Cyanobacteria	9876	P	5751	93	5844	0.00027
ERR3357574_1_kneaddata_paired	Firmicutes_B	17289	P	1192	48	1240	0.00006
ERR3357574_1_kneaddata_paired	Spirochaetota	32587	P	462	0	462	0.00002
ERR3357574_1_kneaddata_paired	Campylobacterota	8700	P	282	0	282	0.00001
ERR3357574_1_kneaddata_paired	Firmicutes_C	17613	P	132	0	132	0.00001
ERR3357574_1_kneaddata_paired	Firmicutes_I	18140	P	119	0	119	0.00001
ERR3357574_1_kneaddata_paired	Thermotogota	33086	P	81	0	81	0.00000
ERR3357574_1_kneaddata_paired	Elusimicrobiota	11888	P	7	0	7	0.00000
ERR3357575_1_kneaddata_paired	Bacteroidota	4587	P	14834973	195043	15030016	0.49233
ERR3357575_1_kneaddata_paired	Firmicutes_A	14608	P	12259788	143458	12403246	0.40629
ERR3357575_1_kneaddata_paired	Verrucomicrobiota	33333	P	1707063	28135	1735198	0.05684
ERR3357575_1_kneaddata_paired	Proteobacteria	22518	P	966272	5794	972066	0.03184
ERR3357575_1_kneaddata_paired	Firmicutes	12188	P	193381	3500	196881	0.00645
ERR3357575_1_kneaddata_paired	Desulfobacterota_A	11509	P	184157	390	184547	0.00605
ERR3357575_1_kneaddata_paired	Cyanobacteria	9876	P	2698	33	2731	0.00009
ERR3357575_1_kneaddata_paired	Actinobacteriota	615	P	1479	4	1483	0.00005
ERR3357575_1_kneaddata_paired	Campylobacterota	8700	P	1110	0	1110	0.00004
ERR3357575_1_kneaddata_paired	Spirochaetota	32587	P	451	0	451	0.00001
ERR3357575_1_kneaddata_paired	Firmicutes_C	17613	P	251	0	251	0.00001
ERR3357575_1_kneaddata_paired	Deferribacterota	10822	P	182	0	182	0.00001
ERR3357575_1_kneaddata_paired	Thermotogota	33086	P	82	0	82	0.00000
ERR3357575_1_kneaddata_paired	Firmicutes_B	17289	P	15	0	15	0.00000
ERR3357575_1_kneaddata_paired	Firmicutes_I	18140	P	1	0	1	0.00000
ERR3357576_1_kneaddata_paired	Firmicutes_A	14608	P	10586248	68270	10654518	0.83986
ERR3357576_1_kneaddata_paired	Bacteroidota	4587	P	1615911	2643	1618554	0.12759
ERR3357576_1_kneaddata_paired	Firmicutes	12188	P	357120	4095	361215	0.02847
ERR3357576_1_kneaddata_paired	Deferribacterota	10822	P	30553	116	30669	0.00242
ERR3357576_1_kneaddata_paired	Actinobacteriota	615	P	10644	24	10668	0.00084
ERR3357576_1_kneaddata_paired	Firmicutes_B	17289	P	5206	195	5401	0.00043
ERR3357576_1_kneaddata_paired	Desulfobacterota_A	11509	P	1826	263	2089	0.00016
ERR3357576_1_kneaddata_paired	Cyanobacteria	9876	P	1152	41	1193	0.00009
ERR3357576_1_kneaddata_paired	Proteobacteria	22518	P	854	6	860	0.00007
ERR3357576_1_kneaddata_paired	Verrucomicrobiota	33333	P	293	15	308	0.00002
ERR3357576_1_kneaddata_paired	Spirochaetota	32587	P	189	0	189	0.00001
ERR3357576_1_kneaddata_paired	Campylobacterota	8700	P	173	0	173	0.00001
ERR3357576_1_kneaddata_paired	Firmicutes_C	17613	P	107	0	107	0.00001
ERR3357576_1_kneaddata_paired	Firmicutes_I	18140	P	59	0	59	0.00000
ERR3357576_1_kneaddata_paired	Thermotogota	33086	P	56	0	56	0.00000
ERR3357576_1_kneaddata_paired	Elusimicrobiota	11888	P	11	0	11	0.00000
ERR3357577_1_kneaddata_paired	Firmicutes_A	14608	P	1925340	18293	1943633	0.60819
ERR3357577_1_kneaddata_paired	Bacteroidota	4587	P	1081168	2341	1083509	0.33905
ERR3357577_1_kneaddata_paired	Firmicutes	12188	P	149873	1906	151779	0.04749
ERR3357577_1_kneaddata_paired	Deferribacterota	10822	P	7951	43	7994	0.00250
ERR3357577_1_kneaddata_paired	Actinobacteriota	615	P	6394	19	6413	0.00201
ERR3357577_1_kneaddata_paired	Firmicutes_B	17289	P	978	52	1030	0.00032
ERR3357577_1_kneaddata_paired	Cyanobacteria	9876	P	426	14	440	0.00014
ERR3357577_1_kneaddata_paired	Desulfobacterota_A	11509	P	319	62	381	0.00012
ERR3357577_1_kneaddata_paired	Proteobacteria	22518	P	318	2	320	0.00010
ERR3357577_1_kneaddata_paired	Spirochaetota	32587	P	84	0	84	0.00003
ERR3357577_1_kneaddata_paired	Campylobacterota	8700	P	67	0	67	0.00002
ERR3357577_1_kneaddata_paired	Verrucomicrobiota	33333	P	38	2	40	0.00001
ERR3357577_1_kneaddata_paired	Firmicutes_C	17613	P	21	0	21	0.00001
ERR3357577_1_kneaddata_paired	Firmicutes_I	18140	P	11	0	11	0.00000
ERR3357577_1_kneaddata_paired	Thermotogota	33086	P	9	0	9	0.00000
ERR3357577_1_kneaddata_paired	Elusimicrobiota	11888	P	4	0	4	0.00000
ERR3357578_1_kneaddata_paired	Firmicutes_A	14608	P	938069	9090	947159	0.48688
ERR3357578_1_kneaddata_paired	Bacteroidota	4587	P	898349	1788	900137	0.46271
ERR3357578_1_kneaddata_paired	Firmicutes	12188	P	82926	873	83799	0.04308
ERR3357578_1_kneaddata_paired	Actinobacteriota	615	P	8659	27	8686	0.00447
ERR3357578_1_kneaddata_paired	Cyanobacteria	9876	P	4817	22	4839	0.00249
ERR3357578_1_kneaddata_paired	Desulfobacterota_A	11509	P	253	60	313	0.00016
ERR3357578_1_kneaddata_paired	Proteobacteria	22518	P	158	0	158	0.00008
ERR3357578_1_kneaddata_paired	Campylobacterota	8700	P	83	0	83	0.00004
ERR3357578_1_kneaddata_paired	Spirochaetota	32587	P	58	0	58	0.00003
ERR3357578_1_kneaddata_paired	Verrucomicrobiota	33333	P	49	3	52	0.00003
ERR3357578_1_kneaddata_paired	Deferribacterota	10822	P	42	0	42	0.00002
ERR3357578_1_kneaddata_paired	Firmicutes_B	17289	P	21	1	22	0.00001
ERR3357578_1_kneaddata_paired	Firmicutes_I	18140	P	5	0	5	0.00000
ERR3357578_1_kneaddata_paired	Elusimicrobiota	11888	P	3	0	3	0.00000
ERR3357578_1_kneaddata_paired	Firmicutes_C	17613	P	2	0	2	0.00000
ERR3357578_1_kneaddata_paired	Thermotogota	33086	P	2	0	2	0.00000
ERR3357579_1_kneaddata_paired	Firmicutes_A	14608	P	7758677	48842	7807519	0.68594
ERR3357579_1_kneaddata_paired	Bacteroidota	4587	P	3093800	4848	3098648	0.27223
ERR3357579_1_kneaddata_paired	Firmicutes	12188	P	456914	4398	461312	0.04053
ERR3357579_1_kneaddata_paired	Actinobacteriota	615	P	9292	20	9312	0.00082
ERR3357579_1_kneaddata_paired	Cyanobacteria	9876	P	1246	18	1264	0.00011
ERR3357579_1_kneaddata_paired	Desulfobacterota_A	11509	P	1041	161	1202	0.00011
ERR3357579_1_kneaddata_paired	Proteobacteria	22518	P	879	4	883	0.00008
ERR3357579_1_kneaddata_paired	Deferribacterota	10822	P	614	2	616	0.00005
ERR3357579_1_kneaddata_paired	Verrucomicrobiota	33333	P	417	27	444	0.00004
ERR3357579_1_kneaddata_paired	Campylobacterota	8700	P	383	0	383	0.00003
ERR3357579_1_kneaddata_paired	Spirochaetota	32587	P	335	1	336	0.00003
ERR3357579_1_kneaddata_paired	Firmicutes_B	17289	P	220	9	229	0.00002
ERR3357579_1_kneaddata_paired	Firmicutes_I	18140	P	74	0	74	0.00001
ERR3357579_1_kneaddata_paired	Firmicutes_C	17613	P	47	0	47	0.00000
ERR3357579_1_kneaddata_paired	Thermotogota	33086	P	16	0	16	0.00000
ERR3357579_1_kneaddata_paired	Elusimicrobiota	11888	P	7	0	7	0.00000
ERR3357580_1_kneaddata_paired	Firmicutes_A	14608	P	2319875	18461	2338336	0.47772
ERR3357580_1_kneaddata_paired	Bacteroidota	4587	P	2211352	4137	2215489	0.45263
ERR3357580_1_kneaddata_paired	Firmicutes	12188	P	326534	3486	330020	0.06742
ERR3357580_1_kneaddata_paired	Actinobacteriota	615	P	8042	17	8059	0.00165
ERR3357580_1_kneaddata_paired	Cyanobacteria	9876	P	979	17	996	0.00020
ERR3357580_1_kneaddata_paired	Proteobacteria	22518	P	600	1	601	0.00012
ERR3357580_1_kneaddata_paired	Desulfobacterota_A	11509	P	285	49	334	0.00007
ERR3357580_1_kneaddata_paired	Campylobacterota	8700	P	254	0	254	0.00005
ERR3357580_1_kneaddata_paired	Deferribacterota	10822	P	222	0	222	0.00005
ERR3357580_1_kneaddata_paired	Spirochaetota	32587	P	186	1	187	0.00004
ERR3357580_1_kneaddata_paired	Firmicutes_B	17289	P	93	4	97	0.00002
ERR3357580_1_kneaddata_paired	Verrucomicrobiota	33333	P	90	7	97	0.00002
ERR3357580_1_kneaddata_paired	Firmicutes_I	18140	P	29	0	29	0.00001
ERR3357580_1_kneaddata_paired	Firmicutes_C	17613	P	9	0	9	0.00000
ERR3357580_1_kneaddata_paired	Thermotogota	33086	P	9	0	9	0.00000
ERR3357581_1_kneaddata_paired	Firmicutes_A	14608	P	9708626	44410	9753036	0.78770
ERR3357581_1_kneaddata_paired	Bacteroidota	4587	P	1324778	1879	1326657	0.10715
ERR3357581_1_kneaddata_paired	Firmicutes	12188	P	1145101	7964	1153065	0.09313
ERR3357581_1_kneaddata_paired	Deferribacterota	10822	P	70205	222	70427	0.00569
ERR3357581_1_kneaddata_paired	Actinobacteriota	615	P	41852	83	41935	0.00339
ERR3357581_1_kneaddata_paired	Firmicutes_B	17289	P	29165	908	30073	0.00243
ERR3357581_1_kneaddata_paired	Proteobacteria	22518	P	3006	34	3040	0.00025
ERR3357581_1_kneaddata_paired	Desulfobacterota_A	11509	P	1268	138	1406	0.00011
ERR3357581_1_kneaddata_paired	Cyanobacteria	9876	P	1187	33	1220	0.00010
ERR3357581_1_kneaddata_paired	Verrucomicrobiota	33333	P	297	13	310	0.00003
ERR3357581_1_kneaddata_paired	Campylobacterota	8700	P	234	0	234	0.00002
ERR3357581_1_kneaddata_paired	Spirochaetota	32587	P	105	0	105	0.00001
ERR3357581_1_kneaddata_paired	Firmicutes_C	17613	P	96	0	96	0.00001
ERR3357581_1_kneaddata_paired	Firmicutes_I	18140	P	68	0	68	0.00001
ERR3357581_1_kneaddata_paired	Thermotogota	33086	P	29	0	29	0.00000
ERR3357581_1_kneaddata_paired	Elusimicrobiota	11888	P	6	0	6	0.00000
ERR3357582_1_kneaddata_paired	Firmicutes_A	14608	P	3317996	25328	3343324	0.78349
ERR3357582_1_kneaddata_paired	Firmicutes	12188	P	447940	4753	452693	0.10609
ERR3357582_1_kneaddata_paired	Bacteroidota	4587	P	415829	918	416747	0.09766
ERR3357582_1_kneaddata_paired	Actinobacteriota	615	P	40468	142	40610	0.00952
ERR3357582_1_kneaddata_paired	Deferribacterota	10822	P	7783	43	7826	0.00183
ERR3357582_1_kneaddata_paired	Cyanobacteria	9876	P	2378	24	2402	0.00056
ERR3357582_1_kneaddata_paired	Firmicutes_B	17289	P	2090	116	2206	0.00052
ERR3357582_1_kneaddata_paired	Proteobacteria	22518	P	566	11	577	0.00014
ERR3357582_1_kneaddata_paired	Desulfobacterota_A	11509	P	421	91	512	0.00012
ERR3357582_1_kneaddata_paired	Verrucomicrobiota	33333	P	109	8	117	0.00003
ERR3357582_1_kneaddata_paired	Campylobacterota	8700	P	78	0	78	0.00002
ERR3357582_1_kneaddata_paired	Spirochaetota	32587	P	34	0	34	0.00001
ERR3357582_1_kneaddata_paired	Firmicutes_I	18140	P	28	0	28	0.00001
ERR3357582_1_kneaddata_paired	Firmicutes_C	17613	P	25	0	25	0.00001
ERR3357582_1_kneaddata_paired	Thermotogota	33086	P	15	0	15	0.00000
ERR3357582_1_kneaddata_paired	Elusimicrobiota	11888	P	5	0	5	0.00000
ERR3357583_1_kneaddata_paired	Firmicutes_A	14608	P	9388119	46512	9434631	0.90264
ERR3357583_1_kneaddata_paired	Bacteroidota	4587	P	561050	1020	562070	0.05377
ERR3357583_1_kneaddata_paired	Firmicutes	12188	P	341329	3340	344669	0.03298
ERR3357583_1_kneaddata_paired	Deferribacterota	10822	P	76197	275	76472	0.00732
ERR3357583_1_kneaddata_paired	Actinobacteriota	615	P	16218	41	16259	0.00156
ERR3357583_1_kneaddata_paired	Firmicutes_B	17289	P	12029	429	12458	0.00119
ERR3357583_1_kneaddata_paired	Proteobacteria	22518	P	1804	29	1833	0.00018
ERR3357583_1_kneaddata_paired	Cyanobacteria	9876	P	1483	53	1536	0.00015
ERR3357583_1_kneaddata_paired	Desulfobacterota_A	11509	P	1302	178	1480	0.00014
ERR3357583_1_kneaddata_paired	Verrucomicrobiota	33333	P	399	21	420	0.00004
ERR3357583_1_kneaddata_paired	Campylobacterota	8700	P	169	0	169	0.00002
ERR3357583_1_kneaddata_paired	Spirochaetota	32587	P	123	0	123	0.00001
ERR3357583_1_kneaddata_paired	Firmicutes_C	17613	P	83	0	83	0.00001
ERR3357583_1_kneaddata_paired	Firmicutes_I	18140	P	69	0	69	0.00001
ERR3357583_1_kneaddata_paired	Thermotogota	33086	P	25	0	25	0.00000
ERR3357583_1_kneaddata_paired	Elusimicrobiota	11888	P	6	0	6	0.00000
ERR3357584_1_kneaddata_paired	Firmicutes_A	14608	P	1853270	13723	1866993	0.52009
ERR3357584_1_kneaddata_paired	Bacteroidota	4587	P	1093779	2537	1096316	0.30540
ERR3357584_1_kneaddata_paired	Firmicutes	12188	P	559650	6576	566226	0.15773
ERR3357584_1_kneaddata_paired	Actinobacteriota	615	P	28760	123	28883	0.00805
ERR3357584_1_kneaddata_paired	Firmicutes_B	17289	P	17168	998	18166	0.00506
ERR3357584_1_kneaddata_paired	Deferribacterota	10822	P	8390	48	8438	0.00235
ERR3357584_1_kneaddata_paired	Proteobacteria	22518	P	3213	77	3290	0.00092
ERR3357584_1_kneaddata_paired	Cyanobacteria	9876	P	843	13	856	0.00024
ERR3357584_1_kneaddata_paired	Desulfobacterota_A	11509	P	245	53	298	0.00008
ERR3357584_1_kneaddata_paired	Campylobacterota	8700	P	122	0	122	0.00003
ERR3357584_1_kneaddata_paired	Verrucomicrobiota	33333	P	71	4	75	0.00002
ERR3357584_1_kneaddata_paired	Spirochaetota	32587	P	47	0	47	0.00001
ERR3357584_1_kneaddata_paired	Firmicutes_I	18140	P	20	0	20	0.00001
ERR3357584_1_kneaddata_paired	Firmicutes_C	17613	P	19	0	19	0.00001
ERR3357584_1_kneaddata_paired	Thermotogota	33086	P	4	0	4	0.00000
ERR3357585_1_kneaddata_paired	Firmicutes_A	14608	P	261420	2214	263634	0.58156
ERR3357585_1_kneaddata_paired	Firmicutes	12188	P	109844	1405	111249	0.24541
ERR3357585_1_kneaddata_paired	Bacteroidota	4587	P	69614	189	69803	0.15398
ERR3357585_1_kneaddata_paired	Actinobacteriota	615	P	5405	22	5427	0.01197
ERR3357585_1_kneaddata_paired	Deferribacterota	10822	P	1432	9	1441	0.00318
ERR3357585_1_kneaddata_paired	Cyanobacteria	9876	P	1395	7	1402	0.00309
ERR3357585_1_kneaddata_paired	Firmicutes_B	17289	P	203	13	216	0.00048
ERR3357585_1_kneaddata_paired	Proteobacteria	22518	P	61	0	61	0.00014
ERR3357585_1_kneaddata_paired	Desulfobacterota_A	11509	P	41	10	51	0.00011
ERR3357585_1_kneaddata_paired	Verrucomicrobiota	33333	P	13	1	14	0.00003
ERR3357585_1_kneaddata_paired	Campylobacterota	8700	P	7	0	7	0.00002
ERR3357585_1_kneaddata_paired	Firmicutes_I	18140	P	5	0	5	0.00001
ERR3357585_1_kneaddata_paired	Spirochaetota	32587	P	3	0	3	0.00001
ERR3357585_1_kneaddata_paired	Firmicutes_C	17613	P	1	0	1	0.00000
ERR3357585_1_kneaddata_paired	Thermotogota	33086	P	1	0	1	0.00000
ERR3357586_1_kneaddata_paired	Firmicutes_A	14608	P	7473128	44037	7517165	0.85816
ERR3357586_1_kneaddata_paired	Bacteroidota	4587	P	683852	1352	685204	0.07822
ERR3357586_1_kneaddata_paired	Firmicutes	12188	P	443711	5138	448849	0.05124
ERR3357586_1_kneaddata_paired	Deferribacterota	10822	P	81978	360	82338	0.00940
ERR3357586_1_kneaddata_paired	Actinobacteriota	615	P	11479	35	11514	0.00131
ERR3357586_1_kneaddata_paired	Firmicutes_B	17289	P	10000	434	10434	0.00119
ERR3357586_1_kneaddata_paired	Proteobacteria	22518	P	1279	19	1298	0.00015
ERR3357586_1_kneaddata_paired	Desulfobacterota_A	11509	P	1110	167	1277	0.00015
ERR3357586_1_kneaddata_paired	Cyanobacteria	9876	P	748	23	771	0.00009
ERR3357586_1_kneaddata_paired	Verrucomicrobiota	33333	P	340	21	361	0.00004
ERR3357586_1_kneaddata_paired	Campylobacterota	8700	P	149	0	149	0.00002
ERR3357586_1_kneaddata_paired	Firmicutes_C	17613	P	98	0	98	0.00001
ERR3357586_1_kneaddata_paired	Spirochaetota	32587	P	98	0	98	0.00001
ERR3357586_1_kneaddata_paired	Firmicutes_I	18140	P	78	0	78	0.00001
ERR3357586_1_kneaddata_paired	Thermotogota	33086	P	19	0	19	0.00000
ERR3357586_1_kneaddata_paired	Elusimicrobiota	11888	P	11	0	11	0.00000
ERR3357587_1_kneaddata_paired	Firmicutes_A	14608	P	3289379	23267	3312646	0.51668
ERR3357587_1_kneaddata_paired	Bacteroidota	4587	P	2047212	3926	2051138	0.31992
ERR3357587_1_kneaddata_paired	Firmicutes	12188	P	964426	10903	975329	0.15212
ERR3357587_1_kneaddata_paired	Actinobacteriota	615	P	23013	87	23100	0.00360
ERR3357587_1_kneaddata_paired	Firmicutes_B	17289	P	22980	1206	24186	0.00377
ERR3357587_1_kneaddata_paired	Deferribacterota	10822	P	20621	109	20730	0.00323
ERR3357587_1_kneaddata_paired	Proteobacteria	22518	P	2646	50	2696	0.00042
ERR3357587_1_kneaddata_paired	Desulfobacterota_A	11509	P	566	102	668	0.00010
ERR3357587_1_kneaddata_paired	Cyanobacteria	9876	P	505	12	517	0.00008
ERR3357587_1_kneaddata_paired	Campylobacterota	8700	P	161	0	161	0.00003
ERR3357587_1_kneaddata_paired	Verrucomicrobiota	33333	P	132	9	141	0.00002
ERR3357587_1_kneaddata_paired	Spirochaetota	32587	P	69	0	69	0.00001
ERR3357587_1_kneaddata_paired	Firmicutes_I	18140	P	35	0	35	0.00001
ERR3357587_1_kneaddata_paired	Firmicutes_C	17613	P	29	0	29	0.00000
ERR3357587_1_kneaddata_paired	Thermotogota	33086	P	12	0	12	0.00000
ERR3357587_1_kneaddata_paired	Elusimicrobiota	11888	P	3	0	3	0.00000
ERR3357588_1_kneaddata_paired	Firmicutes_A	14608	P	140708	1879	142587	0.57325
ERR3357588_1_kneaddata_paired	Bacteroidota	4587	P	59139	150	59289	0.23837
ERR3357588_1_kneaddata_paired	Firmicutes	12188	P	41502	450	41952	0.16867
ERR3357588_1_kneaddata_paired	Actinobacteriota	615	P	3395	11	3406	0.01369
ERR3357588_1_kneaddata_paired	Cyanobacteria	9876	P	1325	5	1330	0.00535
ERR3357588_1_kneaddata_paired	Proteobacteria	22518	P	46	0	46	0.00019
ERR3357588_1_kneaddata_paired	Deferribacterota	10822	P	43	0	43	0.00017
ERR3357588_1_kneaddata_paired	Firmicutes_B	17289	P	30	1	31	0.00013
ERR3357588_1_kneaddata_paired	Campylobacterota	8700	P	19	0	19	0.00008
ERR3357588_1_kneaddata_paired	Desulfobacterota_A	11509	P	17	3	20	0.00008
ERR3357588_1_kneaddata_paired	Firmicutes_I	18140	P	3	0	3	0.00001
ERR3357588_1_kneaddata_paired	Spirochaetota	32587	P	1	0	1	0.00000
ERR3357588_1_kneaddata_paired	Thermotogota	33086	P	1	0	1	0.00000
ERR3357588_1_kneaddata_paired	Verrucomicrobiota	33333	P	1	0	1	0.00000
ERR3357589_1_kneaddata_paired	Firmicutes_A	14608	P	9646159	48193	9694352	0.70932
ERR3357589_1_kneaddata_paired	Bacteroidota	4587	P	3480343	3853	3484196	0.25493
ERR3357589_1_kneaddata_paired	Firmicutes	12188	P	446624	2972	449596	0.03290
ERR3357589_1_kneaddata_paired	Actinobacteriota	615	P	22227	36	22263	0.00163
ERR3357589_1_kneaddata_paired	Deferribacterota	10822	P	8519	25	8544	0.00063
ERR3357589_1_kneaddata_paired	Firmicutes_B	17289	P	2810	82	2892	0.00021
ERR3357589_1_kneaddata_paired	Cyanobacteria	9876	P	1577	33	1610	0.00012
ERR3357589_1_kneaddata_paired	Desulfobacterota_A	11509	P	1268	135	1403	0.00010
ERR3357589_1_kneaddata_paired	Proteobacteria	22518	P	1109	3	1112	0.00008
ERR3357589_1_kneaddata_paired	Spirochaetota	32587	P	339	1	340	0.00002
ERR3357589_1_kneaddata_paired	Campylobacterota	8700	P	309	0	309	0.00002
ERR3357589_1_kneaddata_paired	Verrucomicrobiota	33333	P	280	11	291	0.00002
ERR3357589_1_kneaddata_paired	Firmicutes_I	18140	P	67	0	67	0.00000
ERR3357589_1_kneaddata_paired	Firmicutes_C	17613	P	38	0	38	0.00000
ERR3357589_1_kneaddata_paired	Thermotogota	33086	P	24	0	24	0.00000
ERR3357589_1_kneaddata_paired	Elusimicrobiota	11888	P	7	0	7	0.00000
ERR3357590_1_kneaddata_paired	Bacteroidota	4587	P	8415129	39899	8455028	0.59273
ERR3357590_1_kneaddata_paired	Firmicutes_A	14608	P	5184758	33850	5218608	0.36584
ERR3357590_1_kneaddata_paired	Firmicutes	12188	P	435826	2726	438552	0.03074
ERR3357590_1_kneaddata_paired	Actinobacteriota	615	P	73592	296	73888	0.00518
ERR3357590_1_kneaddata_paired	Desulfobacterota_A	11509	P	48649	276	48925	0.00343
ERR3357590_1_kneaddata_paired	Proteobacteria	22518	P	16941	179	17120	0.00120
ERR3357590_1_kneaddata_paired	Cyanobacteria	9876	P	6189	105	6294	0.00044
ERR3357590_1_kneaddata_paired	Deferribacterota	10822	P	3853	14	3867	0.00027
ERR3357590_1_kneaddata_paired	Firmicutes_B	17289	P	1509	56	1565	0.00011
ERR3357590_1_kneaddata_paired	Verrucomicrobiota	33333	P	354	17	371	0.00003
ERR3357590_1_kneaddata_paired	Spirochaetota	32587	P	108	0	108	0.00001
ERR3357590_1_kneaddata_paired	Campylobacterota	8700	P	85	0	85	0.00001
ERR3357590_1_kneaddata_paired	Firmicutes_I	18140	P	64	0	64	0.00000
ERR3357590_1_kneaddata_paired	Firmicutes_C	17613	P	49	0	49	0.00000
ERR3357590_1_kneaddata_paired	Elusimicrobiota	11888	P	13	0	13	0.00000
ERR3357590_1_kneaddata_paired	Thermotogota	33086	P	6	0	6	0.00000
ERR3357591_1_kneaddata_paired	Firmicutes_A	14608	P	8855638	43746	8899384	0.85545
ERR3357591_1_kneaddata_paired	Bacteroidota	4587	P	1341899	5816	1347715	0.12955
ERR3357591_1_kneaddata_paired	Firmicutes	12188	P	85779	1806	87585	0.00842
ERR3357591_1_kneaddata_paired	Deferribacterota	10822	P	18680	62	18742	0.00180
ERR3357591_1_kneaddata_paired	Actinobacteriota	615	P	16149	37	16186	0.00156
ERR3357591_1_kneaddata_paired	Cyanobacteria	9876	P	15540	237	15777	0.00152
ERR3357591_1_kneaddata_paired	Desulfobacterota_A	11509	P	11591	215	11806	0.00113
ERR3357591_1_kneaddata_paired	Proteobacteria	22518	P	3953	65	4018	0.00039
ERR3357591_1_kneaddata_paired	Firmicutes_B	17289	P	1293	43	1336	0.00013
ERR3357591_1_kneaddata_paired	Verrucomicrobiota	33333	P	203	8	211	0.00002
ERR3357591_1_kneaddata_paired	Spirochaetota	32587	P	189	0	189	0.00002
ERR3357591_1_kneaddata_paired	Firmicutes_C	17613	P	85	0	85	0.00001
ERR3357591_1_kneaddata_paired	Campylobacterota	8700	P	68	0	68	0.00001
ERR3357591_1_kneaddata_paired	Firmicutes_I	18140	P	52	0	52	0.00001
ERR3357591_1_kneaddata_paired	Elusimicrobiota	11888	P	5	0	5	0.00000
ERR3357591_1_kneaddata_paired	Thermotogota	33086	P	3	0	3	0.00000
ERR3357592_1_kneaddata_paired	Firmicutes_A	14608	P	18014013	105753	18119766	0.59408
ERR3357592_1_kneaddata_paired	Bacteroidota	4587	P	11502621	54810	11557431	0.37893
ERR3357592_1_kneaddata_paired	Firmicutes	12188	P	547941	4785	552726	0.01812
ERR3357592_1_kneaddata_paired	Actinobacteriota	615	P	99034	336	99370	0.00326
ERR3357592_1_kneaddata_paired	Desulfobacterota_A	11509	P	81983	627	82610	0.00271
ERR3357592_1_kneaddata_paired	Cyanobacteria	9876	P	32404	365	32769	0.00107
ERR3357592_1_kneaddata_paired	Deferribacterota	10822	P	25709	103	25812	0.00085
ERR3357592_1_kneaddata_paired	Proteobacteria	22518	P	24550	285	24835	0.00081
ERR3357592_1_kneaddata_paired	Firmicutes_B	17289	P	3534	141	3675	0.00012
ERR3357592_1_kneaddata_paired	Verrucomicrobiota	33333	P	553	28	581	0.00002
ERR3357592_1_kneaddata_paired	Spirochaetota	32587	P	317	0	317	0.00001
ERR3357592_1_kneaddata_paired	Firmicutes_C	17613	P	221	0	221	0.00001
ERR3357592_1_kneaddata_paired	Campylobacterota	8700	P	164	0	164	0.00001
ERR3357592_1_kneaddata_paired	Firmicutes_I	18140	P	134	0	134	0.00000
ERR3357592_1_kneaddata_paired	Elusimicrobiota	11888	P	34	0	34	0.00000
ERR3357592_1_kneaddata_paired	Thermotogota	33086	P	7	0	7	0.00000
ERR3357593_1_kneaddata_paired	Firmicutes_A	14608	P	5732707	44736	5777443	0.59797
ERR3357593_1_kneaddata_paired	Bacteroidota	4587	P	2624947	10175	2635122	0.27274
ERR3357593_1_kneaddata_paired	Firmicutes	12188	P	1160543	8793	1169336	0.12103
ERR3357593_1_kneaddata_paired	Actinobacteriota	615	P	54070	256	54326	0.00562
ERR3357593_1_kneaddata_paired	Desulfobacterota_A	11509	P	9104	142	9246	0.00096
ERR3357593_1_kneaddata_paired	Proteobacteria	22518	P	7916	135	8051	0.00083
ERR3357593_1_kneaddata_paired	Cyanobacteria	9876	P	5854	68	5922	0.00061
ERR3357593_1_kneaddata_paired	Firmicutes_B	17289	P	951	51	1002	0.00010
ERR3357593_1_kneaddata_paired	Deferribacterota	10822	P	670	3	673	0.00007
ERR3357593_1_kneaddata_paired	Verrucomicrobiota	33333	P	236	16	252	0.00003
ERR3357593_1_kneaddata_paired	Campylobacterota	8700	P	109	0	109	0.00001
ERR3357593_1_kneaddata_paired	Spirochaetota	32587	P	88	0	88	0.00001
ERR3357593_1_kneaddata_paired	Firmicutes_I	18140	P	56	0	56	0.00001
ERR3357593_1_kneaddata_paired	Firmicutes_C	17613	P	36	0	36	0.00000
ERR3357593_1_kneaddata_paired	Thermotogota	33086	P	12	0	12	0.00000
ERR3357593_1_kneaddata_paired	Elusimicrobiota	11888	P	4	0	4	0.00000
ERR3357594_1_kneaddata_paired	Firmicutes_A	14608	P	3134479	12476	3146955	0.83419
ERR3357594_1_kneaddata_paired	Bacteroidota	4587	P	522770	1434	524204	0.13896
ERR3357594_1_kneaddata_paired	Firmicutes	12188	P	81405	681	82086	0.02176
ERR3357594_1_kneaddata_paired	Actinobacteriota	615	P	10232	14	10246	0.00272
ERR3357594_1_kneaddata_paired	Desulfobacterota_A	11509	P	3227	46	3273	0.00087
ERR3357594_1_kneaddata_paired	Proteobacteria	22518	P	2126	20	2146	0.00057
ERR3357594_1_kneaddata_paired	Cyanobacteria	9876	P	1797	55	1852	0.00049
ERR3357594_1_kneaddata_paired	Deferribacterota	10822	P	1068	2	1070	0.00028
ERR3357594_1_kneaddata_paired	Firmicutes_B	17289	P	411	9	420	0.00011
ERR3357594_1_kneaddata_paired	Spirochaetota	32587	P	62	0	62	0.00002
ERR3357594_1_kneaddata_paired	Campylobacterota	8700	P	59	0	59	0.00002
ERR3357594_1_kneaddata_paired	Verrucomicrobiota	33333	P	47	1	48	0.00001
ERR3357594_1_kneaddata_paired	Firmicutes_I	18140	P	24	0	24	0.00001
ERR3357594_1_kneaddata_paired	Firmicutes_C	17613	P	12	0	12	0.00000
ERR3357594_1_kneaddata_paired	Elusimicrobiota	11888	P	6	0	6	0.00000
ERR3357594_1_kneaddata_paired	Thermotogota	33086	P	1	0	1	0.00000
ERR3357615_1_kneaddata_paired	Bacteroidota	4587	P	14636087	82201	14718288	0.58960
ERR3357615_1_kneaddata_paired	Firmicutes_A	14608	P	7979999	44315	8024314	0.32145
ERR3357615_1_kneaddata_paired	Campylobacterota	8700	P	813424	36	813460	0.03259
ERR3357615_1_kneaddata_paired	Desulfobacterota_A	11509	P	552317	3831	556148	0.02228
ERR3357615_1_kneaddata_paired	Deferribacterota	10822	P	368236	930	369166	0.01479
ERR3357615_1_kneaddata_paired	Cyanobacteria	9876	P	314826	895	315721	0.01265
ERR3357615_1_kneaddata_paired	Firmicutes	12188	P	98657	1351	100008	0.00401
ERR3357615_1_kneaddata_paired	Proteobacteria	22518	P	34666	105	34771	0.00139
ERR3357615_1_kneaddata_paired	Actinobacteriota	615	P	28819	46	28865	0.00116
ERR3357615_1_kneaddata_paired	Spirochaetota	32587	P	745	0	745	0.00003
ERR3357615_1_kneaddata_paired	Verrucomicrobiota	33333	P	715	26	741	0.00003
ERR3357615_1_kneaddata_paired	Firmicutes_B	17289	P	454	11	465	0.00002
ERR3357615_1_kneaddata_paired	Firmicutes_I	18140	P	140	0	140	0.00001
ERR3357615_1_kneaddata_paired	Firmicutes_C	17613	P	124	0	124	0.00000
ERR3357615_1_kneaddata_paired	Thermotogota	33086	P	19	0	19	0.00000
ERR3357615_1_kneaddata_paired	Elusimicrobiota	11888	P	13	0	13	0.00000
ERR3357616_1_kneaddata_paired	Firmicutes_A	14608	P	13287385	52905	13340290	0.66167
ERR3357616_1_kneaddata_paired	Bacteroidota	4587	P	4218192	58763	4276955	0.21214
ERR3357616_1_kneaddata_paired	Campylobacterota	8700	P	872443	162	872605	0.04328
ERR3357616_1_kneaddata_paired	Deferribacterota	10822	P	858373	2965	861338	0.04272
ERR3357616_1_kneaddata_paired	Firmicutes	12188	P	377046	3641	380687	0.01888
ERR3357616_1_kneaddata_paired	Desulfobacterota_A	11509	P	305262	3024	308286	0.01529
ERR3357616_1_kneaddata_paired	Proteobacteria	22518	P	96538	168	96706	0.00480
ERR3357616_1_kneaddata_paired	Actinobacteriota	615	P	17334	44	17378	0.00086
ERR3357616_1_kneaddata_paired	Cyanobacteria	9876	P	4463	74	4537	0.00023
ERR3357616_1_kneaddata_paired	Spirochaetota	32587	P	1158	3	1161	0.00006
ERR3357616_1_kneaddata_paired	Verrucomicrobiota	33333	P	593	30	623	0.00003
ERR3357616_1_kneaddata_paired	Firmicutes_B	17289	P	576	19	595	0.00003
ERR3357616_1_kneaddata_paired	Firmicutes_I	18140	P	136	0	136	0.00001
ERR3357616_1_kneaddata_paired	Firmicutes_C	17613	P	110	0	110	0.00001
ERR3357616_1_kneaddata_paired	Thermotogota	33086	P	37	0	37	0.00000
ERR3357616_1_kneaddata_paired	Elusimicrobiota	11888	P	26	0	26	0.00000
ERR3357617_1_kneaddata_paired	Firmicutes_A	14608	P	9293545	42247	9335792	0.80914
ERR3357617_1_kneaddata_paired	Bacteroidota	4587	P	1186065	12527	1198592	0.10388
ERR3357617_1_kneaddata_paired	Campylobacterota	8700	P	420807	228	421035	0.03649
ERR3357617_1_kneaddata_paired	Firmicutes	12188	P	388688	2394	391082	0.03390
ERR3357617_1_kneaddata_paired	Desulfobacterota_A	11509	P	130539	1450	131989	0.01144
ERR3357617_1_kneaddata_paired	Deferribacterota	10822	P	22856	6	22862	0.00198
ERR3357617_1_kneaddata_paired	Cyanobacteria	9876	P	22070	95	22165	0.00192
ERR3357617_1_kneaddata_paired	Proteobacteria	22518	P	10122	9	10131	0.00088
ERR3357617_1_kneaddata_paired	Actinobacteriota	615	P	2863	7	2870	0.00025
ERR3357617_1_kneaddata_paired	Verrucomicrobiota	33333	P	454	24	478	0.00004
ERR3357617_1_kneaddata_paired	Firmicutes_B	17289	P	336	12	348	0.00003
ERR3357617_1_kneaddata_paired	Spirochaetota	32587	P	333	0	333	0.00003
ERR3357617_1_kneaddata_paired	Firmicutes_C	17613	P	138	0	138	0.00001
ERR3357617_1_kneaddata_paired	Firmicutes_I	18140	P	73	0	73	0.00001
ERR3357617_1_kneaddata_paired	Elusimicrobiota	11888	P	17	0	17	0.00000
ERR3357617_1_kneaddata_paired	Thermotogota	33086	P	12	0	12	0.00000
ERR3357618_1_kneaddata_paired	Firmicutes_A	14608	P	11430408	37614	11468022	0.83951
ERR3357618_1_kneaddata_paired	Bacteroidota	4587	P	967167	11444	978611	0.07164
ERR3357618_1_kneaddata_paired	Deferribacterota	10822	P	360170	1252	361422	0.02646
ERR3357618_1_kneaddata_paired	Desulfobacterota_A	11509	P	359925	3392	363317	0.02660
ERR3357618_1_kneaddata_paired	Firmicutes	12188	P	243048	6628	249676	0.01828
ERR3357618_1_kneaddata_paired	Campylobacterota	8700	P	222682	64	222746	0.01631
ERR3357618_1_kneaddata_paired	Proteobacteria	22518	P	5417	8	5425	0.00040
ERR3357618_1_kneaddata_paired	Actinobacteriota	615	P	5045	6	5051	0.00037
ERR3357618_1_kneaddata_paired	Cyanobacteria	9876	P	4291	93	4384	0.00032
ERR3357618_1_kneaddata_paired	Spirochaetota	32587	P	682	0	682	0.00005
ERR3357618_1_kneaddata_paired	Verrucomicrobiota	33333	P	461	23	484	0.00004
ERR3357618_1_kneaddata_paired	Firmicutes_B	17289	P	291	9	300	0.00002
ERR3357618_1_kneaddata_paired	Firmicutes_I	18140	P	147	0	147	0.00001
ERR3357618_1_kneaddata_paired	Firmicutes_C	17613	P	56	0	56	0.00000
ERR3357618_1_kneaddata_paired	Thermotogota	33086	P	20	0	20	0.00000
ERR3357618_1_kneaddata_paired	Elusimicrobiota	11888	P	10	0	10	0.00000
ERR3357619_1_kneaddata_paired	Bacteroidota	4587	P	11940934	103890	12044824	0.49429
ERR3357619_1_kneaddata_paired	Firmicutes_A	14608	P	11796356	35623	11831979	0.48555
ERR3357619_1_kneaddata_paired	Campylobacterota	8700	P	195720	8	195728	0.00803
ERR3357619_1_kneaddata_paired	Firmicutes	12188	P	148704	1404	150108	0.00616
ERR3357619_1_kneaddata_paired	Deferribacterota	10822	P	120654	343	120997	0.00497
ERR3357619_1_kneaddata_paired	Desulfobacterota_A	11509	P	6100	208	6308	0.00026
ERR3357619_1_kneaddata_paired	Actinobacteriota	615	P	5506	25	5531	0.00023
ERR3357619_1_kneaddata_paired	Proteobacteria	22518	P	5470	16	5486	0.00023
ERR3357619_1_kneaddata_paired	Cyanobacteria	9876	P	4378	82	4460	0.00018
ERR3357619_1_kneaddata_paired	Verrucomicrobiota	33333	P	1157	49	1206	0.00005
ERR3357619_1_kneaddata_paired	Firmicutes_B	17289	P	634	17	651	0.00003
ERR3357619_1_kneaddata_paired	Firmicutes_C	17613	P	249	0	249	0.00001
ERR3357619_1_kneaddata_paired	Spirochaetota	32587	P	239	0	239	0.00001
ERR3357619_1_kneaddata_paired	Firmicutes_I	18140	P	190	0	190	0.00001
ERR3357619_1_kneaddata_paired	Elusimicrobiota	11888	P	24	0	24	0.00000
ERR3357619_1_kneaddata_paired	Thermotogota	33086	P	18	0	18	0.00000
ERR3357620_1_kneaddata_paired	Bacteroidota	4587	P	10145275	69737	10215012	0.52384
ERR3357620_1_kneaddata_paired	Firmicutes_A	14608	P	7365724	34593	7400317	0.37950
ERR3357620_1_kneaddata_paired	Campylobacterota	8700	P	614196	210	614406	0.03151
ERR3357620_1_kneaddata_paired	Desulfobacterota_A	11509	P	428598	4614	433212	0.02222
ERR3357620_1_kneaddata_paired	Firmicutes	12188	P	387703	5574	393277	0.02017
ERR3357620_1_kneaddata_paired	Proteobacteria	22518	P	232897	312	233209	0.01196
ERR3357620_1_kneaddata_paired	Deferribacterota	10822	P	114614	398	115012	0.00590
ERR3357620_1_kneaddata_paired	Cyanobacteria	9876	P	86184	842	87026	0.00446
ERR3357620_1_kneaddata_paired	Actinobacteriota	615	P	6208	24	6232	0.00032
ERR3357620_1_kneaddata_paired	Verrucomicrobiota	33333	P	866	43	909	0.00005
ERR3357620_1_kneaddata_paired	Spirochaetota	32587	P	616	1	617	0.00003
ERR3357620_1_kneaddata_paired	Firmicutes_B	17289	P	518	17	535	0.00003
ERR3357620_1_kneaddata_paired	Firmicutes_C	17613	P	154	0	154	0.00001
ERR3357620_1_kneaddata_paired	Firmicutes_I	18140	P	121	0	121	0.00001
ERR3357620_1_kneaddata_paired	Thermotogota	33086	P	27	0	27	0.00000
ERR3357620_1_kneaddata_paired	Elusimicrobiota	11888	P	20	0	20	0.00000
ERR3357621_1_kneaddata_paired	Firmicutes_A	14608	P	20050387	98211	20148598	0.68451
ERR3357621_1_kneaddata_paired	Bacteroidota	4587	P	6254596	67353	6321949	0.21478
ERR3357621_1_kneaddata_paired	Campylobacterota	8700	P	1737685	1045	1738730	0.05907
ERR3357621_1_kneaddata_paired	Firmicutes	12188	P	1102658	17983	1120641	0.03807
ERR3357621_1_kneaddata_paired	Desulfobacterota_A	11509	P	58176	246	58422	0.00198
ERR3357621_1_kneaddata_paired	Actinobacteriota	615	P	29412	73	29485	0.00100
ERR3357621_1_kneaddata_paired	Cyanobacteria	9876	P	13268	107	13375	0.00045
ERR3357621_1_kneaddata_paired	Proteobacteria	22518	P	1874	5	1879	0.00006
ERR3357621_1_kneaddata_paired	Verrucomicrobiota	33333	P	616	18	634	0.00002
ERR3357621_1_kneaddata_paired	Spirochaetota	32587	P	529	0	529	0.00002
ERR3357621_1_kneaddata_paired	Firmicutes_B	17289	P	316	8	324	0.00001
ERR3357621_1_kneaddata_paired	Deferribacterota	10822	P	293	0	293	0.00001
ERR3357621_1_kneaddata_paired	Firmicutes_I	18140	P	133	0	133	0.00000
ERR3357621_1_kneaddata_paired	Firmicutes_C	17613	P	128	0	128	0.00000
ERR3357621_1_kneaddata_paired	Elusimicrobiota	11888	P	23	0	23	0.00000
ERR3357621_1_kneaddata_paired	Thermotogota	33086	P	8	0	8	0.00000
ERR3357622_1_kneaddata_paired	Firmicutes_A	14608	P	12821481	51201	12872682	0.48498
ERR3357622_1_kneaddata_paired	Bacteroidota	4587	P	12039603	67759	12107362	0.45615
ERR3357622_1_kneaddata_paired	Firmicutes	12188	P	691739	13435	705174	0.02657
ERR3357622_1_kneaddata_paired	Campylobacterota	8700	P	486074	18	486092	0.01831
ERR3357622_1_kneaddata_paired	Cyanobacteria	9876	P	188091	235	188326	0.00710
ERR3357622_1_kneaddata_paired	Desulfobacterota_A	11509	P	126171	942	127113	0.00479
ERR3357622_1_kneaddata_paired	Deferribacterota	10822	P	31798	67	31865	0.00120
ERR3357622_1_kneaddata_paired	Actinobacteriota	615	P	16012	80	16092	0.00061
ERR3357622_1_kneaddata_paired	Proteobacteria	22518	P	6473	30	6503	0.00025
ERR3357622_1_kneaddata_paired	Verrucomicrobiota	33333	P	452	9	461	0.00002
ERR3357622_1_kneaddata_paired	Firmicutes_B	17289	P	311	6	317	0.00001
ERR3357622_1_kneaddata_paired	Spirochaetota	32587	P	251	0	251	0.00001
ERR3357622_1_kneaddata_paired	Firmicutes_I	18140	P	118	0	118	0.00000
ERR3357622_1_kneaddata_paired	Firmicutes_C	17613	P	90	0	90	0.00000
ERR3357622_1_kneaddata_paired	Elusimicrobiota	11888	P	19	0	19	0.00000
ERR3357622_1_kneaddata_paired	Thermotogota	33086	P	15	0	15	0.00000
ERR3357623_1_kneaddata_paired	Firmicutes_A	14608	P	19289810	89096	19378906	0.80200
ERR3357623_1_kneaddata_paired	Bacteroidota	4587	P	2313170	24517	2337687	0.09675
ERR3357623_1_kneaddata_paired	Campylobacterota	8700	P	1432657	76	1432733	0.05929
ERR3357623_1_kneaddata_paired	Desulfobacterota_A	11509	P	388628	3416	392044	0.01622
ERR3357623_1_kneaddata_paired	Cyanobacteria	9876	P	367161	1518	368679	0.01526
ERR3357623_1_kneaddata_paired	Firmicutes	12188	P	190268	4208	194476	0.00805
ERR3357623_1_kneaddata_paired	Deferribacterota	10822	P	49181	146	49327	0.00204
ERR3357623_1_kneaddata_paired	Actinobacteriota	615	P	5855	22	5877	0.00024
ERR3357623_1_kneaddata_paired	Proteobacteria	22518	P	1402	2	1404	0.00006
ERR3357623_1_kneaddata_paired	Verrucomicrobiota	33333	P	751	27	778	0.00003
ERR3357623_1_kneaddata_paired	Firmicutes_B	17289	P	428	12	440	0.00002
ERR3357623_1_kneaddata_paired	Spirochaetota	32587	P	304	0	304	0.00001
ERR3357623_1_kneaddata_paired	Firmicutes_I	18140	P	227	0	227	0.00001
ERR3357623_1_kneaddata_paired	Firmicutes_C	17613	P	220	0	220	0.00001
ERR3357623_1_kneaddata_paired	Thermotogota	33086	P	59	0	59	0.00000
ERR3357623_1_kneaddata_paired	Elusimicrobiota	11888	P	38	0	38	0.00000
ERR3357624_1_kneaddata_paired	Firmicutes_A	14608	P	21848405	119004	21967409	0.93787
ERR3357624_1_kneaddata_paired	Bacteroidota	4587	P	720165	12510	732675	0.03128
ERR3357624_1_kneaddata_paired	Campylobacterota	8700	P	399798	98	399896	0.01707
ERR3357624_1_kneaddata_paired	Firmicutes	12188	P	165868	4847	170715	0.00729
ERR3357624_1_kneaddata_paired	Desulfobacterota_A	11509	P	73490	1285	74775	0.00319
ERR3357624_1_kneaddata_paired	Actinobacteriota	615	P	45719	17	45736	0.00195
ERR3357624_1_kneaddata_paired	Cyanobacteria	9876	P	14250	598	14848	0.00063
ERR3357624_1_kneaddata_paired	Deferribacterota	10822	P	12724	3	12727	0.00054
ERR3357624_1_kneaddata_paired	Proteobacteria	22518	P	1430	4	1434	0.00006
ERR3357624_1_kneaddata_paired	Spirochaetota	32587	P	803	2	805	0.00003
ERR3357624_1_kneaddata_paired	Verrucomicrobiota	33333	P	633	39	672	0.00003
ERR3357624_1_kneaddata_paired	Firmicutes_B	17289	P	399	16	415	0.00002
ERR3357624_1_kneaddata_paired	Firmicutes_C	17613	P	263	0	263	0.00001
ERR3357624_1_kneaddata_paired	Firmicutes_I	18140	P	236	0	236	0.00001
ERR3357624_1_kneaddata_paired	Thermotogota	33086	P	16	0	16	0.00000
ERR3357624_1_kneaddata_paired	Elusimicrobiota	11888	P	11	0	11	0.00000
ERR3357625_1_kneaddata_paired	Firmicutes_A	14608	P	21400576	85904	21486480	0.89718
ERR3357625_1_kneaddata_paired	Bacteroidota	4587	P	1441784	10186	1451970	0.06063
ERR3357625_1_kneaddata_paired	Campylobacterota	8700	P	526411	32	526443	0.02198
ERR3357625_1_kneaddata_paired	Firmicutes	12188	P	328859	2829	331688	0.01385
ERR3357625_1_kneaddata_paired	Desulfobacterota_A	11509	P	131146	835	131981	0.00551
ERR3357625_1_kneaddata_paired	Deferribacterota	10822	P	6293	13	6306	0.00026
ERR3357625_1_kneaddata_paired	Actinobacteriota	615	P	4817	20	4837	0.00020
ERR3357625_1_kneaddata_paired	Proteobacteria	22518	P	3837	6	3843	0.00016
ERR3357625_1_kneaddata_paired	Cyanobacteria	9876	P	3772	43	3815	0.00016
ERR3357625_1_kneaddata_paired	Verrucomicrobiota	33333	P	478	15	493	0.00002
ERR3357625_1_kneaddata_paired	Firmicutes_B	17289	P	408	9	417	0.00002
ERR3357625_1_kneaddata_paired	Spirochaetota	32587	P	284	0	284	0.00001
ERR3357625_1_kneaddata_paired	Firmicutes_C	17613	P	162	0	162	0.00001
ERR3357625_1_kneaddata_paired	Firmicutes_I	18140	P	84	0	84	0.00000
ERR3357625_1_kneaddata_paired	Elusimicrobiota	11888	P	18	0	18	0.00000
ERR3357625_1_kneaddata_paired	Thermotogota	33086	P	7	0	7	0.00000
ERR3357626_1_kneaddata_paired	Firmicutes_A	14608	P	15650023	50976	15700999	0.59114
ERR3357626_1_kneaddata_paired	Bacteroidota	4587	P	9340158	67974	9408132	0.35422
ERR3357626_1_kneaddata_paired	Firmicutes	12188	P	742846	10847	753693	0.02838
ERR3357626_1_kneaddata_paired	Cyanobacteria	9876	P	276740	244	276984	0.01043
ERR3357626_1_kneaddata_paired	Campylobacterota	8700	P	251986	6	251992	0.00949
ERR3357626_1_kneaddata_paired	Deferribacterota	10822	P	66833	185	67018	0.00252
ERR3357626_1_kneaddata_paired	Actinobacteriota	615	P	47267	264	47531	0.00179
ERR3357626_1_kneaddata_paired	Desulfobacterota_A	11509	P	44405	297	44702	0.00168
ERR3357626_1_kneaddata_paired	Proteobacteria	22518	P	6076	23	6099	0.00023
ERR3357626_1_kneaddata_paired	Firmicutes_B	17289	P	1443	39	1482	0.00006
ERR3357626_1_kneaddata_paired	Spirochaetota	32587	P	948	2	950	0.00004
ERR3357626_1_kneaddata_paired	Verrucomicrobiota	33333	P	391	15	406	0.00002
ERR3357626_1_kneaddata_paired	Firmicutes_I	18140	P	228	0	228	0.00001
ERR3357626_1_kneaddata_paired	Firmicutes_C	17613	P	112	0	112	0.00000
ERR3357626_1_kneaddata_paired	Elusimicrobiota	11888	P	51	0	51	0.00000
ERR3357626_1_kneaddata_paired	Thermotogota	33086	P	31	0	31	0.00000
ERR3357627_1_kneaddata_paired	Bacteroidota	4587	P	15529569	99797	15629366	0.64681
ERR3357627_1_kneaddata_paired	Firmicutes_A	14608	P	5273626	27417	5301043	0.21938
ERR3357627_1_kneaddata_paired	Firmicutes	12188	P	1405319	10741	1416060	0.05860
ERR3357627_1_kneaddata_paired	Campylobacterota	8700	P	1314642	454	1315096	0.05442
ERR3357627_1_kneaddata_paired	Deferribacterota	10822	P	226453	849	227302	0.00941
ERR3357627_1_kneaddata_paired	Desulfobacterota_A	11509	P	181549	1867	183416	0.00759
ERR3357627_1_kneaddata_paired	Proteobacteria	22518	P	59036	71	59107	0.00245
ERR3357627_1_kneaddata_paired	Actinobacteriota	615	P	20473	58	20531	0.00085
ERR3357627_1_kneaddata_paired	Cyanobacteria	9876	P	10206	284	10490	0.00043
ERR3357627_1_kneaddata_paired	Spirochaetota	32587	P	479	0	479	0.00002
ERR3357627_1_kneaddata_paired	Verrucomicrobiota	33333	P	359	13	372	0.00002
ERR3357627_1_kneaddata_paired	Firmicutes_B	17289	P	298	11	309	0.00001
ERR3357627_1_kneaddata_paired	Firmicutes_I	18140	P	149	0	149	0.00001
ERR3357627_1_kneaddata_paired	Firmicutes_C	17613	P	82	0	82	0.00000
ERR3357627_1_kneaddata_paired	Thermotogota	33086	P	15	0	15	0.00000
ERR3357627_1_kneaddata_paired	Elusimicrobiota	11888	P	10	0	10	0.00000
ERR3357628_1_kneaddata_paired	Firmicutes_A	14608	P	12364090	63436	12427526	0.52766
ERR3357628_1_kneaddata_paired	Bacteroidota	4587	P	10290802	63421	10354223	0.43963
ERR3357628_1_kneaddata_paired	Campylobacterota	8700	P	349764	96	349860	0.01485
ERR3357628_1_kneaddata_paired	Firmicutes	12188	P	301103	4144	305247	0.01296
ERR3357628_1_kneaddata_paired	Desulfobacterota_A	11509	P	43278	266	43544	0.00185
ERR3357628_1_kneaddata_paired	Cyanobacteria	9876	P	37830	126	37956	0.00161
ERR3357628_1_kneaddata_paired	Proteobacteria	22518	P	21673	32	21705	0.00092
ERR3357628_1_kneaddata_paired	Actinobacteriota	615	P	9625	23	9648	0.00041
ERR3357628_1_kneaddata_paired	Verrucomicrobiota	33333	P	846	29	875	0.00004
ERR3357628_1_kneaddata_paired	Spirochaetota	32587	P	529	1	530	0.00002
ERR3357628_1_kneaddata_paired	Firmicutes_B	17289	P	493	13	506	0.00002
ERR3357628_1_kneaddata_paired	Deferribacterota	10822	P	311	0	311	0.00001
ERR3357628_1_kneaddata_paired	Firmicutes_C	17613	P	196	0	196	0.00001
ERR3357628_1_kneaddata_paired	Firmicutes_I	18140	P	174	0	174	0.00001
ERR3357628_1_kneaddata_paired	Elusimicrobiota	11888	P	30	0	30	0.00000
ERR3357628_1_kneaddata_paired	Thermotogota	33086	P	20	0	20	0.00000
ERR3357629_1_kneaddata_paired	Bacteroidota	4587	P	18332861	90569	18423430	0.80855
ERR3357629_1_kneaddata_paired	Firmicutes_A	14608	P	3465828	26812	3492640	0.15328
ERR3357629_1_kneaddata_paired	Firmicutes	12188	P	323198	3118	326316	0.01432
ERR3357629_1_kneaddata_paired	Campylobacterota	8700	P	205953	11	205964	0.00904
ERR3357629_1_kneaddata_paired	Desulfobacterota_A	11509	P	166972	1913	168885	0.00741
ERR3357629_1_kneaddata_paired	Proteobacteria	22518	P	92113	186	92299	0.00405
ERR3357629_1_kneaddata_paired	Deferribacterota	10822	P	63078	263	63341	0.00278
ERR3357629_1_kneaddata_paired	Actinobacteriota	615	P	5660	30	5690	0.00025
ERR3357629_1_kneaddata_paired	Cyanobacteria	9876	P	5052	295	5347	0.00023
ERR3357629_1_kneaddata_paired	Spirochaetota	32587	P	1051	5	1056	0.00005
ERR3357629_1_kneaddata_paired	Verrucomicrobiota	33333	P	292	16	308	0.00001
ERR3357629_1_kneaddata_paired	Firmicutes_B	17289	P	274	11	285	0.00001
ERR3357629_1_kneaddata_paired	Firmicutes_I	18140	P	179	0	179	0.00001
ERR3357629_1_kneaddata_paired	Firmicutes_C	17613	P	53	0	53	0.00000
ERR3357629_1_kneaddata_paired	Elusimicrobiota	11888	P	16	0	16	0.00000
ERR3357629_1_kneaddata_paired	Thermotogota	33086	P	16	0	16	0.00000
ERR3357630_1_kneaddata_paired	Firmicutes_A	14608	P	10956419	52437	11008856	0.68547
ERR3357630_1_kneaddata_paired	Bacteroidota	4587	P	3743316	63339	3806655	0.23702
ERR3357630_1_kneaddata_paired	Deferribacterota	10822	P	380688	1400	382088	0.02379
ERR3357630_1_kneaddata_paired	Campylobacterota	8700	P	346595	243	346838	0.02160
ERR3357630_1_kneaddata_paired	Firmicutes	12188	P	336854	4085	340939	0.02123
ERR3357630_1_kneaddata_paired	Desulfobacterota_A	11509	P	120419	1397	121816	0.00758
ERR3357630_1_kneaddata_paired	Cyanobacteria	9876	P	32988	208	33196	0.00207
ERR3357630_1_kneaddata_paired	Proteobacteria	22518	P	14903	25	14928	0.00093
ERR3357630_1_kneaddata_paired	Actinobacteriota	615	P	2945	12	2957	0.00018
ERR3357630_1_kneaddata_paired	Spirochaetota	32587	P	1063	4	1067	0.00007
ERR3357630_1_kneaddata_paired	Verrucomicrobiota	33333	P	381	19	400	0.00002
ERR3357630_1_kneaddata_paired	Firmicutes_B	17289	P	305	11	316	0.00002
ERR3357630_1_kneaddata_paired	Firmicutes_C	17613	P	109	0	109	0.00001
ERR3357630_1_kneaddata_paired	Firmicutes_I	18140	P	109	0	109	0.00001
ERR3357630_1_kneaddata_paired	Elusimicrobiota	11888	P	18	0	18	0.00000
ERR3357630_1_kneaddata_paired	Thermotogota	33086	P	6	0	6	0.00000
ERR3357631_1_kneaddata_paired	Bacteroidota	4587	P	28070696	152702	28223398	0.91269
ERR3357631_1_kneaddata_paired	Proteobacteria	22518	P	954207	834	955041	0.03088
ERR3357631_1_kneaddata_paired	Firmicutes_A	14608	P	863626	5189	868815	0.02810
ERR3357631_1_kneaddata_paired	Firmicutes	12188	P	606680	2682	609362	0.01971
ERR3357631_1_kneaddata_paired	Campylobacterota	8700	P	218932	9	218941	0.00708
ERR3357631_1_kneaddata_paired	Deferribacterota	10822	P	27090	62	27152	0.00088
ERR3357631_1_kneaddata_paired	Cyanobacteria	9876	P	12133	341	12474	0.00040
ERR3357631_1_kneaddata_paired	Actinobacteriota	615	P	5051	33	5084	0.00016
ERR3357631_1_kneaddata_paired	Desulfobacterota_A	11509	P	1330	64	1394	0.00005
ERR3357631_1_kneaddata_paired	Verrucomicrobiota	33333	P	843	24	867	0.00003
ERR3357631_1_kneaddata_paired	Spirochaetota	32587	P	473	1	474	0.00002
ERR3357631_1_kneaddata_paired	Firmicutes_I	18140	P	129	0	129	0.00000
ERR3357631_1_kneaddata_paired	Firmicutes_C	17613	P	5	0	5	0.00000
ERR3357631_1_kneaddata_paired	Thermotogota	33086	P	3	0	3	0.00000
ERR3357631_1_kneaddata_paired	Firmicutes_B	17289	P	2	0	2	0.00000
ERR3357632_1_kneaddata_paired	Bacteroidota	4587	P	14544038	113704	14657742	0.70845
ERR3357632_1_kneaddata_paired	Firmicutes_A	14608	P	4514366	31859	4546225	0.21973
ERR3357632_1_kneaddata_paired	Campylobacterota	8700	P	1160503	75	1160578	0.05609
ERR3357632_1_kneaddata_paired	Firmicutes	12188	P	168310	1246	169556	0.00820
ERR3357632_1_kneaddata_paired	Deferribacterota	10822	P	72263	200	72463	0.00350
ERR3357632_1_kneaddata_paired	Desulfobacterota_A	11509	P	58049	242	58291	0.00282
ERR3357632_1_kneaddata_paired	Proteobacteria	22518	P	14514	22	14536	0.00070
ERR3357632_1_kneaddata_paired	Actinobacteriota	615	P	4995	21	5016	0.00024
ERR3357632_1_kneaddata_paired	Cyanobacteria	9876	P	4236	75	4311	0.00021
ERR3357632_1_kneaddata_paired	Spirochaetota	32587	P	413	0	413	0.00002
ERR3357632_1_kneaddata_paired	Verrucomicrobiota	33333	P	246	8	254	0.00001
ERR3357632_1_kneaddata_paired	Firmicutes_B	17289	P	194	5	199	0.00001
ERR3357632_1_kneaddata_paired	Firmicutes_I	18140	P	189	0	189	0.00001
ERR3357632_1_kneaddata_paired	Firmicutes_C	17613	P	110	0	110	0.00001
ERR3357632_1_kneaddata_paired	Thermotogota	33086	P	29	0	29	0.00000
ERR3357632_1_kneaddata_paired	Elusimicrobiota	11888	P	10	0	10	0.00000
ERR3357633_1_kneaddata_paired	Firmicutes_A	14608	P	19761707	72807	19834514	0.80977
ERR3357633_1_kneaddata_paired	Campylobacterota	8700	P	1897438	1557	1898995	0.07753
ERR3357633_1_kneaddata_paired	Firmicutes	12188	P	1640112	34134	1674246	0.06835
ERR3357633_1_kneaddata_paired	Bacteroidota	4587	P	948419	16217	964636	0.03938
ERR3357633_1_kneaddata_paired	Desulfobacterota_A	11509	P	85978	599	86577	0.00353
ERR3357633_1_kneaddata_paired	Actinobacteriota	615	P	21811	114	21925	0.00090
ERR3357633_1_kneaddata_paired	Cyanobacteria	9876	P	6974	279	7253	0.00030
ERR3357633_1_kneaddata_paired	Proteobacteria	22518	P	1774	8	1782	0.00007
ERR3357633_1_kneaddata_paired	Deferribacterota	10822	P	1636	6	1642	0.00007
ERR3357633_1_kneaddata_paired	Spirochaetota	32587	P	949	3	952	0.00004
ERR3357633_1_kneaddata_paired	Verrucomicrobiota	33333	P	511	26	537	0.00002
ERR3357633_1_kneaddata_paired	Firmicutes_B	17289	P	432	17	449	0.00002
ERR3357633_1_kneaddata_paired	Firmicutes_I	18140	P	196	0	196	0.00001
ERR3357633_1_kneaddata_paired	Firmicutes_C	17613	P	181	0	181	0.00001
ERR3357633_1_kneaddata_paired	Thermotogota	33086	P	22	0	22	0.00000
ERR3357633_1_kneaddata_paired	Elusimicrobiota	11888	P	12	0	12	0.00000
ERR3357634_1_kneaddata_paired	Firmicutes_A	14608	P	23348918	77765	23426683	0.87277
ERR3357634_1_kneaddata_paired	Bacteroidota	4587	P	2032813	22476	2055289	0.07657
ERR3357634_1_kneaddata_paired	Campylobacterota	8700	P	893786	37	893823	0.03330
ERR3357634_1_kneaddata_paired	Firmicutes	12188	P	261808	7116	268924	0.01002
ERR3357634_1_kneaddata_paired	Desulfobacterota_A	11509	P	167701	1179	168880	0.00629
ERR3357634_1_kneaddata_paired	Cyanobacteria	9876	P	11761	47	11808	0.00044
ERR3357634_1_kneaddata_paired	Deferribacterota	10822	P	9681	22	9703	0.00036
ERR3357634_1_kneaddata_paired	Actinobacteriota	615	P	2421	6	2427	0.00009
ERR3357634_1_kneaddata_paired	Proteobacteria	22518	P	1874	8	1882	0.00007
ERR3357634_1_kneaddata_paired	Verrucomicrobiota	33333	P	752	25	777	0.00003
ERR3357634_1_kneaddata_paired	Spirochaetota	32587	P	442	0	442	0.00002
ERR3357634_1_kneaddata_paired	Firmicutes_B	17289	P	410	9	419	0.00002
ERR3357634_1_kneaddata_paired	Thermotogota	33086	P	371	0	371	0.00001
ERR3357634_1_kneaddata_paired	Firmicutes_C	17613	P	204	0	204	0.00001
ERR3357634_1_kneaddata_paired	Firmicutes_I	18140	P	139	0	139	0.00001
ERR3357634_1_kneaddata_paired	Elusimicrobiota	11888	P	32	0	32	0.00000
ERR3357635_1_kneaddata_paired	Firmicutes_A	14608	P	7693169	21760	7714929	0.52295
ERR3357635_1_kneaddata_paired	Bacteroidota	4587	P	5716698	53647	5770345	0.39114
ERR3357635_1_kneaddata_paired	Campylobacterota	8700	P	298761	15	298776	0.02025
ERR3357635_1_kneaddata_paired	Proteobacteria	22518	P	287505	140	287645	0.01950
ERR3357635_1_kneaddata_paired	Firmicutes	12188	P	275280	2800	278080	0.01885
ERR3357635_1_kneaddata_paired	Desulfobacterota_A	11509	P	221409	1814	223223	0.01513
ERR3357635_1_kneaddata_paired	Deferribacterota	10822	P	161961	456	162417	0.01101
ERR3357635_1_kneaddata_paired	Actinobacteriota	615	P	9305	17	9322	0.00063
ERR3357635_1_kneaddata_paired	Cyanobacteria	9876	P	6635	205	6840	0.00046
ERR3357635_1_kneaddata_paired	Firmicutes_B	17289	P	408	11	419	0.00003
ERR3357635_1_kneaddata_paired	Spirochaetota	32587	P	227	0	227	0.00002
ERR3357635_1_kneaddata_paired	Verrucomicrobiota	33333	P	140	5	145	0.00001
ERR3357635_1_kneaddata_paired	Firmicutes_C	17613	P	116	0	116	0.00001
ERR3357635_1_kneaddata_paired	Firmicutes_I	18140	P	66	0	66	0.00000
ERR3357635_1_kneaddata_paired	Elusimicrobiota	11888	P	14	0	14	0.00000
ERR3357635_1_kneaddata_paired	Thermotogota	33086	P	3	0	3	0.00000
ERR3357636_1_kneaddata_paired	Bacteroidota	4587	P	11559212	57794	11617006	0.43387
ERR3357636_1_kneaddata_paired	Firmicutes_A	14608	P	11337893	43203	11381096	0.42506
ERR3357636_1_kneaddata_paired	Firmicutes	12188	P	3156339	28448	3184787	0.11894
ERR3357636_1_kneaddata_paired	Campylobacterota	8700	P	415116	23	415139	0.01550
ERR3357636_1_kneaddata_paired	Desulfobacterota_A	11509	P	113115	1067	114182	0.00426
ERR3357636_1_kneaddata_paired	Cyanobacteria	9876	P	30711	141	30852	0.00115
ERR3357636_1_kneaddata_paired	Actinobacteriota	615	P	21063	49	21112	0.00079
ERR3357636_1_kneaddata_paired	Deferribacterota	10822	P	6170	18	6188	0.00023
ERR3357636_1_kneaddata_paired	Proteobacteria	22518	P	3545	8	3553	0.00013
ERR3357636_1_kneaddata_paired	Spirochaetota	32587	P	457	0	457	0.00002
ERR3357636_1_kneaddata_paired	Verrucomicrobiota	33333	P	357	14	371	0.00001
ERR3357636_1_kneaddata_paired	Firmicutes_B	17289	P	334	10	344	0.00001
ERR3357636_1_kneaddata_paired	Firmicutes_C	17613	P	152	0	152	0.00001
ERR3357636_1_kneaddata_paired	Firmicutes_I	18140	P	136	0	136	0.00001
ERR3357636_1_kneaddata_paired	Thermotogota	33086	P	98	0	98	0.00000
ERR3357636_1_kneaddata_paired	Elusimicrobiota	11888	P	15	0	15	0.00000
ERR3357637_1_kneaddata_paired	Firmicutes_A	14608	P	25479541	87761	25567302	0.79990
ERR3357637_1_kneaddata_paired	Bacteroidota	4587	P	4837508	89314	4926822	0.15414
ERR3357637_1_kneaddata_paired	Firmicutes	12188	P	578621	11480	590101	0.01846
ERR3357637_1_kneaddata_paired	Desulfobacterota_A	11509	P	509378	4336	513714	0.01607
ERR3357637_1_kneaddata_paired	Campylobacterota	8700	P	242011	50	242061	0.00757
ERR3357637_1_kneaddata_paired	Proteobacteria	22518	P	67248	113	67361	0.00211
ERR3357637_1_kneaddata_paired	Actinobacteriota	615	P	24801	101	24902	0.00078
ERR3357637_1_kneaddata_paired	Deferribacterota	10822	P	13289	53	13342	0.00042
ERR3357637_1_kneaddata_paired	Spirochaetota	32587	P	9221	9	9230	0.00029
ERR3357637_1_kneaddata_paired	Cyanobacteria	9876	P	4054	78	4132	0.00013
ERR3357637_1_kneaddata_paired	Firmicutes_B	17289	P	1750	71	1821	0.00006
ERR3357637_1_kneaddata_paired	Verrucomicrobiota	33333	P	1447	67	1514	0.00005
ERR3357637_1_kneaddata_paired	Firmicutes_C	17613	P	415	0	415	0.00001
ERR3357637_1_kneaddata_paired	Firmicutes_I	18140	P	349	0	349	0.00001
ERR3357637_1_kneaddata_paired	Elusimicrobiota	11888	P	25	0	25	0.00000
ERR3357637_1_kneaddata_paired	Thermotogota	33086	P	16	0	16	0.00000
ERR3357638_1_kneaddata_paired	Firmicutes_A	14608	P	18070094	34100	18104194	0.62210
ERR3357638_1_kneaddata_paired	Bacteroidota	4587	P	7767399	36838	7804237	0.26817
ERR3357638_1_kneaddata_paired	Firmicutes	12188	P	2633062	51300	2684362	0.09224
ERR3357638_1_kneaddata_paired	Campylobacterota	8700	P	289479	5	289484	0.00995
ERR3357638_1_kneaddata_paired	Deferribacterota	10822	P	120840	188	121028	0.00416
ERR3357638_1_kneaddata_paired	Desulfobacterota_A	11509	P	36567	187	36754	0.00126
ERR3357638_1_kneaddata_paired	Actinobacteriota	615	P	25901	100	26001	0.00089
ERR3357638_1_kneaddata_paired	Cyanobacteria	9876	P	24174	122	24296	0.00083
ERR3357638_1_kneaddata_paired	Proteobacteria	22518	P	9457	20	9477	0.00033
ERR3357638_1_kneaddata_paired	Verrucomicrobiota	33333	P	620	14	634	0.00002
ERR3357638_1_kneaddata_paired	Firmicutes_B	17289	P	350	5	355	0.00001
ERR3357638_1_kneaddata_paired	Spirochaetota	32587	P	326	0	326	0.00001
ERR3357638_1_kneaddata_paired	Firmicutes_I	18140	P	177	0	177	0.00001
ERR3357638_1_kneaddata_paired	Firmicutes_C	17613	P	164	0	164	0.00001
ERR3357638_1_kneaddata_paired	Thermotogota	33086	P	26	0	26	0.00000
ERR3357638_1_kneaddata_paired	Elusimicrobiota	11888	P	19	0	19	0.00000
ERR3357639_1_kneaddata_paired	Firmicutes_A	14608	P	14539328	71559	14610887	0.61308
ERR3357639_1_kneaddata_paired	Bacteroidota	4587	P	7701113	62883	7763996	0.32578
ERR3357639_1_kneaddata_paired	Firmicutes	12188	P	727330	4800	732130	0.03072
ERR3357639_1_kneaddata_paired	Deferribacterota	10822	P	360985	1163	362148	0.01520
ERR3357639_1_kneaddata_paired	Campylobacterota	8700	P	285220	22	285242	0.01197
ERR3357639_1_kneaddata_paired	Desulfobacterota_A	11509	P	53227	283	53510	0.00225
ERR3357639_1_kneaddata_paired	Proteobacteria	22518	P	8287	18	8305	0.00035
ERR3357639_1_kneaddata_paired	Actinobacteriota	615	P	5103	10	5113	0.00021
ERR3357639_1_kneaddata_paired	Cyanobacteria	9876	P	5078	67	5145	0.00022
ERR3357639_1_kneaddata_paired	Firmicutes_B	17289	P	3078	96	3174	0.00013
ERR3357639_1_kneaddata_paired	Verrucomicrobiota	33333	P	1469	71	1540	0.00006
ERR3357639_1_kneaddata_paired	Spirochaetota	32587	P	507	0	507	0.00002
ERR3357639_1_kneaddata_paired	Firmicutes_C	17613	P	155	0	155	0.00001
ERR3357639_1_kneaddata_paired	Firmicutes_I	18140	P	145	0	145	0.00001
ERR3357639_1_kneaddata_paired	Thermotogota	33086	P	21	0	21	0.00000
ERR3357639_1_kneaddata_paired	Elusimicrobiota	11888	P	9	0	9	0.00000
ERR3357640_1_kneaddata_paired	Bacteroidota	4587	P	16903225	55588	16958813	0.70087
ERR3357640_1_kneaddata_paired	Firmicutes_A	14608	P	6709074	43080	6752154	0.27905
ERR3357640_1_kneaddata_paired	Firmicutes	12188	P	260990	2544	263534	0.01089
ERR3357640_1_kneaddata_paired	Campylobacterota	8700	P	121100	7	121107	0.00501
ERR3357640_1_kneaddata_paired	Desulfobacterota_A	11509	P	38171	326	38497	0.00159
ERR3357640_1_kneaddata_paired	Cyanobacteria	9876	P	33809	103	33912	0.00140
ERR3357640_1_kneaddata_paired	Actinobacteriota	615	P	18882	75	18957	0.00078
ERR3357640_1_kneaddata_paired	Proteobacteria	22518	P	7539	16	7555	0.00031
ERR3357640_1_kneaddata_paired	Deferribacterota	10822	P	1132	3	1135	0.00005
ERR3357640_1_kneaddata_paired	Verrucomicrobiota	33333	P	342	11	353	0.00001
ERR3357640_1_kneaddata_paired	Spirochaetota	32587	P	268	0	268	0.00001
ERR3357640_1_kneaddata_paired	Thermotogota	33086	P	196	0	196	0.00001
ERR3357640_1_kneaddata_paired	Firmicutes_B	17289	P	142	4	146	0.00001
ERR3357640_1_kneaddata_paired	Firmicutes_I	18140	P	132	0	132	0.00001
ERR3357640_1_kneaddata_paired	Firmicutes_C	17613	P	94	0	94	0.00000
ERR3357640_1_kneaddata_paired	Elusimicrobiota	11888	P	21	0	21	0.00000
ERR3357641_1_kneaddata_paired	Firmicutes_A	14608	P	10784957	28026	10812983	0.60466
ERR3357641_1_kneaddata_paired	Bacteroidota	4587	P	5909592	34758	5944350	0.33240
ERR3357641_1_kneaddata_paired	Firmicutes	12188	P	555180	9145	564325	0.03156
ERR3357641_1_kneaddata_paired	Campylobacterota	8700	P	495452	65	495517	0.02771
ERR3357641_1_kneaddata_paired	Deferribacterota	10822	P	32349	49	32398	0.00181
ERR3357641_1_kneaddata_paired	Desulfobacterota_A	11509	P	11776	126	11902	0.00067
ERR3357641_1_kneaddata_paired	Proteobacteria	22518	P	7410	9	7419	0.00041
ERR3357641_1_kneaddata_paired	Actinobacteriota	615	P	7165	23	7188	0.00040
ERR3357641_1_kneaddata_paired	Cyanobacteria	9876	P	5284	55	5339	0.00030
ERR3357641_1_kneaddata_paired	Firmicutes_B	17289	P	682	10	692	0.00004
ERR3357641_1_kneaddata_paired	Verrucomicrobiota	33333	P	221	3	224	0.00001
ERR3357641_1_kneaddata_paired	Spirochaetota	32587	P	204	0	204	0.00001
ERR3357641_1_kneaddata_paired	Firmicutes_I	18140	P	194	0	194	0.00001
ERR3357641_1_kneaddata_paired	Firmicutes_C	17613	P	83	0	83	0.00000
ERR3357641_1_kneaddata_paired	Elusimicrobiota	11888	P	26	0	26	0.00000
ERR3357641_1_kneaddata_paired	Thermotogota	33086	P	16	0	16	0.00000
ERR3357642_1_kneaddata_paired	Bacteroidota	4587	P	16278467	176945	16455412	0.61702
ERR3357642_1_kneaddata_paired	Firmicutes_A	14608	P	6198913	30491	6229404	0.23358
ERR3357642_1_kneaddata_paired	Firmicutes	12188	P	3640046	14025	3654071	0.13701
ERR3357642_1_kneaddata_paired	Desulfobacterota_A	11509	P	172392	870	173262	0.00650
ERR3357642_1_kneaddata_paired	Campylobacterota	8700	P	70471	2	70473	0.00264
ERR3357642_1_kneaddata_paired	Proteobacteria	22518	P	36594	79	36673	0.00138
ERR3357642_1_kneaddata_paired	Actinobacteriota	615	P	35185	62	35247	0.00132
ERR3357642_1_kneaddata_paired	Deferribacterota	10822	P	8789	28	8817	0.00033
ERR3357642_1_kneaddata_paired	Cyanobacteria	9876	P	4124	156	4280	0.00016
ERR3357642_1_kneaddata_paired	Firmicutes_B	17289	P	431	13	444	0.00002
ERR3357642_1_kneaddata_paired	Spirochaetota	32587	P	409	0	409	0.00002
ERR3357642_1_kneaddata_paired	Verrucomicrobiota	33333	P	374	16	390	0.00001
ERR3357642_1_kneaddata_paired	Firmicutes_I	18140	P	238	0	238	0.00001
ERR3357642_1_kneaddata_paired	Firmicutes_C	17613	P	127	0	127	0.00000
ERR3357642_1_kneaddata_paired	Thermotogota	33086	P	8	0	8	0.00000
ERR3357642_1_kneaddata_paired	Elusimicrobiota	11888	P	7	0	7	0.00000
ERR3357643_1_kneaddata_paired	Firmicutes_A	14608	P	14159797	61455	14221252	0.63081
ERR3357643_1_kneaddata_paired	Bacteroidota	4587	P	5661147	34877	5696024	0.25266
ERR3357643_1_kneaddata_paired	Campylobacterota	8700	P	1513131	284	1513415	0.06713
ERR3357643_1_kneaddata_paired	Firmicutes	12188	P	450475	3172	453647	0.02012
ERR3357643_1_kneaddata_paired	Actinobacteriota	615	P	448279	118	448397	0.01989
ERR3357643_1_kneaddata_paired	Desulfobacterota_A	11509	P	140168	1004	141172	0.00626
ERR3357643_1_kneaddata_paired	Deferribacterota	10822	P	60155	7	60162	0.00267
ERR3357643_1_kneaddata_paired	Cyanobacteria	9876	P	7193	100	7293	0.00032
ERR3357643_1_kneaddata_paired	Proteobacteria	22518	P	1729	3	1732	0.00008
ERR3357643_1_kneaddata_paired	Spirochaetota	32587	P	570	0	570	0.00003
ERR3357643_1_kneaddata_paired	Verrucomicrobiota	33333	P	276	7	283	0.00001
ERR3357643_1_kneaddata_paired	Firmicutes_B	17289	P	149	3	152	0.00001
ERR3357643_1_kneaddata_paired	Firmicutes_I	18140	P	136	0	136	0.00001
ERR3357643_1_kneaddata_paired	Firmicutes_C	17613	P	104	0	104	0.00000
ERR3357643_1_kneaddata_paired	Elusimicrobiota	11888	P	38	0	38	0.00000
ERR3357643_1_kneaddata_paired	Thermotogota	33086	P	12	0	12	0.00000
ERR3357644_1_kneaddata_paired	Firmicutes_A	14608	P	24363225	88100	24451325	0.87486
ERR3357644_1_kneaddata_paired	Bacteroidota	4587	P	2223571	26630	2250201	0.08051
ERR3357644_1_kneaddata_paired	Firmicutes	12188	P	982991	13197	996188	0.03564
ERR3357644_1_kneaddata_paired	Desulfobacterota_A	11509	P	156214	705	156919	0.00561
ERR3357644_1_kneaddata_paired	Campylobacterota	8700	P	34370	8	34378	0.00123
ERR3357644_1_kneaddata_paired	Actinobacteriota	615	P	33647	76	33723	0.00121
ERR3357644_1_kneaddata_paired	Deferribacterota	10822	P	13326	41	13367	0.00048
ERR3357644_1_kneaddata_paired	Cyanobacteria	9876	P	4462	48	4510	0.00016
ERR3357644_1_kneaddata_paired	Proteobacteria	22518	P	3429	8	3437	0.00012
ERR3357644_1_kneaddata_paired	Firmicutes_B	17289	P	2310	70	2380	0.00009
ERR3357644_1_kneaddata_paired	Verrucomicrobiota	33333	P	1330	59	1389	0.00005
ERR3357644_1_kneaddata_paired	Spirochaetota	32587	P	499	0	499	0.00002
ERR3357644_1_kneaddata_paired	Firmicutes_C	17613	P	282	0	282	0.00001
ERR3357644_1_kneaddata_paired	Firmicutes_I	18140	P	160	0	160	0.00001
ERR3357644_1_kneaddata_paired	Thermotogota	33086	P	10	0	10	0.00000
ERR3357644_1_kneaddata_paired	Elusimicrobiota	11888	P	6	0	6	0.00000
ERR3473656_1_kneaddata_paired	Bacteroidota	4587	P	12305820	55597	12361417	0.50146
ERR3473656_1_kneaddata_paired	Firmicutes_A	14608	P	11806774	56188	11862962	0.48124
ERR3473656_1_kneaddata_paired	Deferribacterota	10822	P	321218	871	322089	0.01307
ERR3473656_1_kneaddata_paired	Firmicutes	12188	P	72760	889	73649	0.00299
ERR3473656_1_kneaddata_paired	Cyanobacteria	9876	P	8530	352	8882	0.00036
ERR3473656_1_kneaddata_paired	Firmicutes_B	17289	P	7397	196	7593	0.00031
ERR3473656_1_kneaddata_paired	Proteobacteria	22518	P	5086	10	5096	0.00021
ERR3473656_1_kneaddata_paired	Actinobacteriota	615	P	4587	10	4597	0.00019
ERR3473656_1_kneaddata_paired	Desulfobacterota_A	11509	P	1931	118	2049	0.00008
ERR3473656_1_kneaddata_paired	Verrucomicrobiota	33333	P	1440	53	1493	0.00006
ERR3473656_1_kneaddata_paired	Spirochaetota	32587	P	436	0	436	0.00002
ERR3473656_1_kneaddata_paired	Campylobacterota	8700	P	393	0	393	0.00002
ERR3473656_1_kneaddata_paired	Firmicutes_I	18140	P	221	0	221	0.00001
ERR3473656_1_kneaddata_paired	Firmicutes_C	17613	P	160	0	160	0.00001
ERR3473656_1_kneaddata_paired	Elusimicrobiota	11888	P	26	0	26	0.00000
ERR3473656_1_kneaddata_paired	Thermotogota	33086	P	8	0	8	0.00000
ERR3473657_1_kneaddata_paired	Bacteroidota	4587	P	14274822	67940	14342762	0.53290
ERR3473657_1_kneaddata_paired	Firmicutes_A	14608	P	11983970	58361	12042331	0.44743
ERR3473657_1_kneaddata_paired	Deferribacterota	10822	P	404071	1077	405148	0.01505
ERR3473657_1_kneaddata_paired	Firmicutes	12188	P	92480	1044	93524	0.00347
ERR3473657_1_kneaddata_paired	Cyanobacteria	9876	P	8845	383	9228	0.00034
ERR3473657_1_kneaddata_paired	Firmicutes_B	17289	P	6001	156	6157	0.00023
ERR3473657_1_kneaddata_paired	Proteobacteria	22518	P	5809	11	5820	0.00022
ERR3473657_1_kneaddata_paired	Actinobacteriota	615	P	4725	10	4735	0.00018
ERR3473657_1_kneaddata_paired	Desulfobacterota_A	11509	P	1870	118	1988	0.00007
ERR3473657_1_kneaddata_paired	Verrucomicrobiota	33333	P	1542	54	1596	0.00006
ERR3473657_1_kneaddata_paired	Spirochaetota	32587	P	440	0	440	0.00002
ERR3473657_1_kneaddata_paired	Campylobacterota	8700	P	343	0	343	0.00001
ERR3473657_1_kneaddata_paired	Firmicutes_I	18140	P	226	0	226	0.00001
ERR3473657_1_kneaddata_paired	Firmicutes_C	17613	P	152	0	152	0.00001
ERR3473657_1_kneaddata_paired	Elusimicrobiota	11888	P	33	0	33	0.00000
ERR3473657_1_kneaddata_paired	Thermotogota	33086	P	7	0	7	0.00000
ERR3473658_1_kneaddata_paired	Firmicutes_A	14608	P	19213637	62297	19275934	0.67937
ERR3473658_1_kneaddata_paired	Bacteroidota	4587	P	7530556	34069	7564625	0.26661
ERR3473658_1_kneaddata_paired	Deferribacterota	10822	P	1416817	2505	1419322	0.05002
ERR3473658_1_kneaddata_paired	Firmicutes	12188	P	81281	604	81885	0.00289
ERR3473658_1_kneaddata_paired	Firmicutes_B	17289	P	7624	131	7755	0.00027
ERR3473658_1_kneaddata_paired	Proteobacteria	22518	P	6053	8	6061	0.00021
ERR3473658_1_kneaddata_paired	Actinobacteriota	615	P	5026	6	5032	0.00018
ERR3473658_1_kneaddata_paired	Cyanobacteria	9876	P	4692	94	4786	0.00017
ERR3473658_1_kneaddata_paired	Verrucomicrobiota	33333	P	3160	34	3194	0.00011
ERR3473658_1_kneaddata_paired	Desulfobacterota_A	11509	P	2336	92	2428	0.00009
ERR3473658_1_kneaddata_paired	Spirochaetota	32587	P	1019	1	1020	0.00004
ERR3473658_1_kneaddata_paired	Campylobacterota	8700	P	557	0	557	0.00002
ERR3473658_1_kneaddata_paired	Firmicutes_I	18140	P	235	0	235	0.00001
ERR3473658_1_kneaddata_paired	Firmicutes_C	17613	P	209	0	209	0.00001
ERR3473658_1_kneaddata_paired	Thermotogota	33086	P	33	0	33	0.00000
ERR3473658_1_kneaddata_paired	Elusimicrobiota	11888	P	25	0	25	0.00000
ERR3473659_1_kneaddata_paired	Bacteroidota	4587	P	16028762	83583	16112345	0.73822
ERR3473659_1_kneaddata_paired	Firmicutes_A	14608	P	5038843	37551	5076394	0.23259
ERR3473659_1_kneaddata_paired	Deferribacterota	10822	P	553432	2428	555860	0.02547
ERR3473659_1_kneaddata_paired	Firmicutes	12188	P	56312	1208	57520	0.00264
ERR3473659_1_kneaddata_paired	Cyanobacteria	9876	P	8298	662	8960	0.00041
ERR3473659_1_kneaddata_paired	Proteobacteria	22518	P	5589	14	5603	0.00026
ERR3473659_1_kneaddata_paired	Actinobacteriota	615	P	4178	12	4190	0.00019
ERR3473659_1_kneaddata_paired	Firmicutes_B	17289	P	2571	110	2681	0.00012
ERR3473659_1_kneaddata_paired	Desulfobacterota_A	11509	P	1122	119	1241	0.00006
ERR3473659_1_kneaddata_paired	Spirochaetota	32587	P	420	1	421	0.00002
ERR3473659_1_kneaddata_paired	Verrucomicrobiota	33333	P	254	14	268	0.00001
ERR3473659_1_kneaddata_paired	Campylobacterota	8700	P	227	0	227	0.00001
ERR3473659_1_kneaddata_paired	Firmicutes_I	18140	P	91	0	91	0.00000
ERR3473659_1_kneaddata_paired	Firmicutes_C	17613	P	69	0	69	0.00000
ERR3473659_1_kneaddata_paired	Elusimicrobiota	11888	P	10	0	10	0.00000
ERR3473659_1_kneaddata_paired	Thermotogota	33086	P	4	0	4	0.00000
ERR3473660_1_kneaddata_paired	Bacteroidota	4587	P	15352092	72857	15424949	0.71101
ERR3473660_1_kneaddata_paired	Firmicutes_A	14608	P	5804222	34297	5838519	0.26912
ERR3473660_1_kneaddata_paired	Deferribacterota	10822	P	357812	1523	359335	0.01656
ERR3473660_1_kneaddata_paired	Firmicutes	12188	P	46930	1013	47943	0.00221
ERR3473660_1_kneaddata_paired	Cyanobacteria	9876	P	7750	605	8355	0.00039
ERR3473660_1_kneaddata_paired	Proteobacteria	22518	P	4957	11	4968	0.00023
ERR3473660_1_kneaddata_paired	Actinobacteriota	615	P	3587	11	3598	0.00017
ERR3473660_1_kneaddata_paired	Firmicutes_B	17289	P	2536	105	2641	0.00012
ERR3473660_1_kneaddata_paired	Verrucomicrobiota	33333	P	2210	22	2232	0.00010
ERR3473660_1_kneaddata_paired	Desulfobacterota_A	11509	P	1147	114	1261	0.00006
ERR3473660_1_kneaddata_paired	Spirochaetota	32587	P	281	0	281	0.00001
ERR3473660_1_kneaddata_paired	Campylobacterota	8700	P	188	0	188	0.00001
ERR3473660_1_kneaddata_paired	Firmicutes_I	18140	P	111	0	111	0.00001
ERR3473660_1_kneaddata_paired	Firmicutes_C	17613	P	87	0	87	0.00000
ERR3473660_1_kneaddata_paired	Thermotogota	33086	P	14	0	14	0.00000
ERR3473660_1_kneaddata_paired	Elusimicrobiota	11888	P	8	0	8	0.00000
ERR3473661_1_kneaddata_paired	Bacteroidota	4587	P	22532410	96732	22629142	0.57031
ERR3473661_1_kneaddata_paired	Firmicutes_A	14608	P	14613660	61610	14675270	0.36985
ERR3473661_1_kneaddata_paired	Deferribacterota	10822	P	1276972	4482	1281454	0.03230
ERR3473661_1_kneaddata_paired	Firmicutes	12188	P	834107	7449	841556	0.02121
ERR3473661_1_kneaddata_paired	Desulfobacterota_A	11509	P	218603	266	218869	0.00552
ERR3473661_1_kneaddata_paired	Cyanobacteria	9876	P	11996	562	12558	0.00032
ERR3473661_1_kneaddata_paired	Proteobacteria	22518	P	7930	56	7986	0.00020
ERR3473661_1_kneaddata_paired	Actinobacteriota	615	P	6385	17	6402	0.00016
ERR3473661_1_kneaddata_paired	Firmicutes_B	17289	P	1958	67	2025	0.00005
ERR3473661_1_kneaddata_paired	Spirochaetota	32587	P	1506	2	1508	0.00004
ERR3473661_1_kneaddata_paired	Campylobacterota	8700	P	859	0	859	0.00002
ERR3473661_1_kneaddata_paired	Verrucomicrobiota	33333	P	518	22	540	0.00001
ERR3473661_1_kneaddata_paired	Firmicutes_I	18140	P	283	0	283	0.00001
ERR3473661_1_kneaddata_paired	Firmicutes_C	17613	P	188	0	188	0.00000
ERR3473661_1_kneaddata_paired	Elusimicrobiota	11888	P	26	0	26	0.00000
ERR3473661_1_kneaddata_paired	Thermotogota	33086	P	18	0	18	0.00000
ERR3473662_1_kneaddata_paired	Bacteroidota	4587	P	23517186	141254	23658440	0.59020
ERR3473662_1_kneaddata_paired	Firmicutes_A	14608	P	14415937	89196	14505133	0.36185
ERR3473662_1_kneaddata_paired	Deferribacterota	10822	P	896780	4473	901253	0.02248
ERR3473662_1_kneaddata_paired	Firmicutes	12188	P	783493	10191	793684	0.01980
ERR3473662_1_kneaddata_paired	Desulfobacterota_A	11509	P	196055	340	196395	0.00490
ERR3473662_1_kneaddata_paired	Cyanobacteria	9876	P	12325	816	13141	0.00033
ERR3473662_1_kneaddata_paired	Proteobacteria	22518	P	7377	71	7448	0.00019
ERR3473662_1_kneaddata_paired	Actinobacteriota	615	P	5622	20	5642	0.00014
ERR3473662_1_kneaddata_paired	Spirochaetota	32587	P	1409	4	1413	0.00004
ERR3473662_1_kneaddata_paired	Firmicutes_B	17289	P	1293	63	1356	0.00003
ERR3473662_1_kneaddata_paired	Campylobacterota	8700	P	923	0	923	0.00002
ERR3473662_1_kneaddata_paired	Verrucomicrobiota	33333	P	428	25	453	0.00001
ERR3473662_1_kneaddata_paired	Firmicutes_I	18140	P	274	0	274	0.00001
ERR3473662_1_kneaddata_paired	Firmicutes_C	17613	P	168	0	168	0.00000
ERR3473662_1_kneaddata_paired	Elusimicrobiota	11888	P	24	0	24	0.00000
ERR3473662_1_kneaddata_paired	Thermotogota	33086	P	20	0	20	0.00000
ERR3473663_1_kneaddata_paired	Bacteroidota	4587	P	9524647	36816	9561463	0.49682
ERR3473663_1_kneaddata_paired	Firmicutes_A	14608	P	7249624	27455	7277079	0.37812
ERR3473663_1_kneaddata_paired	Deferribacterota	10822	P	1293045	3916	1296961	0.06739
ERR3473663_1_kneaddata_paired	Firmicutes	12188	P	983680	7156	990836	0.05148
ERR3473663_1_kneaddata_paired	Desulfobacterota_A	11509	P	101673	108	101781	0.00529
ERR3473663_1_kneaddata_paired	Cyanobacteria	9876	P	5832	190	6022	0.00031
ERR3473663_1_kneaddata_paired	Proteobacteria	22518	P	4576	21	4597	0.00024
ERR3473663_1_kneaddata_paired	Actinobacteriota	615	P	2895	6	2901	0.00015
ERR3473663_1_kneaddata_paired	Spirochaetota	32587	P	1134	2	1136	0.00006
ERR3473663_1_kneaddata_paired	Verrucomicrobiota	33333	P	775	13	788	0.00004
ERR3473663_1_kneaddata_paired	Firmicutes_B	17289	P	762	22	784	0.00004
ERR3473663_1_kneaddata_paired	Campylobacterota	8700	P	588	0	588	0.00003
ERR3473663_1_kneaddata_paired	Firmicutes_I	18140	P	149	0	149	0.00001
ERR3473663_1_kneaddata_paired	Firmicutes_C	17613	P	90	0	90	0.00000
ERR3473663_1_kneaddata_paired	Elusimicrobiota	11888	P	8	0	8	0.00000
ERR3473663_1_kneaddata_paired	Thermotogota	33086	P	7	0	7	0.00000
ERR3598092_1_kneaddata_paired	Firmicutes_A	14608	P	274522	1269	275791	0.95040
ERR3598092_1_kneaddata_paired	Bacteroidota	4587	P	6469	80	6549	0.02257
ERR3598092_1_kneaddata_paired	Campylobacterota	8700	P	4557	0	4557	0.01570
ERR3598092_1_kneaddata_paired	Firmicutes	12188	P	2840	50	2890	0.00996
ERR3598092_1_kneaddata_paired	Actinobacteriota	615	P	249	0	249	0.00086
ERR3598092_1_kneaddata_paired	Cyanobacteria	9876	P	40	0	40	0.00014
ERR3598092_1_kneaddata_paired	Proteobacteria	22518	P	40	0	40	0.00014
ERR3598092_1_kneaddata_paired	Desulfobacterota_A	11509	P	22	3	25	0.00009
ERR3598092_1_kneaddata_paired	Firmicutes_B	17289	P	21	0	21	0.00007
ERR3598092_1_kneaddata_paired	Verrucomicrobiota	33333	P	8	0	8	0.00003
ERR3598092_1_kneaddata_paired	Firmicutes_C	17613	P	3	0	3	0.00001
ERR3598092_1_kneaddata_paired	Thermotogota	33086	P	3	0	3	0.00001
ERR3598092_1_kneaddata_paired	Deferribacterota	10822	P	2	0	2	0.00001
ERR3598093_1_kneaddata_paired	Firmicutes_A	14608	P	252574	1272	253846	0.94926
ERR3598093_1_kneaddata_paired	Bacteroidota	4587	P	6062	81	6143	0.02297
ERR3598093_1_kneaddata_paired	Campylobacterota	8700	P	4405	0	4405	0.01647
ERR3598093_1_kneaddata_paired	Firmicutes	12188	P	2558	48	2606	0.00975
ERR3598093_1_kneaddata_paired	Actinobacteriota	615	P	256	0	256	0.00096
ERR3598093_1_kneaddata_paired	Cyanobacteria	9876	P	50	0	50	0.00019
ERR3598093_1_kneaddata_paired	Proteobacteria	22518	P	37	0	37	0.00014
ERR3598093_1_kneaddata_paired	Desulfobacterota_A	11509	P	24	3	27	0.00010
ERR3598093_1_kneaddata_paired	Firmicutes_B	17289	P	18	0	18	0.00007
ERR3598093_1_kneaddata_paired	Verrucomicrobiota	33333	P	10	0	10	0.00004
ERR3598093_1_kneaddata_paired	Deferribacterota	10822	P	3	0	3	0.00001
ERR3598093_1_kneaddata_paired	Firmicutes_C	17613	P	3	0	3	0.00001
ERR3598093_1_kneaddata_paired	Spirochaetota	32587	P	2	0	2	0.00001
ERR3598093_1_kneaddata_paired	Firmicutes_I	18140	P	1	0	1	0.00000
ERR3598093_1_kneaddata_paired	Thermotogota	33086	P	1	0	1	0.00000
ERR3598094_1_kneaddata_paired	Firmicutes_A	14608	P	275782	1326	277108	0.94994
ERR3598094_1_kneaddata_paired	Bacteroidota	4587	P	6624	86	6710	0.02300
ERR3598094_1_kneaddata_paired	Campylobacterota	8700	P	4667	0	4667	0.01600
ERR3598094_1_kneaddata_paired	Firmicutes	12188	P	2759	50	2809	0.00963
ERR3598094_1_kneaddata_paired	Actinobacteriota	615	P	279	0	279	0.00096
ERR3598094_1_kneaddata_paired	Proteobacteria	22518	P	36	0	36	0.00013
ERR3598094_1_kneaddata_paired	Cyanobacteria	9876	P	32	0	32	0.00011
ERR3598094_1_kneaddata_paired	Firmicutes_B	17289	P	24	0	24	0.00009
ERR3598094_1_kneaddata_paired	Desulfobacterota_A	11509	P	23	2	25	0.00009
ERR3598094_1_kneaddata_paired	Verrucomicrobiota	33333	P	11	0	11	0.00004
ERR3598094_1_kneaddata_paired	Firmicutes_C	17613	P	2	0	2	0.00001
ERR3598094_1_kneaddata_paired	Spirochaetota	32587	P	2	0	2	0.00001
ERR3598094_1_kneaddata_paired	Firmicutes_I	18140	P	1	0	1	0.00000
ERR3598095_1_kneaddata_paired	Firmicutes_A	14608	P	277789	1314	279103	0.95049
ERR3598095_1_kneaddata_paired	Bacteroidota	4587	P	6671	86	6757	0.02301
ERR3598095_1_kneaddata_paired	Campylobacterota	8700	P	4673	0	4673	0.01591
ERR3598095_1_kneaddata_paired	Firmicutes	12188	P	2641	46	2687	0.00915
ERR3598095_1_kneaddata_paired	Actinobacteriota	615	P	249	0	249	0.00085
ERR3598095_1_kneaddata_paired	Proteobacteria	22518	P	47	1	48	0.00016
ERR3598095_1_kneaddata_paired	Cyanobacteria	9876	P	36	0	36	0.00012
ERR3598095_1_kneaddata_paired	Desulfobacterota_A	11509	P	34	4	38	0.00013
ERR3598095_1_kneaddata_paired	Firmicutes_B	17289	P	28	0	28	0.00010
ERR3598095_1_kneaddata_paired	Verrucomicrobiota	33333	P	10	0	10	0.00004
ERR3598095_1_kneaddata_paired	Firmicutes_I	18140	P	3	0	3	0.00001
ERR3598095_1_kneaddata_paired	Firmicutes_C	17613	P	2	0	2	0.00001
ERR3598095_1_kneaddata_paired	Deferribacterota	10822	P	1	0	1	0.00000
ERR3598095_1_kneaddata_paired	Elusimicrobiota	11888	P	1	0	1	0.00000
ERR3598096_1_kneaddata_paired	Firmicutes_A	14608	P	444450	1750	446200	0.91573
ERR3598096_1_kneaddata_paired	Bacteroidota	4587	P	25554	274	25828	0.05301
ERR3598096_1_kneaddata_paired	Deferribacterota	10822	P	6707	0	6707	0.01377
ERR3598096_1_kneaddata_paired	Firmicutes	12188	P	5674	59	5733	0.01177
ERR3598096_1_kneaddata_paired	Campylobacterota	8700	P	1788	0	1788	0.00367
ERR3598096_1_kneaddata_paired	Actinobacteriota	615	P	562	2	564	0.00116
ERR3598096_1_kneaddata_paired	Desulfobacterota_A	11509	P	229	10	239	0.00049
ERR3598096_1_kneaddata_paired	Cyanobacteria	9876	P	98	2	100	0.00021
ERR3598096_1_kneaddata_paired	Proteobacteria	22518	P	51	0	51	0.00011
ERR3598096_1_kneaddata_paired	Spirochaetota	32587	P	14	0	14	0.00003
ERR3598096_1_kneaddata_paired	Verrucomicrobiota	33333	P	12	0	12	0.00003
ERR3598096_1_kneaddata_paired	Firmicutes_B	17289	P	10	0	10	0.00002
ERR3598096_1_kneaddata_paired	Thermotogota	33086	P	6	0	6	0.00001
ERR3598096_1_kneaddata_paired	Firmicutes_C	17613	P	4	0	4	0.00001
ERR3598096_1_kneaddata_paired	Firmicutes_I	18140	P	3	0	3	0.00001
ERR3598097_1_kneaddata_paired	Firmicutes_A	14608	P	407402	1675	409077	0.91615
ERR3598097_1_kneaddata_paired	Bacteroidota	4587	P	23313	261	23574	0.05280
ERR3598097_1_kneaddata_paired	Deferribacterota	10822	P	6085	0	6085	0.01363
ERR3598097_1_kneaddata_paired	Firmicutes	12188	P	5247	56	5303	0.01188
ERR3598097_1_kneaddata_paired	Campylobacterota	8700	P	1528	0	1528	0.00342
ERR3598097_1_kneaddata_paired	Actinobacteriota	615	P	540	2	542	0.00121
ERR3598097_1_kneaddata_paired	Desulfobacterota_A	11509	P	204	9	213	0.00048
ERR3598097_1_kneaddata_paired	Cyanobacteria	9876	P	98	1	99	0.00022
ERR3598097_1_kneaddata_paired	Proteobacteria	22518	P	40	0	40	0.00009
ERR3598097_1_kneaddata_paired	Thermotogota	33086	P	14	0	14	0.00003
ERR3598097_1_kneaddata_paired	Firmicutes_B	17289	P	10	0	10	0.00002
ERR3598097_1_kneaddata_paired	Firmicutes_C	17613	P	7	0	7	0.00002
ERR3598097_1_kneaddata_paired	Spirochaetota	32587	P	7	0	7	0.00002
ERR3598097_1_kneaddata_paired	Verrucomicrobiota	33333	P	7	0	7	0.00002
ERR3598097_1_kneaddata_paired	Elusimicrobiota	11888	P	3	0	3	0.00001
ERR3598097_1_kneaddata_paired	Firmicutes_I	18140	P	3	0	3	0.00001
ERR3598098_1_kneaddata_paired	Firmicutes_A	14608	P	443961	1876	445837	0.91615
ERR3598098_1_kneaddata_paired	Bacteroidota	4587	P	25520	295	25815	0.05305
ERR3598098_1_kneaddata_paired	Deferribacterota	10822	P	6706	0	6706	0.01378
ERR3598098_1_kneaddata_paired	Firmicutes	12188	P	5506	58	5564	0.01143
ERR3598098_1_kneaddata_paired	Campylobacterota	8700	P	1663	0	1663	0.00342
ERR3598098_1_kneaddata_paired	Actinobacteriota	615	P	596	2	598	0.00123
ERR3598098_1_kneaddata_paired	Desulfobacterota_A	11509	P	229	9	238	0.00049
ERR3598098_1_kneaddata_paired	Cyanobacteria	9876	P	94	1	95	0.00020
ERR3598098_1_kneaddata_paired	Proteobacteria	22518	P	50	0	50	0.00010
ERR3598098_1_kneaddata_paired	Verrucomicrobiota	33333	P	19	0	19	0.00004
ERR3598098_1_kneaddata_paired	Thermotogota	33086	P	16	0	16	0.00003
ERR3598098_1_kneaddata_paired	Firmicutes_B	17289	P	14	0	14	0.00003
ERR3598098_1_kneaddata_paired	Spirochaetota	32587	P	8	0	8	0.00002
ERR3598098_1_kneaddata_paired	Firmicutes_I	18140	P	7	0	7	0.00001
ERR3598098_1_kneaddata_paired	Firmicutes_C	17613	P	6	0	6	0.00001
ERR3598098_1_kneaddata_paired	Elusimicrobiota	11888	P	1	0	1	0.00000
ERR3598099_1_kneaddata_paired	Firmicutes_A	14608	P	444500	1809	446309	0.91615
ERR3598099_1_kneaddata_paired	Bacteroidota	4587	P	25528	283	25811	0.05298
ERR3598099_1_kneaddata_paired	Deferribacterota	10822	P	6572	0	6572	0.01349
ERR3598099_1_kneaddata_paired	Firmicutes	12188	P	5713	61	5774	0.01185
ERR3598099_1_kneaddata_paired	Campylobacterota	8700	P	1640	0	1640	0.00337
ERR3598099_1_kneaddata_paired	Actinobacteriota	615	P	616	2	618	0.00127
ERR3598099_1_kneaddata_paired	Desulfobacterota_A	11509	P	218	10	228	0.00047
ERR3598099_1_kneaddata_paired	Cyanobacteria	9876	P	89	0	89	0.00018
ERR3598099_1_kneaddata_paired	Proteobacteria	22518	P	56	0	56	0.00012
ERR3598099_1_kneaddata_paired	Verrucomicrobiota	33333	P	20	0	20	0.00004
ERR3598099_1_kneaddata_paired	Spirochaetota	32587	P	10	0	10	0.00002
ERR3598099_1_kneaddata_paired	Firmicutes_B	17289	P	9	0	9	0.00002
ERR3598099_1_kneaddata_paired	Firmicutes_C	17613	P	8	0	8	0.00002
ERR3598099_1_kneaddata_paired	Thermotogota	33086	P	7	0	7	0.00001
ERR3598099_1_kneaddata_paired	Firmicutes_I	18140	P	2	0	2	0.00000
ERR3598100_1_kneaddata_paired	Firmicutes_A	14608	P	315361	2013	317374	0.85370
ERR3598100_1_kneaddata_paired	Bacteroidota	4587	P	44552	614	45166	0.12149
ERR3598100_1_kneaddata_paired	Campylobacterota	8700	P	3116	0	3116	0.00838
ERR3598100_1_kneaddata_paired	Firmicutes	12188	P	2748	37	2785	0.00749
ERR3598100_1_kneaddata_paired	Desulfobacterota_A	11509	P	1811	34	1845	0.00496
ERR3598100_1_kneaddata_paired	Deferribacterota	10822	P	786	3	789	0.00212
ERR3598100_1_kneaddata_paired	Actinobacteriota	615	P	572	5	577	0.00155
ERR3598100_1_kneaddata_paired	Cyanobacteria	9876	P	34	0	34	0.00009
ERR3598100_1_kneaddata_paired	Proteobacteria	22518	P	33	0	33	0.00009
ERR3598100_1_kneaddata_paired	Firmicutes_B	17289	P	14	0	14	0.00004
ERR3598100_1_kneaddata_paired	Spirochaetota	32587	P	12	0	12	0.00003
ERR3598100_1_kneaddata_paired	Verrucomicrobiota	33333	P	6	0	6	0.00002
ERR3598100_1_kneaddata_paired	Firmicutes_C	17613	P	3	0	3	0.00001
ERR3598100_1_kneaddata_paired	Thermotogota	33086	P	3	0	3	0.00001
ERR3598100_1_kneaddata_paired	Firmicutes_I	18140	P	2	0	2	0.00001
ERR3598101_1_kneaddata_paired	Firmicutes_A	14608	P	286045	1852	287897	0.85381
ERR3598101_1_kneaddata_paired	Bacteroidota	4587	P	40451	566	41017	0.12165
ERR3598101_1_kneaddata_paired	Campylobacterota	8700	P	2871	0	2871	0.00852
ERR3598101_1_kneaddata_paired	Firmicutes	12188	P	2459	33	2492	0.00739
ERR3598101_1_kneaddata_paired	Desulfobacterota_A	11509	P	1529	29	1558	0.00462
ERR3598101_1_kneaddata_paired	Deferribacterota	10822	P	743	3	746	0.00221
ERR3598101_1_kneaddata_paired	Actinobacteriota	615	P	522	4	526	0.00156
ERR3598101_1_kneaddata_paired	Proteobacteria	22518	P	31	0	31	0.00009
ERR3598101_1_kneaddata_paired	Cyanobacteria	9876	P	30	0	30	0.00009
ERR3598101_1_kneaddata_paired	Firmicutes_B	17289	P	9	0	9	0.00003
ERR3598101_1_kneaddata_paired	Verrucomicrobiota	33333	P	7	0	7	0.00002
ERR3598101_1_kneaddata_paired	Firmicutes_I	18140	P	2	0	2	0.00001
ERR3598101_1_kneaddata_paired	Spirochaetota	32587	P	1	0	1	0.00000
ERR3598102_1_kneaddata_paired	Firmicutes_A	14608	P	316048	1986	318034	0.85376
ERR3598102_1_kneaddata_paired	Bacteroidota	4587	P	44809	619	45428	0.12195
ERR3598102_1_kneaddata_paired	Campylobacterota	8700	P	3099	0	3099	0.00832
ERR3598102_1_kneaddata_paired	Firmicutes	12188	P	2590	38	2628	0.00706
ERR3598102_1_kneaddata_paired	Desulfobacterota_A	11509	P	1762	30	1792	0.00481
ERR3598102_1_kneaddata_paired	Deferribacterota	10822	P	830	3	833	0.00224
ERR3598102_1_kneaddata_paired	Actinobacteriota	615	P	593	5	598	0.00161
ERR3598102_1_kneaddata_paired	Cyanobacteria	9876	P	40	0	40	0.00011
ERR3598102_1_kneaddata_paired	Proteobacteria	22518	P	24	0	24	0.00007
ERR3598102_1_kneaddata_paired	Firmicutes_B	17289	P	9	0	9	0.00003
ERR3598102_1_kneaddata_paired	Verrucomicrobiota	33333	P	8	0	8	0.00002
ERR3598102_1_kneaddata_paired	Spirochaetota	32587	P	7	0	7	0.00002
ERR3598102_1_kneaddata_paired	Firmicutes_C	17613	P	3	0	3	0.00001
ERR3598102_1_kneaddata_paired	Firmicutes_I	18140	P	3	0	3	0.00001
ERR3598102_1_kneaddata_paired	Thermotogota	33086	P	2	0	2	0.00001
ERR3598103_1_kneaddata_paired	Firmicutes_A	14608	P	315217	1994	317211	0.85265
ERR3598103_1_kneaddata_paired	Bacteroidota	4587	P	45083	619	45702	0.12285
ERR3598103_1_kneaddata_paired	Campylobacterota	8700	P	3161	0	3161	0.00850
ERR3598103_1_kneaddata_paired	Firmicutes	12188	P	2715	38	2753	0.00740
ERR3598103_1_kneaddata_paired	Desulfobacterota_A	11509	P	1716	31	1747	0.00470
ERR3598103_1_kneaddata_paired	Deferribacterota	10822	P	796	3	799	0.00215
ERR3598103_1_kneaddata_paired	Actinobacteriota	615	P	544	4	548	0.00148
ERR3598103_1_kneaddata_paired	Cyanobacteria	9876	P	36	0	36	0.00010
ERR3598103_1_kneaddata_paired	Proteobacteria	22518	P	33	0	33	0.00009
ERR3598103_1_kneaddata_paired	Verrucomicrobiota	33333	P	11	0	11	0.00003
ERR3598103_1_kneaddata_paired	Spirochaetota	32587	P	9	0	9	0.00002
ERR3598103_1_kneaddata_paired	Firmicutes_B	17289	P	8	0	8	0.00002
ERR3598103_1_kneaddata_paired	Firmicutes_C	17613	P	2	0	2	0.00001
ERR3598103_1_kneaddata_paired	Thermotogota	33086	P	2	0	2	0.00001
ERR3598103_1_kneaddata_paired	Firmicutes_I	18140	P	1	0	1	0.00000
ERR3598104_1_kneaddata_paired	Firmicutes_A	14608	P	255539	1043	256582	0.78665
ERR3598104_1_kneaddata_paired	Bacteroidota	4587	P	61362	591	61953	0.18994
ERR3598104_1_kneaddata_paired	Firmicutes	12188	P	4314	38	4352	0.01334
ERR3598104_1_kneaddata_paired	Campylobacterota	8700	P	1049	0	1049	0.00322
ERR3598104_1_kneaddata_paired	Desulfobacterota_A	11509	P	968	7	975	0.00299
ERR3598104_1_kneaddata_paired	Deferribacterota	10822	P	683	0	683	0.00209
ERR3598104_1_kneaddata_paired	Actinobacteriota	615	P	297	0	297	0.00091
ERR3598104_1_kneaddata_paired	Proteobacteria	22518	P	159	1	160	0.00049
ERR3598104_1_kneaddata_paired	Cyanobacteria	9876	P	52	2	54	0.00017
ERR3598104_1_kneaddata_paired	Firmicutes_B	17289	P	33	0	33	0.00010
ERR3598104_1_kneaddata_paired	Verrucomicrobiota	33333	P	13	0	13	0.00004
ERR3598104_1_kneaddata_paired	Firmicutes_C	17613	P	7	0	7	0.00002
ERR3598104_1_kneaddata_paired	Firmicutes_I	18140	P	4	0	4	0.00001
ERR3598104_1_kneaddata_paired	Spirochaetota	32587	P	2	0	2	0.00001
ERR3598104_1_kneaddata_paired	Elusimicrobiota	11888	P	1	0	1	0.00000
ERR3598104_1_kneaddata_paired	Thermotogota	33086	P	1	0	1	0.00000
ERR3598105_1_kneaddata_paired	Firmicutes_A	14608	P	233960	1008	234968	0.78730
ERR3598105_1_kneaddata_paired	Bacteroidota	4587	P	56023	569	56592	0.18962
ERR3598105_1_kneaddata_paired	Firmicutes	12188	P	3924	35	3959	0.01327
ERR3598105_1_kneaddata_paired	Campylobacterota	8700	P	930	0	930	0.00312
ERR3598105_1_kneaddata_paired	Desulfobacterota_A	11509	P	847	6	853	0.00286
ERR3598105_1_kneaddata_paired	Deferribacterota	10822	P	638	0	638	0.00214
ERR3598105_1_kneaddata_paired	Actinobacteriota	615	P	247	0	247	0.00083
ERR3598105_1_kneaddata_paired	Proteobacteria	22518	P	155	1	156	0.00053
ERR3598105_1_kneaddata_paired	Cyanobacteria	9876	P	47	1	48	0.00016
ERR3598105_1_kneaddata_paired	Firmicutes_B	17289	P	34	0	34	0.00012
ERR3598105_1_kneaddata_paired	Spirochaetota	32587	P	6	0	6	0.00002
ERR3598105_1_kneaddata_paired	Verrucomicrobiota	33333	P	4	0	4	0.00001
ERR3598105_1_kneaddata_paired	Firmicutes_C	17613	P	3	0	3	0.00001
ERR3598105_1_kneaddata_paired	Elusimicrobiota	11888	P	2	0	2	0.00001
ERR3598105_1_kneaddata_paired	Firmicutes_I	18140	P	1	0	1	0.00000
ERR3598105_1_kneaddata_paired	Thermotogota	33086	P	1	0	1	0.00000
ERR3598106_1_kneaddata_paired	Firmicutes_A	14608	P	257627	1075	258702	0.78573
ERR3598106_1_kneaddata_paired	Bacteroidota	4587	P	62257	614	62871	0.19095
ERR3598106_1_kneaddata_paired	Firmicutes	12188	P	4231	36	4267	0.01296
ERR3598106_1_kneaddata_paired	Campylobacterota	8700	P	1059	0	1059	0.00322
ERR3598106_1_kneaddata_paired	Desulfobacterota_A	11509	P	1043	7	1050	0.00319
ERR3598106_1_kneaddata_paired	Deferribacterota	10822	P	697	0	697	0.00212
ERR3598106_1_kneaddata_paired	Actinobacteriota	615	P	309	0	309	0.00094
ERR3598106_1_kneaddata_paired	Proteobacteria	22518	P	178	2	180	0.00055
ERR3598106_1_kneaddata_paired	Cyanobacteria	9876	P	51	2	53	0.00016
ERR3598106_1_kneaddata_paired	Firmicutes_B	17289	P	31	0	31	0.00010
ERR3598106_1_kneaddata_paired	Verrucomicrobiota	33333	P	11	0	11	0.00003
ERR3598106_1_kneaddata_paired	Firmicutes_C	17613	P	6	0	6	0.00002
ERR3598106_1_kneaddata_paired	Spirochaetota	32587	P	5	0	5	0.00002
ERR3598106_1_kneaddata_paired	Firmicutes_I	18140	P	3	0	3	0.00001
ERR3598106_1_kneaddata_paired	Thermotogota	33086	P	2	0	2	0.00001
ERR3598106_1_kneaddata_paired	Elusimicrobiota	11888	P	1	0	1	0.00000
ERR3598107_1_kneaddata_paired	Firmicutes_A	14608	P	258288	1036	259324	0.78678
ERR3598107_1_kneaddata_paired	Bacteroidota	4587	P	61944	578	62522	0.18969
ERR3598107_1_kneaddata_paired	Firmicutes	12188	P	4405	36	4441	0.01347
ERR3598107_1_kneaddata_paired	Campylobacterota	8700	P	1086	0	1086	0.00330
ERR3598107_1_kneaddata_paired	Desulfobacterota_A	11509	P	1062	7	1069	0.00324
ERR3598107_1_kneaddata_paired	Deferribacterota	10822	P	624	0	624	0.00189
ERR3598107_1_kneaddata_paired	Actinobacteriota	615	P	279	0	279	0.00085
ERR3598107_1_kneaddata_paired	Proteobacteria	22518	P	159	1	160	0.00049
ERR3598107_1_kneaddata_paired	Cyanobacteria	9876	P	42	1	43	0.00013
ERR3598107_1_kneaddata_paired	Firmicutes_B	17289	P	28	0	28	0.00009
ERR3598107_1_kneaddata_paired	Verrucomicrobiota	33333	P	10	0	10	0.00003
ERR3598107_1_kneaddata_paired	Firmicutes_C	17613	P	6	0	6	0.00002
ERR3598107_1_kneaddata_paired	Elusimicrobiota	11888	P	2	0	2	0.00001
ERR3598107_1_kneaddata_paired	Firmicutes_I	18140	P	2	0	2	0.00001
ERR3598107_1_kneaddata_paired	Spirochaetota	32587	P	2	0	2	0.00001
ERR3598107_1_kneaddata_paired	Thermotogota	33086	P	1	0	1	0.00000
ERR3598108_1_kneaddata_paired	Firmicutes_A	14608	P	280237	1074	281311	0.85376
ERR3598108_1_kneaddata_paired	Bacteroidota	4587	P	23994	182	24176	0.07337
ERR3598108_1_kneaddata_paired	Deferribacterota	10822	P	14410	1	14411	0.04374
ERR3598108_1_kneaddata_paired	Firmicutes	12188	P	5708	33	5741	0.01743
ERR3598108_1_kneaddata_paired	Campylobacterota	8700	P	2196	0	2196	0.00667
ERR3598108_1_kneaddata_paired	Desulfobacterota_A	11509	P	1205	14	1219	0.00370
ERR3598108_1_kneaddata_paired	Actinobacteriota	615	P	222	0	222	0.00068
ERR3598108_1_kneaddata_paired	Cyanobacteria	9876	P	123	4	127	0.00039
ERR3598108_1_kneaddata_paired	Proteobacteria	22518	P	43	0	43	0.00013
ERR3598108_1_kneaddata_paired	Spirochaetota	32587	P	13	0	13	0.00004
ERR3598108_1_kneaddata_paired	Firmicutes_B	17289	P	12	0	12	0.00004
ERR3598108_1_kneaddata_paired	Firmicutes_C	17613	P	8	0	8	0.00002
ERR3598108_1_kneaddata_paired	Verrucomicrobiota	33333	P	6	0	6	0.00002
ERR3598108_1_kneaddata_paired	Thermotogota	33086	P	4	0	4	0.00001
ERR3598108_1_kneaddata_paired	Firmicutes_I	18140	P	3	0	3	0.00001
ERR3598108_1_kneaddata_paired	Elusimicrobiota	11888	P	1	0	1	0.00000
ERR3598109_1_kneaddata_paired	Firmicutes_A	14608	P	257333	993	258326	0.85398
ERR3598109_1_kneaddata_paired	Bacteroidota	4587	P	22074	169	22243	0.07353
ERR3598109_1_kneaddata_paired	Deferribacterota	10822	P	13005	1	13006	0.04300
ERR3598109_1_kneaddata_paired	Firmicutes	12188	P	5225	29	5254	0.01737
ERR3598109_1_kneaddata_paired	Campylobacterota	8700	P	2093	0	2093	0.00692
ERR3598109_1_kneaddata_paired	Desulfobacterota_A	11509	P	1168	14	1182	0.00391
ERR3598109_1_kneaddata_paired	Actinobacteriota	615	P	207	0	207	0.00069
ERR3598109_1_kneaddata_paired	Cyanobacteria	9876	P	108	5	113	0.00037
ERR3598109_1_kneaddata_paired	Proteobacteria	22518	P	32	0	32	0.00011
ERR3598109_1_kneaddata_paired	Spirochaetota	32587	P	14	0	14	0.00005
ERR3598109_1_kneaddata_paired	Verrucomicrobiota	33333	P	8	0	8	0.00003
ERR3598109_1_kneaddata_paired	Firmicutes_B	17289	P	6	0	6	0.00002
ERR3598109_1_kneaddata_paired	Firmicutes_C	17613	P	6	0	6	0.00002
ERR3598109_1_kneaddata_paired	Firmicutes_I	18140	P	2	0	2	0.00001
ERR3598109_1_kneaddata_paired	Elusimicrobiota	11888	P	1	0	1	0.00000
ERR3598110_1_kneaddata_paired	Firmicutes_A	14608	P	279137	1105	280242	0.85358
ERR3598110_1_kneaddata_paired	Bacteroidota	4587	P	24191	191	24382	0.07426
ERR3598110_1_kneaddata_paired	Deferribacterota	10822	P	13994	1	13995	0.04263
ERR3598110_1_kneaddata_paired	Firmicutes	12188	P	5820	34	5854	0.01783
ERR3598110_1_kneaddata_paired	Campylobacterota	8700	P	2157	0	2157	0.00657
ERR3598110_1_kneaddata_paired	Desulfobacterota_A	11509	P	1228	13	1241	0.00378
ERR3598110_1_kneaddata_paired	Actinobacteriota	615	P	240	0	240	0.00073
ERR3598110_1_kneaddata_paired	Cyanobacteria	9876	P	114	4	118	0.00036
ERR3598110_1_kneaddata_paired	Proteobacteria	22518	P	49	0	49	0.00015
ERR3598110_1_kneaddata_paired	Firmicutes_C	17613	P	8	0	8	0.00002
ERR3598110_1_kneaddata_paired	Firmicutes_I	18140	P	6	0	6	0.00002
ERR3598110_1_kneaddata_paired	Spirochaetota	32587	P	6	0	6	0.00002
ERR3598110_1_kneaddata_paired	Verrucomicrobiota	33333	P	5	0	5	0.00002
ERR3598110_1_kneaddata_paired	Firmicutes_B	17289	P	3	0	3	0.00001
ERR3598110_1_kneaddata_paired	Elusimicrobiota	11888	P	2	0	2	0.00001
ERR3598110_1_kneaddata_paired	Thermotogota	33086	P	2	0	2	0.00001
ERR3598111_1_kneaddata_paired	Firmicutes_A	14608	P	282360	1135	283495	0.85512
ERR3598111_1_kneaddata_paired	Bacteroidota	4587	P	24060	192	24252	0.07315
ERR3598111_1_kneaddata_paired	Deferribacterota	10822	P	14094	1	14095	0.04252
ERR3598111_1_kneaddata_paired	Firmicutes	12188	P	5784	33	5817	0.01755
ERR3598111_1_kneaddata_paired	Campylobacterota	8700	P	2178	0	2178	0.00657
ERR3598111_1_kneaddata_paired	Desulfobacterota_A	11509	P	1256	15	1271	0.00384
ERR3598111_1_kneaddata_paired	Actinobacteriota	615	P	225	0	225	0.00068
ERR3598111_1_kneaddata_paired	Cyanobacteria	9876	P	107	4	111	0.00034
ERR3598111_1_kneaddata_paired	Proteobacteria	22518	P	46	0	46	0.00014
ERR3598111_1_kneaddata_paired	Verrucomicrobiota	33333	P	9	0	9	0.00003
ERR3598111_1_kneaddata_paired	Spirochaetota	32587	P	8	0	8	0.00002
ERR3598111_1_kneaddata_paired	Firmicutes_I	18140	P	6	0	6	0.00002
ERR3598111_1_kneaddata_paired	Firmicutes_B	17289	P	4	0	4	0.00001
ERR3598111_1_kneaddata_paired	Elusimicrobiota	11888	P	2	0	2	0.00001
ERR3598111_1_kneaddata_paired	Firmicutes_C	17613	P	2	0	2	0.00001
ERR3598111_1_kneaddata_paired	Thermotogota	33086	P	1	0	1	0.00000
ERR3610232_1_kneaddata_paired	Firmicutes_A	14608	P	274520	1269	275789	0.95039
ERR3610232_1_kneaddata_paired	Bacteroidota	4587	P	6471	80	6551	0.02258
ERR3610232_1_kneaddata_paired	Campylobacterota	8700	P	4557	0	4557	0.01570
ERR3610232_1_kneaddata_paired	Firmicutes	12188	P	2840	50	2890	0.00996
ERR3610232_1_kneaddata_paired	Actinobacteriota	615	P	249	0	249	0.00086
ERR3610232_1_kneaddata_paired	Cyanobacteria	9876	P	41	0	41	0.00014
ERR3610232_1_kneaddata_paired	Proteobacteria	22518	P	40	0	40	0.00014
ERR3610232_1_kneaddata_paired	Desulfobacterota_A	11509	P	22	3	25	0.00009
ERR3610232_1_kneaddata_paired	Firmicutes_B	17289	P	21	0	21	0.00007
ERR3610232_1_kneaddata_paired	Verrucomicrobiota	33333	P	8	0	8	0.00003
ERR3610232_1_kneaddata_paired	Firmicutes_C	17613	P	3	0	3	0.00001
ERR3610232_1_kneaddata_paired	Thermotogota	33086	P	3	0	3	0.00001
ERR3610232_1_kneaddata_paired	Deferribacterota	10822	P	2	0	2	0.00001
ERR3610233_1_kneaddata_paired	Firmicutes_A	14608	P	252572	1272	253844	0.94926
ERR3610233_1_kneaddata_paired	Bacteroidota	4587	P	6062	81	6143	0.02297
ERR3610233_1_kneaddata_paired	Campylobacterota	8700	P	4405	0	4405	0.01647
ERR3610233_1_kneaddata_paired	Firmicutes	12188	P	2558	48	2606	0.00975
ERR3610233_1_kneaddata_paired	Actinobacteriota	615	P	256	0	256	0.00096
ERR3610233_1_kneaddata_paired	Cyanobacteria	9876	P	50	0	50	0.00019
ERR3610233_1_kneaddata_paired	Proteobacteria	22518	P	37	0	37	0.00014
ERR3610233_1_kneaddata_paired	Desulfobacterota_A	11509	P	24	3	27	0.00010
ERR3610233_1_kneaddata_paired	Firmicutes_B	17289	P	18	0	18	0.00007
ERR3610233_1_kneaddata_paired	Verrucomicrobiota	33333	P	10	0	10	0.00004
ERR3610233_1_kneaddata_paired	Deferribacterota	10822	P	3	0	3	0.00001
ERR3610233_1_kneaddata_paired	Firmicutes_C	17613	P	3	0	3	0.00001
ERR3610233_1_kneaddata_paired	Spirochaetota	32587	P	2	0	2	0.00001
ERR3610233_1_kneaddata_paired	Firmicutes_I	18140	P	1	0	1	0.00000
ERR3610233_1_kneaddata_paired	Thermotogota	33086	P	1	0	1	0.00000
ERR3610234_1_kneaddata_paired	Firmicutes_A	14608	P	275786	1326	277112	0.94994
ERR3610234_1_kneaddata_paired	Bacteroidota	4587	P	6623	86	6709	0.02300
ERR3610234_1_kneaddata_paired	Campylobacterota	8700	P	4667	0	4667	0.01600
ERR3610234_1_kneaddata_paired	Firmicutes	12188	P	2759	50	2809	0.00963
ERR3610234_1_kneaddata_paired	Actinobacteriota	615	P	279	0	279	0.00096
ERR3610234_1_kneaddata_paired	Proteobacteria	22518	P	36	0	36	0.00013
ERR3610234_1_kneaddata_paired	Cyanobacteria	9876	P	33	0	33	0.00011
ERR3610234_1_kneaddata_paired	Firmicutes_B	17289	P	24	0	24	0.00009
ERR3610234_1_kneaddata_paired	Desulfobacterota_A	11509	P	23	2	25	0.00009
ERR3610234_1_kneaddata_paired	Verrucomicrobiota	33333	P	11	0	11	0.00004
ERR3610234_1_kneaddata_paired	Firmicutes_C	17613	P	2	0	2	0.00001
ERR3610234_1_kneaddata_paired	Spirochaetota	32587	P	2	0	2	0.00001
ERR3610234_1_kneaddata_paired	Firmicutes_I	18140	P	1	0	1	0.00000
ERR3610235_1_kneaddata_paired	Firmicutes_A	14608	P	277790	1314	279104	0.95049
ERR3610235_1_kneaddata_paired	Bacteroidota	4587	P	6672	86	6758	0.02302
ERR3610235_1_kneaddata_paired	Campylobacterota	8700	P	4673	0	4673	0.01591
ERR3610235_1_kneaddata_paired	Firmicutes	12188	P	2641	46	2687	0.00915
ERR3610235_1_kneaddata_paired	Actinobacteriota	615	P	249	0	249	0.00085
ERR3610235_1_kneaddata_paired	Proteobacteria	22518	P	47	1	48	0.00016
ERR3610235_1_kneaddata_paired	Cyanobacteria	9876	P	36	0	36	0.00012
ERR3610235_1_kneaddata_paired	Desulfobacterota_A	11509	P	34	4	38	0.00013
ERR3610235_1_kneaddata_paired	Firmicutes_B	17289	P	28	0	28	0.00010
ERR3610235_1_kneaddata_paired	Verrucomicrobiota	33333	P	10	0	10	0.00004
ERR3610235_1_kneaddata_paired	Firmicutes_I	18140	P	3	0	3	0.00001
ERR3610235_1_kneaddata_paired	Firmicutes_C	17613	P	2	0	2	0.00001
ERR3610235_1_kneaddata_paired	Deferribacterota	10822	P	1	0	1	0.00000
ERR3610235_1_kneaddata_paired	Elusimicrobiota	11888	P	1	0	1	0.00000
ERR3610236_1_kneaddata_paired	Firmicutes_A	14608	P	444452	1750	446202	0.91573
ERR3610236_1_kneaddata_paired	Bacteroidota	4587	P	25554	274	25828	0.05301
ERR3610236_1_kneaddata_paired	Deferribacterota	10822	P	6707	0	6707	0.01377
ERR3610236_1_kneaddata_paired	Firmicutes	12188	P	5674	59	5733	0.01177
ERR3610236_1_kneaddata_paired	Campylobacterota	8700	P	1788	0	1788	0.00367
ERR3610236_1_kneaddata_paired	Actinobacteriota	615	P	562	2	564	0.00116
ERR3610236_1_kneaddata_paired	Desulfobacterota_A	11509	P	229	10	239	0.00049
ERR3610236_1_kneaddata_paired	Cyanobacteria	9876	P	98	2	100	0.00021
ERR3610236_1_kneaddata_paired	Proteobacteria	22518	P	51	0	51	0.00011
ERR3610236_1_kneaddata_paired	Spirochaetota	32587	P	14	0	14	0.00003
ERR3610236_1_kneaddata_paired	Verrucomicrobiota	33333	P	12	0	12	0.00003
ERR3610236_1_kneaddata_paired	Firmicutes_B	17289	P	10	0	10	0.00002
ERR3610236_1_kneaddata_paired	Thermotogota	33086	P	6	0	6	0.00001
ERR3610236_1_kneaddata_paired	Firmicutes_C	17613	P	4	0	4	0.00001
ERR3610236_1_kneaddata_paired	Firmicutes_I	18140	P	3	0	3	0.00001
ERR3610237_1_kneaddata_paired	Firmicutes_A	14608	P	407404	1675	409079	0.91616
ERR3610237_1_kneaddata_paired	Bacteroidota	4587	P	23313	261	23574	0.05280
ERR3610237_1_kneaddata_paired	Deferribacterota	10822	P	6084	0	6084	0.01363
ERR3610237_1_kneaddata_paired	Firmicutes	12188	P	5246	56	5302	0.01188
ERR3610237_1_kneaddata_paired	Campylobacterota	8700	P	1528	0	1528	0.00342
ERR3610237_1_kneaddata_paired	Actinobacteriota	615	P	540	2	542	0.00121
ERR3610237_1_kneaddata_paired	Desulfobacterota_A	11509	P	204	9	213	0.00048
ERR3610237_1_kneaddata_paired	Cyanobacteria	9876	P	98	1	99	0.00022
ERR3610237_1_kneaddata_paired	Proteobacteria	22518	P	40	0	40	0.00009
ERR3610237_1_kneaddata_paired	Thermotogota	33086	P	14	0	14	0.00003
ERR3610237_1_kneaddata_paired	Firmicutes_B	17289	P	10	0	10	0.00002
ERR3610237_1_kneaddata_paired	Firmicutes_C	17613	P	7	0	7	0.00002
ERR3610237_1_kneaddata_paired	Spirochaetota	32587	P	7	0	7	0.00002
ERR3610237_1_kneaddata_paired	Verrucomicrobiota	33333	P	7	0	7	0.00002
ERR3610237_1_kneaddata_paired	Elusimicrobiota	11888	P	3	0	3	0.00001
ERR3610237_1_kneaddata_paired	Firmicutes_I	18140	P	3	0	3	0.00001
ERR3610238_1_kneaddata_paired	Firmicutes_A	14608	P	443962	1876	445838	0.91615
ERR3610238_1_kneaddata_paired	Bacteroidota	4587	P	25520	295	25815	0.05305
ERR3610238_1_kneaddata_paired	Deferribacterota	10822	P	6706	0	6706	0.01378
ERR3610238_1_kneaddata_paired	Firmicutes	12188	P	5506	58	5564	0.01143
ERR3610238_1_kneaddata_paired	Campylobacterota	8700	P	1663	0	1663	0.00342
ERR3610238_1_kneaddata_paired	Actinobacteriota	615	P	596	2	598	0.00123
ERR3610238_1_kneaddata_paired	Desulfobacterota_A	11509	P	229	9	238	0.00049
ERR3610238_1_kneaddata_paired	Cyanobacteria	9876	P	94	1	95	0.00020
ERR3610238_1_kneaddata_paired	Proteobacteria	22518	P	50	0	50	0.00010
ERR3610238_1_kneaddata_paired	Verrucomicrobiota	33333	P	19	0	19	0.00004
ERR3610238_1_kneaddata_paired	Thermotogota	33086	P	16	0	16	0.00003
ERR3610238_1_kneaddata_paired	Firmicutes_B	17289	P	14	0	14	0.00003
ERR3610238_1_kneaddata_paired	Spirochaetota	32587	P	8	0	8	0.00002
ERR3610238_1_kneaddata_paired	Firmicutes_I	18140	P	7	0	7	0.00001
ERR3610238_1_kneaddata_paired	Firmicutes_C	17613	P	6	0	6	0.00001
ERR3610238_1_kneaddata_paired	Elusimicrobiota	11888	P	1	0	1	0.00000
ERR3610239_1_kneaddata_paired	Firmicutes_A	14608	P	444501	1809	446310	0.91615
ERR3610239_1_kneaddata_paired	Bacteroidota	4587	P	25527	283	25810	0.05298
ERR3610239_1_kneaddata_paired	Deferribacterota	10822	P	6572	0	6572	0.01349
ERR3610239_1_kneaddata_paired	Firmicutes	12188	P	5713	61	5774	0.01185
ERR3610239_1_kneaddata_paired	Campylobacterota	8700	P	1640	0	1640	0.00337
ERR3610239_1_kneaddata_paired	Actinobacteriota	615	P	616	2	618	0.00127
ERR3610239_1_kneaddata_paired	Desulfobacterota_A	11509	P	218	10	228	0.00047
ERR3610239_1_kneaddata_paired	Cyanobacteria	9876	P	89	0	89	0.00018
ERR3610239_1_kneaddata_paired	Proteobacteria	22518	P	56	0	56	0.00012
ERR3610239_1_kneaddata_paired	Verrucomicrobiota	33333	P	20	0	20	0.00004
ERR3610239_1_kneaddata_paired	Spirochaetota	32587	P	10	0	10	0.00002
ERR3610239_1_kneaddata_paired	Firmicutes_B	17289	P	9	0	9	0.00002
ERR3610239_1_kneaddata_paired	Firmicutes_C	17613	P	8	0	8	0.00002
ERR3610239_1_kneaddata_paired	Thermotogota	33086	P	7	0	7	0.00001
ERR3610239_1_kneaddata_paired	Firmicutes_I	18140	P	2	0	2	0.00000
ERR3610240_1_kneaddata_paired	Firmicutes_A	14608	P	315362	2013	317375	0.85370
ERR3610240_1_kneaddata_paired	Bacteroidota	4587	P	44550	614	45164	0.12149
ERR3610240_1_kneaddata_paired	Campylobacterota	8700	P	3116	0	3116	0.00838
ERR3610240_1_kneaddata_paired	Firmicutes	12188	P	2748	37	2785	0.00749
ERR3610240_1_kneaddata_paired	Desulfobacterota_A	11509	P	1811	34	1845	0.00496
ERR3610240_1_kneaddata_paired	Deferribacterota	10822	P	786	3	789	0.00212
ERR3610240_1_kneaddata_paired	Actinobacteriota	615	P	572	5	577	0.00155
ERR3610240_1_kneaddata_paired	Cyanobacteria	9876	P	34	0	34	0.00009
ERR3610240_1_kneaddata_paired	Proteobacteria	22518	P	33	0	33	0.00009
ERR3610240_1_kneaddata_paired	Firmicutes_B	17289	P	14	0	14	0.00004
ERR3610240_1_kneaddata_paired	Spirochaetota	32587	P	12	0	12	0.00003
ERR3610240_1_kneaddata_paired	Verrucomicrobiota	33333	P	6	0	6	0.00002
ERR3610240_1_kneaddata_paired	Firmicutes_C	17613	P	3	0	3	0.00001
ERR3610240_1_kneaddata_paired	Thermotogota	33086	P	3	0	3	0.00001
ERR3610240_1_kneaddata_paired	Firmicutes_I	18140	P	2	0	2	0.00001
ERR3610241_1_kneaddata_paired	Firmicutes_A	14608	P	286047	1852	287899	0.85381
ERR3610241_1_kneaddata_paired	Bacteroidota	4587	P	40450	566	41016	0.12164
ERR3610241_1_kneaddata_paired	Campylobacterota	8700	P	2871	0	2871	0.00852
ERR3610241_1_kneaddata_paired	Firmicutes	12188	P	2459	33	2492	0.00739
ERR3610241_1_kneaddata_paired	Desulfobacterota_A	11509	P	1529	29	1558	0.00462
ERR3610241_1_kneaddata_paired	Deferribacterota	10822	P	743	3	746	0.00221
ERR3610241_1_kneaddata_paired	Actinobacteriota	615	P	522	4	526	0.00156
ERR3610241_1_kneaddata_paired	Proteobacteria	22518	P	31	0	31	0.00009
ERR3610241_1_kneaddata_paired	Cyanobacteria	9876	P	30	0	30	0.00009
ERR3610241_1_kneaddata_paired	Firmicutes_B	17289	P	9	0	9	0.00003
ERR3610241_1_kneaddata_paired	Verrucomicrobiota	33333	P	7	0	7	0.00002
ERR3610241_1_kneaddata_paired	Firmicutes_I	18140	P	2	0	2	0.00001
ERR3610241_1_kneaddata_paired	Spirochaetota	32587	P	1	0	1	0.00000
ERR3610242_1_kneaddata_paired	Firmicutes_A	14608	P	316048	1986	318034	0.85376
ERR3610242_1_kneaddata_paired	Bacteroidota	4587	P	44809	619	45428	0.12195
ERR3610242_1_kneaddata_paired	Campylobacterota	8700	P	3099	0	3099	0.00832
ERR3610242_1_kneaddata_paired	Firmicutes	12188	P	2590	38	2628	0.00706
ERR3610242_1_kneaddata_paired	Desulfobacterota_A	11509	P	1762	30	1792	0.00481
ERR3610242_1_kneaddata_paired	Deferribacterota	10822	P	830	3	833	0.00224
ERR3610242_1_kneaddata_paired	Actinobacteriota	615	P	593	5	598	0.00161
ERR3610242_1_kneaddata_paired	Cyanobacteria	9876	P	40	0	40	0.00011
ERR3610242_1_kneaddata_paired	Proteobacteria	22518	P	24	0	24	0.00007
ERR3610242_1_kneaddata_paired	Firmicutes_B	17289	P	9	0	9	0.00003
ERR3610242_1_kneaddata_paired	Verrucomicrobiota	33333	P	8	0	8	0.00002
ERR3610242_1_kneaddata_paired	Spirochaetota	32587	P	7	0	7	0.00002
ERR3610242_1_kneaddata_paired	Firmicutes_C	17613	P	3	0	3	0.00001
ERR3610242_1_kneaddata_paired	Firmicutes_I	18140	P	3	0	3	0.00001
ERR3610242_1_kneaddata_paired	Thermotogota	33086	P	2	0	2	0.00001
ERR3610243_1_kneaddata_paired	Firmicutes_A	14608	P	315217	1994	317211	0.85265
ERR3610243_1_kneaddata_paired	Bacteroidota	4587	P	45085	619	45704	0.12285
ERR3610243_1_kneaddata_paired	Campylobacterota	8700	P	3161	0	3161	0.00850
ERR3610243_1_kneaddata_paired	Firmicutes	12188	P	2715	38	2753	0.00740
ERR3610243_1_kneaddata_paired	Desulfobacterota_A	11509	P	1716	31	1747	0.00470
ERR3610243_1_kneaddata_paired	Deferribacterota	10822	P	796	3	799	0.00215
ERR3610243_1_kneaddata_paired	Actinobacteriota	615	P	544	4	548	0.00148
ERR3610243_1_kneaddata_paired	Cyanobacteria	9876	P	36	0	36	0.00010
ERR3610243_1_kneaddata_paired	Proteobacteria	22518	P	33	0	33	0.00009
ERR3610243_1_kneaddata_paired	Verrucomicrobiota	33333	P	11	0	11	0.00003
ERR3610243_1_kneaddata_paired	Spirochaetota	32587	P	9	0	9	0.00002
ERR3610243_1_kneaddata_paired	Firmicutes_B	17289	P	8	0	8	0.00002
ERR3610243_1_kneaddata_paired	Firmicutes_C	17613	P	2	0	2	0.00001
ERR3610243_1_kneaddata_paired	Thermotogota	33086	P	2	0	2	0.00001
ERR3610243_1_kneaddata_paired	Firmicutes_I	18140	P	1	0	1	0.00000
ERR3610244_1_kneaddata_paired	Firmicutes_A	14608	P	255538	1043	256581	0.78665
ERR3610244_1_kneaddata_paired	Bacteroidota	4587	P	61362	591	61953	0.18994
ERR3610244_1_kneaddata_paired	Firmicutes	12188	P	4314	38	4352	0.01334
ERR3610244_1_kneaddata_paired	Campylobacterota	8700	P	1049	0	1049	0.00322
ERR3610244_1_kneaddata_paired	Desulfobacterota_A	11509	P	968	7	975	0.00299
ERR3610244_1_kneaddata_paired	Deferribacterota	10822	P	683	0	683	0.00209
ERR3610244_1_kneaddata_paired	Actinobacteriota	615	P	297	0	297	0.00091
ERR3610244_1_kneaddata_paired	Proteobacteria	22518	P	159	1	160	0.00049
ERR3610244_1_kneaddata_paired	Cyanobacteria	9876	P	52	2	54	0.00017
ERR3610244_1_kneaddata_paired	Firmicutes_B	17289	P	33	0	33	0.00010
ERR3610244_1_kneaddata_paired	Verrucomicrobiota	33333	P	13	0	13	0.00004
ERR3610244_1_kneaddata_paired	Firmicutes_C	17613	P	7	0	7	0.00002
ERR3610244_1_kneaddata_paired	Firmicutes_I	18140	P	4	0	4	0.00001
ERR3610244_1_kneaddata_paired	Spirochaetota	32587	P	2	0	2	0.00001
ERR3610244_1_kneaddata_paired	Elusimicrobiota	11888	P	1	0	1	0.00000
ERR3610244_1_kneaddata_paired	Thermotogota	33086	P	1	0	1	0.00000
ERR3610245_1_kneaddata_paired	Firmicutes_A	14608	P	233961	1008	234969	0.78730
ERR3610245_1_kneaddata_paired	Bacteroidota	4587	P	56023	569	56592	0.18962
ERR3610245_1_kneaddata_paired	Firmicutes	12188	P	3924	35	3959	0.01327
ERR3610245_1_kneaddata_paired	Campylobacterota	8700	P	930	0	930	0.00312
ERR3610245_1_kneaddata_paired	Desulfobacterota_A	11509	P	847	6	853	0.00286
ERR3610245_1_kneaddata_paired	Deferribacterota	10822	P	638	0	638	0.00214
ERR3610245_1_kneaddata_paired	Actinobacteriota	615	P	247	0	247	0.00083
ERR3610245_1_kneaddata_paired	Proteobacteria	22518	P	155	1	156	0.00053
ERR3610245_1_kneaddata_paired	Cyanobacteria	9876	P	47	1	48	0.00016
ERR3610245_1_kneaddata_paired	Firmicutes_B	17289	P	34	0	34	0.00012
ERR3610245_1_kneaddata_paired	Spirochaetota	32587	P	6	0	6	0.00002
ERR3610245_1_kneaddata_paired	Verrucomicrobiota	33333	P	4	0	4	0.00001
ERR3610245_1_kneaddata_paired	Firmicutes_C	17613	P	3	0	3	0.00001
ERR3610245_1_kneaddata_paired	Elusimicrobiota	11888	P	2	0	2	0.00001
ERR3610245_1_kneaddata_paired	Firmicutes_I	18140	P	1	0	1	0.00000
ERR3610245_1_kneaddata_paired	Thermotogota	33086	P	1	0	1	0.00000
ERR3610246_1_kneaddata_paired	Firmicutes_A	14608	P	257628	1075	258703	0.78573
ERR3610246_1_kneaddata_paired	Bacteroidota	4587	P	62257	614	62871	0.19095
ERR3610246_1_kneaddata_paired	Firmicutes	12188	P	4231	36	4267	0.01296
ERR3610246_1_kneaddata_paired	Campylobacterota	8700	P	1059	0	1059	0.00322
ERR3610246_1_kneaddata_paired	Desulfobacterota_A	11509	P	1043	7	1050	0.00319
ERR3610246_1_kneaddata_paired	Deferribacterota	10822	P	697	0	697	0.00212
ERR3610246_1_kneaddata_paired	Actinobacteriota	615	P	309	0	309	0.00094
ERR3610246_1_kneaddata_paired	Proteobacteria	22518	P	178	2	180	0.00055
ERR3610246_1_kneaddata_paired	Cyanobacteria	9876	P	51	2	53	0.00016
ERR3610246_1_kneaddata_paired	Firmicutes_B	17289	P	31	0	31	0.00010
ERR3610246_1_kneaddata_paired	Verrucomicrobiota	33333	P	11	0	11	0.00003
ERR3610246_1_kneaddata_paired	Firmicutes_C	17613	P	6	0	6	0.00002
ERR3610246_1_kneaddata_paired	Spirochaetota	32587	P	5	0	5	0.00002
ERR3610246_1_kneaddata_paired	Firmicutes_I	18140	P	3	0	3	0.00001
ERR3610246_1_kneaddata_paired	Thermotogota	33086	P	2	0	2	0.00001
ERR3610246_1_kneaddata_paired	Elusimicrobiota	11888	P	1	0	1	0.00000
ERR3610247_1_kneaddata_paired	Firmicutes_A	14608	P	258288	1036	259324	0.78678
ERR3610247_1_kneaddata_paired	Bacteroidota	4587	P	61942	578	62520	0.18969
ERR3610247_1_kneaddata_paired	Firmicutes	12188	P	4405	36	4441	0.01347
ERR3610247_1_kneaddata_paired	Campylobacterota	8700	P	1086	0	1086	0.00330
ERR3610247_1_kneaddata_paired	Desulfobacterota_A	11509	P	1062	7	1069	0.00324
ERR3610247_1_kneaddata_paired	Deferribacterota	10822	P	624	0	624	0.00189
ERR3610247_1_kneaddata_paired	Actinobacteriota	615	P	279	0	279	0.00085
ERR3610247_1_kneaddata_paired	Proteobacteria	22518	P	159	1	160	0.00049
ERR3610247_1_kneaddata_paired	Cyanobacteria	9876	P	42	1	43	0.00013
ERR3610247_1_kneaddata_paired	Firmicutes_B	17289	P	28	0	28	0.00009
ERR3610247_1_kneaddata_paired	Verrucomicrobiota	33333	P	10	0	10	0.00003
ERR3610247_1_kneaddata_paired	Firmicutes_C	17613	P	6	0	6	0.00002
ERR3610247_1_kneaddata_paired	Elusimicrobiota	11888	P	2	0	2	0.00001
ERR3610247_1_kneaddata_paired	Firmicutes_I	18140	P	2	0	2	0.00001
ERR3610247_1_kneaddata_paired	Spirochaetota	32587	P	2	0	2	0.00001
ERR3610247_1_kneaddata_paired	Thermotogota	33086	P	1	0	1	0.00000
ERR3610248_1_kneaddata_paired	Firmicutes_A	14608	P	280235	1074	281309	0.85376
ERR3610248_1_kneaddata_paired	Bacteroidota	4587	P	23994	182	24176	0.07337
ERR3610248_1_kneaddata_paired	Deferribacterota	10822	P	14410	1	14411	0.04374
ERR3610248_1_kneaddata_paired	Firmicutes	12188	P	5708	33	5741	0.01743
ERR3610248_1_kneaddata_paired	Campylobacterota	8700	P	2196	0	2196	0.00667
ERR3610248_1_kneaddata_paired	Desulfobacterota_A	11509	P	1205	14	1219	0.00370
ERR3610248_1_kneaddata_paired	Actinobacteriota	615	P	222	0	222	0.00068
ERR3610248_1_kneaddata_paired	Cyanobacteria	9876	P	123	4	127	0.00039
ERR3610248_1_kneaddata_paired	Proteobacteria	22518	P	43	0	43	0.00013
ERR3610248_1_kneaddata_paired	Spirochaetota	32587	P	13	0	13	0.00004
ERR3610248_1_kneaddata_paired	Firmicutes_B	17289	P	12	0	12	0.00004
ERR3610248_1_kneaddata_paired	Firmicutes_C	17613	P	8	0	8	0.00002
ERR3610248_1_kneaddata_paired	Verrucomicrobiota	33333	P	6	0	6	0.00002
ERR3610248_1_kneaddata_paired	Thermotogota	33086	P	4	0	4	0.00001
ERR3610248_1_kneaddata_paired	Firmicutes_I	18140	P	3	0	3	0.00001
ERR3610248_1_kneaddata_paired	Elusimicrobiota	11888	P	1	0	1	0.00000
ERR3610249_1_kneaddata_paired	Firmicutes_A	14608	P	257331	993	258324	0.85398
ERR3610249_1_kneaddata_paired	Bacteroidota	4587	P	22074	169	22243	0.07353
ERR3610249_1_kneaddata_paired	Deferribacterota	10822	P	13006	1	13007	0.04300
ERR3610249_1_kneaddata_paired	Firmicutes	12188	P	5225	29	5254	0.01737
ERR3610249_1_kneaddata_paired	Campylobacterota	8700	P	2093	0	2093	0.00692
ERR3610249_1_kneaddata_paired	Desulfobacterota_A	11509	P	1168	14	1182	0.00391
ERR3610249_1_kneaddata_paired	Actinobacteriota	615	P	207	0	207	0.00069
ERR3610249_1_kneaddata_paired	Cyanobacteria	9876	P	108	5	113	0.00037
ERR3610249_1_kneaddata_paired	Proteobacteria	22518	P	32	0	32	0.00011
ERR3610249_1_kneaddata_paired	Spirochaetota	32587	P	14	0	14	0.00005
ERR3610249_1_kneaddata_paired	Verrucomicrobiota	33333	P	8	0	8	0.00003
ERR3610249_1_kneaddata_paired	Firmicutes_B	17289	P	6	0	6	0.00002
ERR3610249_1_kneaddata_paired	Firmicutes_C	17613	P	6	0	6	0.00002
ERR3610249_1_kneaddata_paired	Firmicutes_I	18140	P	2	0	2	0.00001
ERR3610249_1_kneaddata_paired	Elusimicrobiota	11888	P	1	0	1	0.00000
ERR3610250_1_kneaddata_paired	Firmicutes_A	14608	P	279137	1105	280242	0.85358
ERR3610250_1_kneaddata_paired	Bacteroidota	4587	P	24191	191	24382	0.07426
ERR3610250_1_kneaddata_paired	Deferribacterota	10822	P	13994	1	13995	0.04263
ERR3610250_1_kneaddata_paired	Firmicutes	12188	P	5820	34	5854	0.01783
ERR3610250_1_kneaddata_paired	Campylobacterota	8700	P	2157	0	2157	0.00657
ERR3610250_1_kneaddata_paired	Desulfobacterota_A	11509	P	1228	13	1241	0.00378
ERR3610250_1_kneaddata_paired	Actinobacteriota	615	P	240	0	240	0.00073
ERR3610250_1_kneaddata_paired	Cyanobacteria	9876	P	114	4	118	0.00036
ERR3610250_1_kneaddata_paired	Proteobacteria	22518	P	49	0	49	0.00015
ERR3610250_1_kneaddata_paired	Firmicutes_C	17613	P	8	0	8	0.00002
ERR3610250_1_kneaddata_paired	Firmicutes_I	18140	P	6	0	6	0.00002
ERR3610250_1_kneaddata_paired	Spirochaetota	32587	P	6	0	6	0.00002
ERR3610250_1_kneaddata_paired	Verrucomicrobiota	33333	P	5	0	5	0.00002
ERR3610250_1_kneaddata_paired	Firmicutes_B	17289	P	3	0	3	0.00001
ERR3610250_1_kneaddata_paired	Elusimicrobiota	11888	P	2	0	2	0.00001
ERR3610250_1_kneaddata_paired	Thermotogota	33086	P	2	0	2	0.00001
ERR3610251_1_kneaddata_paired	Firmicutes_A	14608	P	282358	1135	283493	0.85512
ERR3610251_1_kneaddata_paired	Bacteroidota	4587	P	24060	192	24252	0.07315
ERR3610251_1_kneaddata_paired	Deferribacterota	10822	P	14094	1	14095	0.04252
ERR3610251_1_kneaddata_paired	Firmicutes	12188	P	5784	33	5817	0.01755
ERR3610251_1_kneaddata_paired	Campylobacterota	8700	P	2178	0	2178	0.00657
ERR3610251_1_kneaddata_paired	Desulfobacterota_A	11509	P	1256	15	1271	0.00384
ERR3610251_1_kneaddata_paired	Actinobacteriota	615	P	225	0	225	0.00068
ERR3610251_1_kneaddata_paired	Cyanobacteria	9876	P	107	4	111	0.00034
ERR3610251_1_kneaddata_paired	Proteobacteria	22518	P	46	0	46	0.00014
ERR3610251_1_kneaddata_paired	Verrucomicrobiota	33333	P	9	0	9	0.00003
ERR3610251_1_kneaddata_paired	Spirochaetota	32587	P	8	0	8	0.00002
ERR3610251_1_kneaddata_paired	Firmicutes_I	18140	P	6	0	6	0.00002
ERR3610251_1_kneaddata_paired	Firmicutes_B	17289	P	4	0	4	0.00001
ERR3610251_1_kneaddata_paired	Elusimicrobiota	11888	P	2	0	2	0.00001
ERR3610251_1_kneaddata_paired	Firmicutes_C	17613	P	2	0	2	0.00001
ERR3610251_1_kneaddata_paired	Thermotogota	33086	P	1	0	1	0.00000
ERR3957830_1_kneaddata_paired	Firmicutes_A	14608	P	22906760	100711	23007471	0.87097
ERR3957830_1_kneaddata_paired	Bacteroidota	4587	P	2761527	54341	2815868	0.10660
ERR3957830_1_kneaddata_paired	Firmicutes	12188	P	514647	11690	526337	0.01992
ERR3957830_1_kneaddata_paired	Actinobacteriota	615	P	26623	23	26646	0.00101
ERR3957830_1_kneaddata_paired	Verrucomicrobiota	33333	P	15421	1111	16532	0.00063
ERR3957830_1_kneaddata_paired	Proteobacteria	22518	P	9709	250	9959	0.00038
ERR3957830_1_kneaddata_paired	Cyanobacteria	9876	P	6999	231	7230	0.00027
ERR3957830_1_kneaddata_paired	Desulfobacterota_A	11509	P	1880	312	2192	0.00008
ERR3957830_1_kneaddata_paired	Firmicutes_B	17289	P	1552	74	1626	0.00006
ERR3957830_1_kneaddata_paired	Spirochaetota	32587	P	1159	1	1160	0.00004
ERR3957830_1_kneaddata_paired	Campylobacterota	8700	P	416	0	416	0.00002
ERR3957830_1_kneaddata_paired	Firmicutes_I	18140	P	200	0	200	0.00001
ERR3957830_1_kneaddata_paired	Firmicutes_C	17613	P	153	0	153	0.00001
ERR3957830_1_kneaddata_paired	Deferribacterota	10822	P	101	0	101	0.00000
ERR3957830_1_kneaddata_paired	Thermotogota	33086	P	44	0	44	0.00000
ERR3957830_1_kneaddata_paired	Elusimicrobiota	11888	P	32	0	32	0.00000
ERR3957831_1_kneaddata_paired	Firmicutes_A	14608	P	14772704	55658	14828362	0.57186
ERR3957831_1_kneaddata_paired	Bacteroidota	4587	P	7257844	14058	7271902	0.28045
ERR3957831_1_kneaddata_paired	Verrucomicrobiota	33333	P	2221164	58614	2279778	0.08792
ERR3957831_1_kneaddata_paired	Firmicutes	12188	P	1033864	51085	1084949	0.04184
ERR3957831_1_kneaddata_paired	Actinobacteriota	615	P	436274	51	436325	0.01683
ERR3957831_1_kneaddata_paired	Proteobacteria	22518	P	10338	93	10431	0.00040
ERR3957831_1_kneaddata_paired	Cyanobacteria	9876	P	7964	24	7988	0.00031
ERR3957831_1_kneaddata_paired	Desulfobacterota_A	11509	P	4498	298	4796	0.00018
ERR3957831_1_kneaddata_paired	Firmicutes_B	17289	P	3131	53	3184	0.00012
ERR3957831_1_kneaddata_paired	Spirochaetota	32587	P	1595	0	1595	0.00006
ERR3957831_1_kneaddata_paired	Campylobacterota	8700	P	161	0	161	0.00001
ERR3957831_1_kneaddata_paired	Firmicutes_C	17613	P	155	0	155	0.00001
ERR3957831_1_kneaddata_paired	Firmicutes_I	18140	P	134	0	134	0.00001
ERR3957831_1_kneaddata_paired	Deferribacterota	10822	P	43	0	43	0.00000
ERR3957831_1_kneaddata_paired	Thermotogota	33086	P	33	0	33	0.00000
ERR3957831_1_kneaddata_paired	Elusimicrobiota	11888	P	11	0	11	0.00000
ERR3957832_1_kneaddata_paired	Firmicutes_A	14608	P	13059786	66136	13125922	0.91499
ERR3957832_1_kneaddata_paired	Bacteroidota	4587	P	890848	18857	909705	0.06341
ERR3957832_1_kneaddata_paired	Firmicutes	12188	P	234304	7425	241729	0.01685
ERR3957832_1_kneaddata_paired	Actinobacteriota	615	P	28188	9	28197	0.00197
ERR3957832_1_kneaddata_paired	Firmicutes_B	17289	P	14890	585	15475	0.00108
ERR3957832_1_kneaddata_paired	Verrucomicrobiota	33333	P	13569	828	14397	0.00100
ERR3957832_1_kneaddata_paired	Proteobacteria	22518	P	4630	100	4730	0.00033
ERR3957832_1_kneaddata_paired	Cyanobacteria	9876	P	2828	26	2854	0.00020
ERR3957832_1_kneaddata_paired	Desulfobacterota_A	11509	P	992	127	1119	0.00008
ERR3957832_1_kneaddata_paired	Spirochaetota	32587	P	889	1	890	0.00006
ERR3957832_1_kneaddata_paired	Campylobacterota	8700	P	126	0	126	0.00001
ERR3957832_1_kneaddata_paired	Firmicutes_I	18140	P	86	0	86	0.00001
ERR3957832_1_kneaddata_paired	Deferribacterota	10822	P	85	0	85	0.00001
ERR3957832_1_kneaddata_paired	Firmicutes_C	17613	P	63	0	63	0.00000
ERR3957832_1_kneaddata_paired	Elusimicrobiota	11888	P	9	0	9	0.00000
ERR3957832_1_kneaddata_paired	Thermotogota	33086	P	5	0	5	0.00000
ERR3957833_1_kneaddata_paired	Firmicutes_A	14608	P	15708969	45323	15754292	0.56564
ERR3957833_1_kneaddata_paired	Bacteroidota	4587	P	8347476	16241	8363717	0.30029
ERR3957833_1_kneaddata_paired	Verrucomicrobiota	33333	P	1960755	47532	2008287	0.07211
ERR3957833_1_kneaddata_paired	Firmicutes	12188	P	939099	44624	983723	0.03532
ERR3957833_1_kneaddata_paired	Firmicutes_B	17289	P	408332	6350	414682	0.01489
ERR3957833_1_kneaddata_paired	Actinobacteriota	615	P	256230	25	256255	0.00920
ERR3957833_1_kneaddata_paired	Proteobacteria	22518	P	58587	532	59119	0.00212
ERR3957833_1_kneaddata_paired	Cyanobacteria	9876	P	6555	21	6576	0.00024
ERR3957833_1_kneaddata_paired	Desulfobacterota_A	11509	P	3573	209	3782	0.00014
ERR3957833_1_kneaddata_paired	Spirochaetota	32587	P	1196	0	1196	0.00004
ERR3957833_1_kneaddata_paired	Firmicutes_I	18140	P	239	0	239	0.00001
ERR3957833_1_kneaddata_paired	Campylobacterota	8700	P	184	0	184	0.00001
ERR3957833_1_kneaddata_paired	Firmicutes_C	17613	P	150	0	150	0.00001
ERR3957833_1_kneaddata_paired	Deferribacterota	10822	P	17	0	17	0.00000
ERR3957833_1_kneaddata_paired	Elusimicrobiota	11888	P	17	0	17	0.00000
ERR3957833_1_kneaddata_paired	Thermotogota	33086	P	16	0	16	0.00000
ERR3957834_1_kneaddata_paired	Firmicutes_A	14608	P	14348828	61499	14410327	0.71062
ERR3957834_1_kneaddata_paired	Bacteroidota	4587	P	4513017	70428	4583445	0.22602
ERR3957834_1_kneaddata_paired	Firmicutes	12188	P	648538	21736	670274	0.03305
ERR3957834_1_kneaddata_paired	Verrucomicrobiota	33333	P	325700	17853	343553	0.01694
ERR3957834_1_kneaddata_paired	Actinobacteriota	615	P	149778	26	149804	0.00739
ERR3957834_1_kneaddata_paired	Firmicutes_B	17289	P	90612	3188	93800	0.00463
ERR3957834_1_kneaddata_paired	Proteobacteria	22518	P	17787	352	18139	0.00089
ERR3957834_1_kneaddata_paired	Cyanobacteria	9876	P	5823	86	5909	0.00029
ERR3957834_1_kneaddata_paired	Spirochaetota	32587	P	1386	1	1387	0.00007
ERR3957834_1_kneaddata_paired	Desulfobacterota_A	11509	P	1165	148	1313	0.00006
ERR3957834_1_kneaddata_paired	Campylobacterota	8700	P	211	0	211	0.00001
ERR3957834_1_kneaddata_paired	Deferribacterota	10822	P	145	0	145	0.00001
ERR3957834_1_kneaddata_paired	Firmicutes_I	18140	P	126	0	126	0.00001
ERR3957834_1_kneaddata_paired	Firmicutes_C	17613	P	86	0	86	0.00000
ERR3957834_1_kneaddata_paired	Thermotogota	33086	P	28	0	28	0.00000
ERR3957834_1_kneaddata_paired	Elusimicrobiota	11888	P	11	0	11	0.00000
ERR3957835_1_kneaddata_paired	Firmicutes_A	14608	P	15134079	63664	15197743	0.56176
ERR3957835_1_kneaddata_paired	Bacteroidota	4587	P	8511605	17083	8528688	0.31525
ERR3957835_1_kneaddata_paired	Verrucomicrobiota	33333	P	2068674	68680	2137354	0.07900
ERR3957835_1_kneaddata_paired	Firmicutes_B	17289	P	404069	8613	412682	0.01525
ERR3957835_1_kneaddata_paired	Actinobacteriota	615	P	371448	26	371474	0.01373
ERR3957835_1_kneaddata_paired	Firmicutes	12188	P	302111	20179	322290	0.01191
ERR3957835_1_kneaddata_paired	Proteobacteria	22518	P	66349	824	67173	0.00248
ERR3957835_1_kneaddata_paired	Cyanobacteria	9876	P	10046	28	10074	0.00037
ERR3957835_1_kneaddata_paired	Desulfobacterota_A	11509	P	3739	302	4041	0.00015
ERR3957835_1_kneaddata_paired	Spirochaetota	32587	P	1726	0	1726	0.00006
ERR3957835_1_kneaddata_paired	Firmicutes_I	18140	P	187	0	187	0.00001
ERR3957835_1_kneaddata_paired	Firmicutes_C	17613	P	159	0	159	0.00001
ERR3957835_1_kneaddata_paired	Campylobacterota	8700	P	131	0	131	0.00000
ERR3957835_1_kneaddata_paired	Deferribacterota	10822	P	27	0	27	0.00000
ERR3957835_1_kneaddata_paired	Elusimicrobiota	11888	P	19	0	19	0.00000
ERR3957835_1_kneaddata_paired	Thermotogota	33086	P	15	0	15	0.00000
ERR3957836_1_kneaddata_paired	Firmicutes_A	14608	P	16035730	99814	16135544	0.88377
ERR3957836_1_kneaddata_paired	Bacteroidota	4587	P	1639617	28914	1668531	0.09139
ERR3957836_1_kneaddata_paired	Firmicutes	12188	P	373834	12433	386267	0.02116
ERR3957836_1_kneaddata_paired	Actinobacteriota	615	P	24033	11	24044	0.00132
ERR3957836_1_kneaddata_paired	Verrucomicrobiota	33333	P	22734	1883	24617	0.00135
ERR3957836_1_kneaddata_paired	Firmicutes_B	17289	P	9427	500	9927	0.00054
ERR3957836_1_kneaddata_paired	Proteobacteria	22518	P	3320	89	3409	0.00019
ERR3957836_1_kneaddata_paired	Cyanobacteria	9876	P	2541	69	2610	0.00014
ERR3957836_1_kneaddata_paired	Desulfobacterota_A	11509	P	1398	282	1680	0.00009
ERR3957836_1_kneaddata_paired	Spirochaetota	32587	P	652	1	653	0.00004
ERR3957836_1_kneaddata_paired	Firmicutes_I	18140	P	185	0	185	0.00001
ERR3957836_1_kneaddata_paired	Campylobacterota	8700	P	129	0	129	0.00001
ERR3957836_1_kneaddata_paired	Firmicutes_C	17613	P	70	0	70	0.00000
ERR3957836_1_kneaddata_paired	Deferribacterota	10822	P	28	0	28	0.00000
ERR3957836_1_kneaddata_paired	Elusimicrobiota	11888	P	7	0	7	0.00000
ERR3957836_1_kneaddata_paired	Thermotogota	33086	P	3	0	3	0.00000
ERR3957837_1_kneaddata_paired	Firmicutes_A	14608	P	15455800	46363	15502163	0.55541
ERR3957837_1_kneaddata_paired	Bacteroidota	4587	P	8004170	15653	8019823	0.28734
ERR3957837_1_kneaddata_paired	Verrucomicrobiota	33333	P	2897904	80662	2978566	0.10672
ERR3957837_1_kneaddata_paired	Firmicutes_B	17289	P	580354	10371	590725	0.02116
ERR3957837_1_kneaddata_paired	Actinobacteriota	615	P	403356	32	403388	0.01445
ERR3957837_1_kneaddata_paired	Firmicutes	12188	P	308532	14791	323323	0.01158
ERR3957837_1_kneaddata_paired	Proteobacteria	22518	P	78156	816	78972	0.00283
ERR3957837_1_kneaddata_paired	Cyanobacteria	9876	P	8567	22	8589	0.00031
ERR3957837_1_kneaddata_paired	Desulfobacterota_A	11509	P	2969	196	3165	0.00011
ERR3957837_1_kneaddata_paired	Spirochaetota	32587	P	1624	0	1624	0.00006
ERR3957837_1_kneaddata_paired	Firmicutes_C	17613	P	208	0	208	0.00001
ERR3957837_1_kneaddata_paired	Firmicutes_I	18140	P	183	0	183	0.00001
ERR3957837_1_kneaddata_paired	Campylobacterota	8700	P	139	0	139	0.00000
ERR3957837_1_kneaddata_paired	Deferribacterota	10822	P	38	0	38	0.00000
ERR3957837_1_kneaddata_paired	Elusimicrobiota	11888	P	23	0	23	0.00000
ERR3957837_1_kneaddata_paired	Thermotogota	33086	P	21	0	21	0.00000
ERR3957838_1_kneaddata_paired	Firmicutes_A	14608	P	14993753	68262	15062015	0.88122
ERR3957838_1_kneaddata_paired	Bacteroidota	4587	P	1544941	21540	1566481	0.09165
ERR3957838_1_kneaddata_paired	Firmicutes	12188	P	398040	7754	405794	0.02374
ERR3957838_1_kneaddata_paired	Actinobacteriota	615	P	26168	8	26176	0.00153
ERR3957838_1_kneaddata_paired	Proteobacteria	22518	P	13470	310	13780	0.00081
ERR3957838_1_kneaddata_paired	Verrucomicrobiota	33333	P	9830	566	10396	0.00061
ERR3957838_1_kneaddata_paired	Cyanobacteria	9876	P	3854	115	3969	0.00023
ERR3957838_1_kneaddata_paired	Firmicutes_B	17289	P	1119	41	1160	0.00007
ERR3957838_1_kneaddata_paired	Spirochaetota	32587	P	883	1	884	0.00005
ERR3957838_1_kneaddata_paired	Desulfobacterota_A	11509	P	797	91	888	0.00005
ERR3957838_1_kneaddata_paired	Campylobacterota	8700	P	292	0	292	0.00002
ERR3957838_1_kneaddata_paired	Firmicutes_I	18140	P	156	0	156	0.00001
ERR3957838_1_kneaddata_paired	Deferribacterota	10822	P	85	0	85	0.00000
ERR3957838_1_kneaddata_paired	Firmicutes_C	17613	P	45	0	45	0.00000
ERR3957838_1_kneaddata_paired	Thermotogota	33086	P	13	0	13	0.00000
ERR3957838_1_kneaddata_paired	Elusimicrobiota	11888	P	11	0	11	0.00000
ERR3957839_1_kneaddata_paired	Firmicutes_A	14608	P	12604158	57370	12661528	0.57184
ERR3957839_1_kneaddata_paired	Bacteroidota	4587	P	4849505	3894	4853399	0.21920
ERR3957839_1_kneaddata_paired	Verrucomicrobiota	33333	P	2215241	69707	2284948	0.10320
ERR3957839_1_kneaddata_paired	Firmicutes	12188	P	1470485	101587	1572072	0.07100
ERR3957839_1_kneaddata_paired	Actinobacteriota	615	P	574388	156	574544	0.02595
ERR3957839_1_kneaddata_paired	Proteobacteria	22518	P	128052	1520	129572	0.00585
ERR3957839_1_kneaddata_paired	Firmicutes_B	17289	P	50303	1019	51322	0.00232
ERR3957839_1_kneaddata_paired	Cyanobacteria	9876	P	7709	17	7726	0.00035
ERR3957839_1_kneaddata_paired	Desulfobacterota_A	11509	P	4388	360	4748	0.00021
ERR3957839_1_kneaddata_paired	Spirochaetota	32587	P	1424	1	1425	0.00006
ERR3957839_1_kneaddata_paired	Firmicutes_I	18140	P	131	0	131	0.00001
ERR3957839_1_kneaddata_paired	Campylobacterota	8700	P	130	0	130	0.00001
ERR3957839_1_kneaddata_paired	Firmicutes_C	17613	P	124	0	124	0.00001
ERR3957839_1_kneaddata_paired	Elusimicrobiota	11888	P	39	0	39	0.00000
ERR3957839_1_kneaddata_paired	Deferribacterota	10822	P	23	0	23	0.00000
ERR3957839_1_kneaddata_paired	Thermotogota	33086	P	13	0	13	0.00000
ERR3957840_1_kneaddata_paired	Firmicutes_A	14608	P	11425293	54763	11480056	0.65115
ERR3957840_1_kneaddata_paired	Bacteroidota	4587	P	4828184	49676	4877860	0.27667
ERR3957840_1_kneaddata_paired	Firmicutes	12188	P	1173380	10107	1183487	0.06713
ERR3957840_1_kneaddata_paired	Proteobacteria	22518	P	36516	758	37274	0.00211
ERR3957840_1_kneaddata_paired	Actinobacteriota	615	P	33555	11	33566	0.00190
ERR3957840_1_kneaddata_paired	Verrucomicrobiota	33333	P	7784	418	8202	0.00047
ERR3957840_1_kneaddata_paired	Cyanobacteria	9876	P	5029	90	5119	0.00029
ERR3957840_1_kneaddata_paired	Firmicutes_B	17289	P	1115	38	1153	0.00007
ERR3957840_1_kneaddata_paired	Desulfobacterota_A	11509	P	1032	128	1160	0.00007
ERR3957840_1_kneaddata_paired	Spirochaetota	32587	P	1020	1	1021	0.00006
ERR3957840_1_kneaddata_paired	Campylobacterota	8700	P	909	0	909	0.00005
ERR3957840_1_kneaddata_paired	Firmicutes_I	18140	P	332	0	332	0.00002
ERR3957840_1_kneaddata_paired	Deferribacterota	10822	P	232	0	232	0.00001
ERR3957840_1_kneaddata_paired	Firmicutes_C	17613	P	56	0	56	0.00000
ERR3957840_1_kneaddata_paired	Elusimicrobiota	11888	P	18	0	18	0.00000
ERR3957840_1_kneaddata_paired	Thermotogota	33086	P	17	0	17	0.00000
ERR3957841_1_kneaddata_paired	Firmicutes_A	14608	P	16555517	90539	16646056	0.67293
ERR3957841_1_kneaddata_paired	Bacteroidota	4587	P	4930633	8232	4938865	0.19966
ERR3957841_1_kneaddata_paired	Verrucomicrobiota	33333	P	2310647	98809	2409456	0.09740
ERR3957841_1_kneaddata_paired	Firmicutes	12188	P	427919	38796	466715	0.01887
ERR3957841_1_kneaddata_paired	Actinobacteriota	615	P	189587	82	189669	0.00767
ERR3957841_1_kneaddata_paired	Proteobacteria	22518	P	67035	1067	68102	0.00275
ERR3957841_1_kneaddata_paired	Cyanobacteria	9876	P	9410	36	9446	0.00038
ERR3957841_1_kneaddata_paired	Desulfobacterota_A	11509	P	3018	317	3335	0.00013
ERR3957841_1_kneaddata_paired	Firmicutes_B	17289	P	2350	64	2414	0.00010
ERR3957841_1_kneaddata_paired	Spirochaetota	32587	P	1869	1	1870	0.00008
ERR3957841_1_kneaddata_paired	Firmicutes_C	17613	P	200	0	200	0.00001
ERR3957841_1_kneaddata_paired	Firmicutes_I	18140	P	194	0	194	0.00001
ERR3957841_1_kneaddata_paired	Campylobacterota	8700	P	138	0	138	0.00001
ERR3957841_1_kneaddata_paired	Elusimicrobiota	11888	P	42	0	42	0.00000
ERR3957841_1_kneaddata_paired	Deferribacterota	10822	P	15	0	15	0.00000
ERR3957841_1_kneaddata_paired	Thermotogota	33086	P	14	0	14	0.00000
ERR3957842_1_kneaddata_paired	Firmicutes_A	14608	P	15462721	73459	15536180	0.80704
ERR3957842_1_kneaddata_paired	Bacteroidota	4587	P	3244672	31875	3276547	0.17020
ERR3957842_1_kneaddata_paired	Firmicutes	12188	P	327306	5154	332460	0.01727
ERR3957842_1_kneaddata_paired	Verrucomicrobiota	33333	P	67866	3831	71697	0.00372
ERR3957842_1_kneaddata_paired	Actinobacteriota	615	P	19117	9	19126	0.00099
ERR3957842_1_kneaddata_paired	Proteobacteria	22518	P	6888	132	7020	0.00036
ERR3957842_1_kneaddata_paired	Cyanobacteria	9876	P	3777	34	3811	0.00020
ERR3957842_1_kneaddata_paired	Desulfobacterota_A	11509	P	1290	158	1448	0.00008
ERR3957842_1_kneaddata_paired	Firmicutes_B	17289	P	865	31	896	0.00005
ERR3957842_1_kneaddata_paired	Spirochaetota	32587	P	826	1	827	0.00004
ERR3957842_1_kneaddata_paired	Campylobacterota	8700	P	259	0	259	0.00001
ERR3957842_1_kneaddata_paired	Deferribacterota	10822	P	185	0	185	0.00001
ERR3957842_1_kneaddata_paired	Firmicutes_I	18140	P	134	0	134	0.00001
ERR3957842_1_kneaddata_paired	Firmicutes_C	17613	P	75	0	75	0.00000
ERR3957842_1_kneaddata_paired	Thermotogota	33086	P	51	0	51	0.00000
ERR3957842_1_kneaddata_paired	Elusimicrobiota	11888	P	14	0	14	0.00000
ERR3957843_1_kneaddata_paired	Bacteroidota	4587	P	12373272	18379	12391651	0.43209
ERR3957843_1_kneaddata_paired	Firmicutes_A	14608	P	11802258	39172	11841430	0.41290
ERR3957843_1_kneaddata_paired	Verrucomicrobiota	33333	P	2887433	70109	2957542	0.10313
ERR3957843_1_kneaddata_paired	Firmicutes	12188	P	922428	36649	959077	0.03344
ERR3957843_1_kneaddata_paired	Actinobacteriota	615	P	413803	37	413840	0.01443
ERR3957843_1_kneaddata_paired	Proteobacteria	22518	P	98060	892	98952	0.00345
ERR3957843_1_kneaddata_paired	Cyanobacteria	9876	P	8252	14	8266	0.00029
ERR3957843_1_kneaddata_paired	Desulfobacterota_A	11509	P	3286	196	3482	0.00012
ERR3957843_1_kneaddata_paired	Firmicutes_B	17289	P	2331	36	2367	0.00008
ERR3957843_1_kneaddata_paired	Spirochaetota	32587	P	1399	0	1399	0.00005
ERR3957843_1_kneaddata_paired	Firmicutes_I	18140	P	224	0	224	0.00001
ERR3957843_1_kneaddata_paired	Campylobacterota	8700	P	199	0	199	0.00001
ERR3957843_1_kneaddata_paired	Firmicutes_C	17613	P	141	0	141	0.00000
ERR3957843_1_kneaddata_paired	Deferribacterota	10822	P	40	0	40	0.00000
ERR3957843_1_kneaddata_paired	Elusimicrobiota	11888	P	17	0	17	0.00000
ERR3957843_1_kneaddata_paired	Thermotogota	33086	P	14	0	14	0.00000
ERR3957844_1_kneaddata_paired	Firmicutes_A	14608	P	18333459	96833	18430292	0.88147
ERR3957844_1_kneaddata_paired	Bacteroidota	4587	P	2093392	31326	2124718	0.10162
ERR3957844_1_kneaddata_paired	Firmicutes	12188	P	218518	4209	222727	0.01065
ERR3957844_1_kneaddata_paired	Verrucomicrobiota	33333	P	76442	4632	81074	0.00388
ERR3957844_1_kneaddata_paired	Actinobacteriota	615	P	28259	22	28281	0.00135
ERR3957844_1_kneaddata_paired	Proteobacteria	22518	P	10408	221	10629	0.00051
ERR3957844_1_kneaddata_paired	Cyanobacteria	9876	P	4908	101	5009	0.00024
ERR3957844_1_kneaddata_paired	Desulfobacterota_A	11509	P	2609	424	3033	0.00015
ERR3957844_1_kneaddata_paired	Spirochaetota	32587	P	1026	1	1027	0.00005
ERR3957844_1_kneaddata_paired	Firmicutes_B	17289	P	915	35	950	0.00005
ERR3957844_1_kneaddata_paired	Campylobacterota	8700	P	314	0	314	0.00002
ERR3957844_1_kneaddata_paired	Firmicutes_I	18140	P	155	0	155	0.00001
ERR3957844_1_kneaddata_paired	Firmicutes_C	17613	P	109	0	109	0.00001
ERR3957844_1_kneaddata_paired	Deferribacterota	10822	P	108	0	108	0.00001
ERR3957844_1_kneaddata_paired	Thermotogota	33086	P	35	0	35	0.00000
ERR3957844_1_kneaddata_paired	Elusimicrobiota	11888	P	21	0	21	0.00000
ERR3957845_1_kneaddata_paired	Firmicutes_A	14608	P	16179243	65581	16244824	0.61293
ERR3957845_1_kneaddata_paired	Bacteroidota	4587	P	6206966	13847	6220813	0.23472
ERR3957845_1_kneaddata_paired	Verrucomicrobiota	33333	P	2629735	74410	2704145	0.10203
ERR3957845_1_kneaddata_paired	Firmicutes	12188	P	680159	41011	721170	0.02721
ERR3957845_1_kneaddata_paired	Actinobacteriota	615	P	531126	60	531186	0.02004
ERR3957845_1_kneaddata_paired	Proteobacteria	22518	P	61584	650	62234	0.00235
ERR3957845_1_kneaddata_paired	Cyanobacteria	9876	P	7388	17	7405	0.00028
ERR3957845_1_kneaddata_paired	Desulfobacterota_A	11509	P	5376	397	5773	0.00022
ERR3957845_1_kneaddata_paired	Firmicutes_B	17289	P	3961	72	4033	0.00015
ERR3957845_1_kneaddata_paired	Spirochaetota	32587	P	1502	0	1502	0.00006
ERR3957845_1_kneaddata_paired	Firmicutes_I	18140	P	181	0	181	0.00001
ERR3957845_1_kneaddata_paired	Firmicutes_C	17613	P	159	0	159	0.00001
ERR3957845_1_kneaddata_paired	Campylobacterota	8700	P	117	0	117	0.00000
ERR3957845_1_kneaddata_paired	Deferribacterota	10822	P	39	0	39	0.00000
ERR3957845_1_kneaddata_paired	Elusimicrobiota	11888	P	37	0	37	0.00000
ERR3957845_1_kneaddata_paired	Thermotogota	33086	P	17	0	17	0.00000
ERR3957846_1_kneaddata_paired	Bacteroidota	4587	P	12556521	89213	12645734	0.56046
ERR3957846_1_kneaddata_paired	Firmicutes_A	14608	P	8060224	26412	8086636	0.35840
ERR3957846_1_kneaddata_paired	Verrucomicrobiota	33333	P	918058	39824	957882	0.04245
ERR3957846_1_kneaddata_paired	Firmicutes	12188	P	801643	6883	808526	0.03583
ERR3957846_1_kneaddata_paired	Actinobacteriota	615	P	27674	6	27680	0.00123
ERR3957846_1_kneaddata_paired	Proteobacteria	22518	P	25258	402	25660	0.00114
ERR3957846_1_kneaddata_paired	Cyanobacteria	9876	P	5990	63	6053	0.00027
ERR3957846_1_kneaddata_paired	Firmicutes_B	17289	P	1456	40	1496	0.00007
ERR3957846_1_kneaddata_paired	Spirochaetota	32587	P	1182	1	1183	0.00005
ERR3957846_1_kneaddata_paired	Desulfobacterota_A	11509	P	657	40	697	0.00003
ERR3957846_1_kneaddata_paired	Deferribacterota	10822	P	536	0	536	0.00002
ERR3957846_1_kneaddata_paired	Campylobacterota	8700	P	519	0	519	0.00002
ERR3957846_1_kneaddata_paired	Firmicutes_I	18140	P	283	0	283	0.00001
ERR3957846_1_kneaddata_paired	Firmicutes_C	17613	P	109	0	109	0.00000
ERR3957846_1_kneaddata_paired	Thermotogota	33086	P	12	0	12	0.00000
ERR3957846_1_kneaddata_paired	Elusimicrobiota	11888	P	10	0	10	0.00000
ERR3957847_1_kneaddata_paired	Firmicutes_A	14608	P	10252503	27981	10280484	0.46185
ERR3957847_1_kneaddata_paired	Bacteroidota	4587	P	8054586	12835	8067421	0.36243
ERR3957847_1_kneaddata_paired	Verrucomicrobiota	33333	P	2194453	44676	2239129	0.10059
ERR3957847_1_kneaddata_paired	Firmicutes	12188	P	1198794	38963	1237757	0.05561
ERR3957847_1_kneaddata_paired	Actinobacteriota	615	P	313520	50	313570	0.01409
ERR3957847_1_kneaddata_paired	Proteobacteria	22518	P	107190	824	108014	0.00485
ERR3957847_1_kneaddata_paired	Cyanobacteria	9876	P	6167	12	6179	0.00028
ERR3957847_1_kneaddata_paired	Desulfobacterota_A	11509	P	2596	109	2705	0.00012
ERR3957847_1_kneaddata_paired	Firmicutes_B	17289	P	2452	32	2484	0.00011
ERR3957847_1_kneaddata_paired	Spirochaetota	32587	P	1093	0	1093	0.00005
ERR3957847_1_kneaddata_paired	Firmicutes_I	18140	P	180	0	180	0.00001
ERR3957847_1_kneaddata_paired	Campylobacterota	8700	P	114	0	114	0.00001
ERR3957847_1_kneaddata_paired	Firmicutes_C	17613	P	113	0	113	0.00001
ERR3957847_1_kneaddata_paired	Deferribacterota	10822	P	82	0	82	0.00000
ERR3957847_1_kneaddata_paired	Elusimicrobiota	11888	P	9	0	9	0.00000
ERR3957847_1_kneaddata_paired	Thermotogota	33086	P	9	0	9	0.00000
ERR3957848_1_kneaddata_paired	Firmicutes_A	14608	P	20045327	125287	20170614	0.83575
ERR3957848_1_kneaddata_paired	Bacteroidota	4587	P	3368560	56142	3424702	0.14190
ERR3957848_1_kneaddata_paired	Firmicutes	12188	P	427829	8766	436595	0.01809
ERR3957848_1_kneaddata_paired	Verrucomicrobiota	33333	P	46960	3498	50458	0.00209
ERR3957848_1_kneaddata_paired	Actinobacteriota	615	P	26992	18	27010	0.00112
ERR3957848_1_kneaddata_paired	Proteobacteria	22518	P	10043	264	10307	0.00043
ERR3957848_1_kneaddata_paired	Firmicutes_B	17289	P	4607	220	4827	0.00020
ERR3957848_1_kneaddata_paired	Cyanobacteria	9876	P	4214	65	4279	0.00018
ERR3957848_1_kneaddata_paired	Desulfobacterota_A	11509	P	3467	688	4155	0.00017
ERR3957848_1_kneaddata_paired	Spirochaetota	32587	P	1177	2	1179	0.00005
ERR3957848_1_kneaddata_paired	Firmicutes_I	18140	P	188	0	188	0.00001
ERR3957848_1_kneaddata_paired	Campylobacterota	8700	P	167	0	167	0.00001
ERR3957848_1_kneaddata_paired	Firmicutes_C	17613	P	123	0	123	0.00001
ERR3957848_1_kneaddata_paired	Deferribacterota	10822	P	74	0	74	0.00000
ERR3957848_1_kneaddata_paired	Thermotogota	33086	P	25	0	25	0.00000
ERR3957848_1_kneaddata_paired	Elusimicrobiota	11888	P	11	0	11	0.00000
ERR3957849_1_kneaddata_paired	Firmicutes_A	14608	P	13773806	46967	13820773	0.56291
ERR3957849_1_kneaddata_paired	Bacteroidota	4587	P	7158590	11482	7170072	0.29203
ERR3957849_1_kneaddata_paired	Verrucomicrobiota	33333	P	1867693	50106	1917799	0.07811
ERR3957849_1_kneaddata_paired	Firmicutes	12188	P	1170658	68258	1238916	0.05046
ERR3957849_1_kneaddata_paired	Actinobacteriota	615	P	280004	46	280050	0.01141
ERR3957849_1_kneaddata_paired	Proteobacteria	22518	P	104781	1054	105835	0.00431
ERR3957849_1_kneaddata_paired	Cyanobacteria	9876	P	8642	17	8659	0.00035
ERR3957849_1_kneaddata_paired	Desulfobacterota_A	11509	P	5505	389	5894	0.00024
ERR3957849_1_kneaddata_paired	Firmicutes_B	17289	P	2546	43	2589	0.00011
ERR3957849_1_kneaddata_paired	Spirochaetota	32587	P	1322	0	1322	0.00005
ERR3957849_1_kneaddata_paired	Firmicutes_I	18140	P	184	0	184	0.00001
ERR3957849_1_kneaddata_paired	Firmicutes_C	17613	P	179	0	179	0.00001
ERR3957849_1_kneaddata_paired	Campylobacterota	8700	P	164	0	164	0.00001
ERR3957849_1_kneaddata_paired	Elusimicrobiota	11888	P	33	0	33	0.00000
ERR3957849_1_kneaddata_paired	Thermotogota	33086	P	24	0	24	0.00000
ERR3957849_1_kneaddata_paired	Deferribacterota	10822	P	20	0	20	0.00000
ERR3957850_1_kneaddata_paired	Firmicutes_A	14608	P	16119749	85031	16204780	0.88173
ERR3957850_1_kneaddata_paired	Bacteroidota	4587	P	1762537	41304	1803841	0.09815
ERR3957850_1_kneaddata_paired	Firmicutes	12188	P	244401	6672	251073	0.01366
ERR3957850_1_kneaddata_paired	Verrucomicrobiota	33333	P	89712	6498	96210	0.00523
ERR3957850_1_kneaddata_paired	Actinobacteriota	615	P	12800	12	12812	0.00070
ERR3957850_1_kneaddata_paired	Proteobacteria	22518	P	3012	66	3078	0.00017
ERR3957850_1_kneaddata_paired	Cyanobacteria	9876	P	2856	35	2891	0.00016
ERR3957850_1_kneaddata_paired	Desulfobacterota_A	11509	P	1222	207	1429	0.00008
ERR3957850_1_kneaddata_paired	Spirochaetota	32587	P	887	1	888	0.00005
ERR3957850_1_kneaddata_paired	Firmicutes_B	17289	P	884	41	925	0.00005
ERR3957850_1_kneaddata_paired	Firmicutes_I	18140	P	123	0	123	0.00001
ERR3957850_1_kneaddata_paired	Campylobacterota	8700	P	115	0	115	0.00001
ERR3957850_1_kneaddata_paired	Deferribacterota	10822	P	75	0	75	0.00000
ERR3957850_1_kneaddata_paired	Firmicutes_C	17613	P	66	0	66	0.00000
ERR3957850_1_kneaddata_paired	Thermotogota	33086	P	45	0	45	0.00000
ERR3957850_1_kneaddata_paired	Elusimicrobiota	11888	P	8	0	8	0.00000
ERR3957851_1_kneaddata_paired	Firmicutes_A	14608	P	10783889	48096	10831985	0.56180
ERR3957851_1_kneaddata_paired	Bacteroidota	4587	P	5878023	15768	5893791	0.30568
ERR3957851_1_kneaddata_paired	Verrucomicrobiota	33333	P	1646088	52796	1698884	0.08811
ERR3957851_1_kneaddata_paired	Actinobacteriota	615	P	397341	540	397881	0.02064
ERR3957851_1_kneaddata_paired	Firmicutes	12188	P	365152	18261	383413	0.01989
ERR3957851_1_kneaddata_paired	Proteobacteria	22518	P	62259	745	63004	0.00327
ERR3957851_1_kneaddata_paired	Cyanobacteria	9876	P	5663	23	5686	0.00029
ERR3957851_1_kneaddata_paired	Firmicutes_B	17289	P	2189	45	2234	0.00012
ERR3957851_1_kneaddata_paired	Desulfobacterota_A	11509	P	2071	159	2230	0.00012
ERR3957851_1_kneaddata_paired	Spirochaetota	32587	P	1247	0	1247	0.00006
ERR3957851_1_kneaddata_paired	Campylobacterota	8700	P	255	0	255	0.00001
ERR3957851_1_kneaddata_paired	Firmicutes_I	18140	P	184	0	184	0.00001
ERR3957851_1_kneaddata_paired	Firmicutes_C	17613	P	114	0	114	0.00001
ERR3957851_1_kneaddata_paired	Deferribacterota	10822	P	29	0	29	0.00000
ERR3957851_1_kneaddata_paired	Elusimicrobiota	11888	P	13	0	13	0.00000
ERR3957851_1_kneaddata_paired	Thermotogota	33086	P	10	0	10	0.00000
ERR3957852_1_kneaddata_paired	Firmicutes_A	14608	P	16526662	75122	16601784	0.90438
ERR3957852_1_kneaddata_paired	Bacteroidota	4587	P	1168926	27480	1196406	0.06517
ERR3957852_1_kneaddata_paired	Firmicutes	12188	P	502932	9713	512645	0.02793
ERR3957852_1_kneaddata_paired	Verrucomicrobiota	33333	P	23738	1670	25408	0.00138
ERR3957852_1_kneaddata_paired	Actinobacteriota	615	P	11433	9	11442	0.00062
ERR3957852_1_kneaddata_paired	Proteobacteria	22518	P	3188	75	3263	0.00018
ERR3957852_1_kneaddata_paired	Cyanobacteria	9876	P	2571	29	2600	0.00014
ERR3957852_1_kneaddata_paired	Firmicutes_B	17289	P	1159	52	1211	0.00007
ERR3957852_1_kneaddata_paired	Desulfobacterota_A	11509	P	1029	168	1197	0.00007
ERR3957852_1_kneaddata_paired	Spirochaetota	32587	P	696	1	697	0.00004
ERR3957852_1_kneaddata_paired	Firmicutes_I	18140	P	117	0	117	0.00001
ERR3957852_1_kneaddata_paired	Campylobacterota	8700	P	109	0	109	0.00001
ERR3957852_1_kneaddata_paired	Firmicutes_C	17613	P	97	0	97	0.00001
ERR3957852_1_kneaddata_paired	Deferribacterota	10822	P	74	0	74	0.00000
ERR3957852_1_kneaddata_paired	Elusimicrobiota	11888	P	5	0	5	0.00000
ERR3957852_1_kneaddata_paired	Thermotogota	33086	P	4	0	4	0.00000
ERR3957853_1_kneaddata_paired	Firmicutes_A	14608	P	14254731	42967	14297698	0.72454
ERR3957853_1_kneaddata_paired	Bacteroidota	4587	P	3189784	5929	3195713	0.16194
ERR3957853_1_kneaddata_paired	Verrucomicrobiota	33333	P	1317818	35254	1353072	0.06857
ERR3957853_1_kneaddata_paired	Firmicutes	12188	P	586648	32850	619498	0.03139
ERR3957853_1_kneaddata_paired	Actinobacteriota	615	P	235611	102	235713	0.01194
ERR3957853_1_kneaddata_paired	Proteobacteria	22518	P	20071	193	20264	0.00103
ERR3957853_1_kneaddata_paired	Cyanobacteria	9876	P	4419	15	4434	0.00022
ERR3957853_1_kneaddata_paired	Desulfobacterota_A	11509	P	3000	209	3209	0.00016
ERR3957853_1_kneaddata_paired	Firmicutes_B	17289	P	2034	35	2069	0.00010
ERR3957853_1_kneaddata_paired	Spirochaetota	32587	P	926	0	926	0.00005
ERR3957853_1_kneaddata_paired	Campylobacterota	8700	P	368	0	368	0.00002
ERR3957853_1_kneaddata_paired	Firmicutes_I	18140	P	176	0	176	0.00001
ERR3957853_1_kneaddata_paired	Firmicutes_C	17613	P	148	0	148	0.00001
ERR3957853_1_kneaddata_paired	Deferribacterota	10822	P	35	0	35	0.00000
ERR3957853_1_kneaddata_paired	Elusimicrobiota	11888	P	27	0	27	0.00000
ERR3957853_1_kneaddata_paired	Thermotogota	33086	P	11	0	11	0.00000
ERR3957854_1_kneaddata_paired	Firmicutes_A	14608	P	14259719	61966	14321685	0.85133
ERR3957854_1_kneaddata_paired	Bacteroidota	4587	P	1700173	25113	1725286	0.10256
ERR3957854_1_kneaddata_paired	Firmicutes	12188	P	557155	9789	566944	0.03370
ERR3957854_1_kneaddata_paired	Verrucomicrobiota	33333	P	117856	7266	125122	0.00744
ERR3957854_1_kneaddata_paired	Actinobacteriota	615	P	35635	11	35646	0.00212
ERR3957854_1_kneaddata_paired	Firmicutes_B	17289	P	26839	1062	27901	0.00166
ERR3957854_1_kneaddata_paired	Proteobacteria	22518	P	11159	247	11406	0.00068
ERR3957854_1_kneaddata_paired	Cyanobacteria	9876	P	4673	126	4799	0.00029
ERR3957854_1_kneaddata_paired	Desulfobacterota_A	11509	P	1303	178	1481	0.00009
ERR3957854_1_kneaddata_paired	Campylobacterota	8700	P	984	0	984	0.00006
ERR3957854_1_kneaddata_paired	Spirochaetota	32587	P	941	1	942	0.00006
ERR3957854_1_kneaddata_paired	Firmicutes_I	18140	P	309	0	309	0.00002
ERR3957854_1_kneaddata_paired	Deferribacterota	10822	P	176	0	176	0.00001
ERR3957854_1_kneaddata_paired	Firmicutes_C	17613	P	58	0	58	0.00000
ERR3957854_1_kneaddata_paired	Thermotogota	33086	P	16	0	16	0.00000
ERR3957854_1_kneaddata_paired	Elusimicrobiota	11888	P	11	0	11	0.00000
ERR3957855_1_kneaddata_paired	Firmicutes_A	14608	P	9531438	28793	9560231	0.51439
ERR3957855_1_kneaddata_paired	Bacteroidota	4587	P	6079878	10170	6090048	0.32768
ERR3957855_1_kneaddata_paired	Verrucomicrobiota	33333	P	1695107	43466	1738573	0.09354
ERR3957855_1_kneaddata_paired	Firmicutes	12188	P	510183	23106	533289	0.02869
ERR3957855_1_kneaddata_paired	Firmicutes_B	17289	P	357471	5913	363384	0.01955
ERR3957855_1_kneaddata_paired	Actinobacteriota	615	P	258446	277	258723	0.01392
ERR3957855_1_kneaddata_paired	Proteobacteria	22518	P	31209	296	31505	0.00170
ERR3957855_1_kneaddata_paired	Cyanobacteria	9876	P	5115	14	5129	0.00028
ERR3957855_1_kneaddata_paired	Desulfobacterota_A	11509	P	2898	191	3089	0.00017
ERR3957855_1_kneaddata_paired	Spirochaetota	32587	P	938	0	938	0.00005
ERR3957855_1_kneaddata_paired	Firmicutes_I	18140	P	177	0	177	0.00001
ERR3957855_1_kneaddata_paired	Campylobacterota	8700	P	169	0	169	0.00001
ERR3957855_1_kneaddata_paired	Firmicutes_C	17613	P	118	0	118	0.00001
ERR3957855_1_kneaddata_paired	Thermotogota	33086	P	26	0	26	0.00000
ERR3957855_1_kneaddata_paired	Deferribacterota	10822	P	20	0	20	0.00000
ERR3957855_1_kneaddata_paired	Elusimicrobiota	11888	P	9	0	9	0.00000
ERR3957856_1_kneaddata_paired	Firmicutes_A	14608	P	18029206	87940	18117146	0.79268
ERR3957856_1_kneaddata_paired	Bacteroidota	4587	P	4241437	49842	4291279	0.18776
ERR3957856_1_kneaddata_paired	Firmicutes	12188	P	272481	10889	283370	0.01240
ERR3957856_1_kneaddata_paired	Verrucomicrobiota	33333	P	65054	4149	69203	0.00303
ERR3957856_1_kneaddata_paired	Actinobacteriota	615	P	38991	15	39006	0.00171
ERR3957856_1_kneaddata_paired	Firmicutes_B	17289	P	36454	1494	37948	0.00166
ERR3957856_1_kneaddata_paired	Proteobacteria	22518	P	8885	195	9080	0.00040
ERR3957856_1_kneaddata_paired	Cyanobacteria	9876	P	4319	63	4382	0.00019
ERR3957856_1_kneaddata_paired	Desulfobacterota_A	11509	P	1689	243	1932	0.00008
ERR3957856_1_kneaddata_paired	Spirochaetota	32587	P	1115	1	1116	0.00005
ERR3957856_1_kneaddata_paired	Campylobacterota	8700	P	399	0	399	0.00002
ERR3957856_1_kneaddata_paired	Firmicutes_C	17613	P	226	0	226	0.00001
ERR3957856_1_kneaddata_paired	Firmicutes_I	18140	P	213	0	213	0.00001
ERR3957856_1_kneaddata_paired	Deferribacterota	10822	P	169	0	169	0.00001
ERR3957856_1_kneaddata_paired	Elusimicrobiota	11888	P	21	0	21	0.00000
ERR3957856_1_kneaddata_paired	Thermotogota	33086	P	9	0	9	0.00000
ERR3957857_1_kneaddata_paired	Firmicutes_A	14608	P	11489226	39797	11529023	0.61142
ERR3957857_1_kneaddata_paired	Bacteroidota	4587	P	4976670	10102	4986772	0.26446
ERR3957857_1_kneaddata_paired	Verrucomicrobiota	33333	P	1550878	49641	1600519	0.08488
ERR3957857_1_kneaddata_paired	Firmicutes	12188	P	407054	27322	434376	0.02304
ERR3957857_1_kneaddata_paired	Actinobacteriota	615	P	231153	20	231173	0.01226
ERR3957857_1_kneaddata_paired	Proteobacteria	22518	P	59705	716	60421	0.00320
ERR3957857_1_kneaddata_paired	Cyanobacteria	9876	P	5555	24	5579	0.00030
ERR3957857_1_kneaddata_paired	Desulfobacterota_A	11509	P	3802	321	4123	0.00022
ERR3957857_1_kneaddata_paired	Firmicutes_B	17289	P	2522	52	2574	0.00014
ERR3957857_1_kneaddata_paired	Spirochaetota	32587	P	1086	0	1086	0.00006
ERR3957857_1_kneaddata_paired	Campylobacterota	8700	P	147	0	147	0.00001
ERR3957857_1_kneaddata_paired	Firmicutes_I	18140	P	136	0	136	0.00001
ERR3957857_1_kneaddata_paired	Firmicutes_C	17613	P	96	0	96	0.00001
ERR3957857_1_kneaddata_paired	Thermotogota	33086	P	26	0	26	0.00000
ERR3957857_1_kneaddata_paired	Deferribacterota	10822	P	22	0	22	0.00000
ERR3957857_1_kneaddata_paired	Elusimicrobiota	11888	P	15	0	15	0.00000
ERR3957858_1_kneaddata_paired	Firmicutes_A	14608	P	12844604	59775	12904379	0.71216
ERR3957858_1_kneaddata_paired	Bacteroidota	4587	P	4088125	49976	4138101	0.22837
ERR3957858_1_kneaddata_paired	Firmicutes	12188	P	732534	14428	746962	0.04122
ERR3957858_1_kneaddata_paired	Verrucomicrobiota	33333	P	178809	9042	187851	0.01037
ERR3957858_1_kneaddata_paired	Actinobacteriota	615	P	60237	15	60252	0.00333
ERR3957858_1_kneaddata_paired	Firmicutes_B	17289	P	52423	1701	54124	0.00299
ERR3957858_1_kneaddata_paired	Proteobacteria	22518	P	19459	356	19815	0.00109
ERR3957858_1_kneaddata_paired	Cyanobacteria	9876	P	5292	57	5349	0.00030
ERR3957858_1_kneaddata_paired	Spirochaetota	32587	P	1278	1	1279	0.00007
ERR3957858_1_kneaddata_paired	Desulfobacterota_A	11509	P	848	80	928	0.00005
ERR3957858_1_kneaddata_paired	Campylobacterota	8700	P	587	0	587	0.00003
ERR3957858_1_kneaddata_paired	Firmicutes_I	18140	P	225	0	225	0.00001
ERR3957858_1_kneaddata_paired	Deferribacterota	10822	P	153	0	153	0.00001
ERR3957858_1_kneaddata_paired	Firmicutes_C	17613	P	60	0	60	0.00000
ERR3957858_1_kneaddata_paired	Thermotogota	33086	P	7	0	7	0.00000
ERR3957858_1_kneaddata_paired	Elusimicrobiota	11888	P	6	0	6	0.00000
ERR3957859_1_kneaddata_paired	Firmicutes_A	14608	P	13464418	49317	13513735	0.61057
ERR3957859_1_kneaddata_paired	Bacteroidota	4587	P	5671300	11950	5683250	0.25678
ERR3957859_1_kneaddata_paired	Verrucomicrobiota	33333	P	1473449	47675	1521124	0.06873
ERR3957859_1_kneaddata_paired	Firmicutes	12188	P	736979	34925	771904	0.03488
ERR3957859_1_kneaddata_paired	Firmicutes_B	17289	P	308179	6426	314605	0.01421
ERR3957859_1_kneaddata_paired	Actinobacteriota	615	P	270382	400	270782	0.01223
ERR3957859_1_kneaddata_paired	Proteobacteria	22518	P	43589	522	44111	0.00199
ERR3957859_1_kneaddata_paired	Cyanobacteria	9876	P	6389	20	6409	0.00029
ERR3957859_1_kneaddata_paired	Desulfobacterota_A	11509	P	5015	430	5445	0.00025
ERR3957859_1_kneaddata_paired	Spirochaetota	32587	P	1140	0	1140	0.00005
ERR3957859_1_kneaddata_paired	Firmicutes_I	18140	P	176	0	176	0.00001
ERR3957859_1_kneaddata_paired	Campylobacterota	8700	P	117	0	117	0.00001
ERR3957859_1_kneaddata_paired	Firmicutes_C	17613	P	109	0	109	0.00000
ERR3957859_1_kneaddata_paired	Elusimicrobiota	11888	P	25	0	25	0.00000
ERR3957859_1_kneaddata_paired	Deferribacterota	10822	P	24	0	24	0.00000
ERR3957859_1_kneaddata_paired	Thermotogota	33086	P	11	0	11	0.00000
ERR3957860_1_kneaddata_paired	Firmicutes_A	14608	P	25439285	130403	25569688	0.75523
ERR3957860_1_kneaddata_paired	Bacteroidota	4587	P	6447866	84341	6532207	0.19294
ERR3957860_1_kneaddata_paired	Firmicutes	12188	P	1198164	11692	1209856	0.03573
ERR3957860_1_kneaddata_paired	Verrucomicrobiota	33333	P	334398	16592	350990	0.01037
ERR3957860_1_kneaddata_paired	Proteobacteria	22518	P	89436	1719	91155	0.00269
ERR3957860_1_kneaddata_paired	Actinobacteriota	615	P	78279	27	78306	0.00231
ERR3957860_1_kneaddata_paired	Cyanobacteria	9876	P	9705	183	9888	0.00029
ERR3957860_1_kneaddata_paired	Firmicutes_B	17289	P	5034	160	5194	0.00015
ERR3957860_1_kneaddata_paired	Desulfobacterota_A	11509	P	3225	398	3623	0.00011
ERR3957860_1_kneaddata_paired	Campylobacterota	8700	P	2287	1	2288	0.00007
ERR3957860_1_kneaddata_paired	Spirochaetota	32587	P	2185	2	2187	0.00006
ERR3957860_1_kneaddata_paired	Firmicutes_I	18140	P	773	0	773	0.00002
ERR3957860_1_kneaddata_paired	Deferribacterota	10822	P	355	0	355	0.00001
ERR3957860_1_kneaddata_paired	Firmicutes_C	17613	P	169	0	169	0.00001
ERR3957860_1_kneaddata_paired	Thermotogota	33086	P	22	0	22	0.00000
ERR3957860_1_kneaddata_paired	Elusimicrobiota	11888	P	14	0	14	0.00000
ERR3957861_1_kneaddata_paired	Firmicutes_A	14608	P	16705887	65113	16771000	0.70157
ERR3957861_1_kneaddata_paired	Bacteroidota	4587	P	3909444	6931	3916375	0.16383
ERR3957861_1_kneaddata_paired	Verrucomicrobiota	33333	P	1703524	62877	1766401	0.07389
ERR3957861_1_kneaddata_paired	Firmicutes	12188	P	1029929	50550	1080479	0.04520
ERR3957861_1_kneaddata_paired	Actinobacteriota	615	P	274998	281	275279	0.01152
ERR3957861_1_kneaddata_paired	Proteobacteria	22518	P	78037	1081	79118	0.00331
ERR3957861_1_kneaddata_paired	Desulfobacterota_A	11509	P	5906	578	6484	0.00027
ERR3957861_1_kneaddata_paired	Cyanobacteria	9876	P	5651	31	5682	0.00024
ERR3957861_1_kneaddata_paired	Firmicutes_B	17289	P	2205	52	2257	0.00009
ERR3957861_1_kneaddata_paired	Spirochaetota	32587	P	1342	1	1343	0.00006
ERR3957861_1_kneaddata_paired	Firmicutes_I	18140	P	171	0	171	0.00001
ERR3957861_1_kneaddata_paired	Firmicutes_C	17613	P	140	0	140	0.00001
ERR3957861_1_kneaddata_paired	Campylobacterota	8700	P	114	0	114	0.00000
ERR3957861_1_kneaddata_paired	Elusimicrobiota	11888	P	47	0	47	0.00000
ERR3957861_1_kneaddata_paired	Deferribacterota	10822	P	24	0	24	0.00000
ERR3957861_1_kneaddata_paired	Thermotogota	33086	P	24	0	24	0.00000
ERR3957862_1_kneaddata_paired	Firmicutes_A	14608	P	14813460	66825	14880285	0.94399
ERR3957862_1_kneaddata_paired	Bacteroidota	4587	P	447854	5639	453493	0.02877
ERR3957862_1_kneaddata_paired	Firmicutes	12188	P	360980	5623	366603	0.02326
ERR3957862_1_kneaddata_paired	Verrucomicrobiota	33333	P	29560	1447	31007	0.00197
ERR3957862_1_kneaddata_paired	Actinobacteriota	615	P	19536	7	19543	0.00124
ERR3957862_1_kneaddata_paired	Proteobacteria	22518	P	4747	100	4847	0.00031
ERR3957862_1_kneaddata_paired	Cyanobacteria	9876	P	3921	96	4017	0.00025
ERR3957862_1_kneaddata_paired	Firmicutes_B	17289	P	1086	34	1120	0.00007
ERR3957862_1_kneaddata_paired	Desulfobacterota_A	11509	P	975	101	1076	0.00007
ERR3957862_1_kneaddata_paired	Spirochaetota	32587	P	773	0	773	0.00005
ERR3957862_1_kneaddata_paired	Campylobacterota	8700	P	205	0	205	0.00001
ERR3957862_1_kneaddata_paired	Firmicutes_I	18140	P	105	0	105	0.00001
ERR3957862_1_kneaddata_paired	Firmicutes_C	17613	P	68	0	68	0.00000
ERR3957862_1_kneaddata_paired	Deferribacterota	10822	P	63	0	63	0.00000
ERR3957862_1_kneaddata_paired	Thermotogota	33086	P	14	0	14	0.00000
ERR3957862_1_kneaddata_paired	Elusimicrobiota	11888	P	8	0	8	0.00000
ERR3957863_1_kneaddata_paired	Firmicutes_A	14608	P	20465527	77484	20543011	0.70728
ERR3957863_1_kneaddata_paired	Bacteroidota	4587	P	4516562	9497	4526059	0.15583
ERR3957863_1_kneaddata_paired	Verrucomicrobiota	33333	P	2407204	75775	2482979	0.08549
ERR3957863_1_kneaddata_paired	Firmicutes	12188	P	983042	55240	1038282	0.03575
ERR3957863_1_kneaddata_paired	Actinobacteriota	615	P	371709	215	371924	0.01281
ERR3957863_1_kneaddata_paired	Proteobacteria	22518	P	60428	701	61129	0.00210
ERR3957863_1_kneaddata_paired	Cyanobacteria	9876	P	8704	32	8736	0.00030
ERR3957863_1_kneaddata_paired	Desulfobacterota_A	11509	P	6545	545	7090	0.00024
ERR3957863_1_kneaddata_paired	Firmicutes_B	17289	P	3351	67	3418	0.00012
ERR3957863_1_kneaddata_paired	Spirochaetota	32587	P	1380	0	1380	0.00005
ERR3957863_1_kneaddata_paired	Campylobacterota	8700	P	467	0	467	0.00002
ERR3957863_1_kneaddata_paired	Firmicutes_I	18140	P	320	0	320	0.00001
ERR3957863_1_kneaddata_paired	Firmicutes_C	17613	P	224	0	224	0.00001
ERR3957863_1_kneaddata_paired	Deferribacterota	10822	P	73	0	73	0.00000
ERR3957863_1_kneaddata_paired	Elusimicrobiota	11888	P	46	0	46	0.00000
ERR3957863_1_kneaddata_paired	Thermotogota	33086	P	20	0	20	0.00000
ERR3957864_1_kneaddata_paired	Firmicutes_A	14608	P	13762642	72342	13834984	0.83284
ERR3957864_1_kneaddata_paired	Bacteroidota	4587	P	2360034	20448	2380482	0.14330
ERR3957864_1_kneaddata_paired	Firmicutes	12188	P	170682	4117	174799	0.01052
ERR3957864_1_kneaddata_paired	Verrucomicrobiota	33333	P	151543	8453	159996	0.00963
ERR3957864_1_kneaddata_paired	Actinobacteriota	615	P	47962	11	47973	0.00289
ERR3957864_1_kneaddata_paired	Proteobacteria	22518	P	5142	94	5236	0.00032
ERR3957864_1_kneaddata_paired	Cyanobacteria	9876	P	3774	24	3798	0.00023
ERR3957864_1_kneaddata_paired	Desulfobacterota_A	11509	P	1467	202	1669	0.00010
ERR3957864_1_kneaddata_paired	Firmicutes_B	17289	P	1138	41	1179	0.00007
ERR3957864_1_kneaddata_paired	Spirochaetota	32587	P	1084	1	1085	0.00007
ERR3957864_1_kneaddata_paired	Campylobacterota	8700	P	284	0	284	0.00002
ERR3957864_1_kneaddata_paired	Firmicutes_I	18140	P	142	0	142	0.00001
ERR3957864_1_kneaddata_paired	Thermotogota	33086	P	120	0	120	0.00001
ERR3957864_1_kneaddata_paired	Deferribacterota	10822	P	78	0	78	0.00000
ERR3957864_1_kneaddata_paired	Firmicutes_C	17613	P	66	0	66	0.00000
ERR3957864_1_kneaddata_paired	Elusimicrobiota	11888	P	13	0	13	0.00000
ERR3957865_1_kneaddata_paired	Bacteroidota	4587	P	14445009	20155	14465164	0.43193
ERR3957865_1_kneaddata_paired	Firmicutes_A	14608	P	13600260	45941	13646201	0.40747
ERR3957865_1_kneaddata_paired	Verrucomicrobiota	33333	P	3935145	99889	4035034	0.12049
ERR3957865_1_kneaddata_paired	Actinobacteriota	615	P	623843	758	624601	0.01865
ERR3957865_1_kneaddata_paired	Firmicutes	12188	P	578122	28195	606317	0.01810
ERR3957865_1_kneaddata_paired	Proteobacteria	22518	P	72243	683	72926	0.00218
ERR3957865_1_kneaddata_paired	Firmicutes_B	17289	P	22153	360	22513	0.00067
ERR3957865_1_kneaddata_paired	Cyanobacteria	9876	P	9768	20	9788	0.00029
ERR3957865_1_kneaddata_paired	Desulfobacterota_A	11509	P	4479	285	4764	0.00014
ERR3957865_1_kneaddata_paired	Spirochaetota	32587	P	1568	0	1568	0.00005
ERR3957865_1_kneaddata_paired	Firmicutes_I	18140	P	278	0	278	0.00001
ERR3957865_1_kneaddata_paired	Campylobacterota	8700	P	230	0	230	0.00001
ERR3957865_1_kneaddata_paired	Firmicutes_C	17613	P	218	0	218	0.00001
ERR3957865_1_kneaddata_paired	Deferribacterota	10822	P	51	0	51	0.00000
ERR3957865_1_kneaddata_paired	Elusimicrobiota	11888	P	32	0	32	0.00000
ERR3957865_1_kneaddata_paired	Thermotogota	33086	P	27	0	27	0.00000
ERR3957866_1_kneaddata_paired	Firmicutes_A	14608	P	12556881	51379	12608260	0.68760
ERR3957866_1_kneaddata_paired	Bacteroidota	4587	P	4848088	35692	4883780	0.26634
ERR3957866_1_kneaddata_paired	Firmicutes	12188	P	548890	7318	556208	0.03033
ERR3957866_1_kneaddata_paired	Verrucomicrobiota	33333	P	211822	12174	223996	0.01222
ERR3957866_1_kneaddata_paired	Actinobacteriota	615	P	37939	23	37962	0.00207
ERR3957866_1_kneaddata_paired	Proteobacteria	22518	P	17370	371	17741	0.00097
ERR3957866_1_kneaddata_paired	Cyanobacteria	9876	P	3667	40	3707	0.00020
ERR3957866_1_kneaddata_paired	Desulfobacterota_A	11509	P	1181	161	1342	0.00007
ERR3957866_1_kneaddata_paired	Firmicutes_B	17289	P	1180	43	1223	0.00007
ERR3957866_1_kneaddata_paired	Spirochaetota	32587	P	898	1	899	0.00005
ERR3957866_1_kneaddata_paired	Campylobacterota	8700	P	849	0	849	0.00005
ERR3957866_1_kneaddata_paired	Firmicutes_I	18140	P	277	0	277	0.00002
ERR3957866_1_kneaddata_paired	Deferribacterota	10822	P	148	0	148	0.00001
ERR3957866_1_kneaddata_paired	Firmicutes_C	17613	P	63	0	63	0.00000
ERR3957866_1_kneaddata_paired	Thermotogota	33086	P	41	0	41	0.00000
ERR3957866_1_kneaddata_paired	Elusimicrobiota	11888	P	13	0	13	0.00000
ERR3957867_1_kneaddata_paired	Firmicutes_A	14608	P	14477603	48095	14525698	0.51723
ERR3957867_1_kneaddata_paired	Bacteroidota	4587	P	7905401	12589	7917990	0.28194
ERR3957867_1_kneaddata_paired	Verrucomicrobiota	33333	P	3575555	75842	3651397	0.13002
ERR3957867_1_kneaddata_paired	Firmicutes	12188	P	1109392	31650	1141042	0.04063
ERR3957867_1_kneaddata_paired	Actinobacteriota	615	P	750143	669	750812	0.02673
ERR3957867_1_kneaddata_paired	Proteobacteria	22518	P	81033	645	81678	0.00291
ERR3957867_1_kneaddata_paired	Cyanobacteria	9876	P	5815	14	5829	0.00021
ERR3957867_1_kneaddata_paired	Desulfobacterota_A	11509	P	3474	175	3649	0.00013
ERR3957867_1_kneaddata_paired	Firmicutes_B	17289	P	3306	44	3350	0.00012
ERR3957867_1_kneaddata_paired	Spirochaetota	32587	P	1377	0	1377	0.00005
ERR3957867_1_kneaddata_paired	Campylobacterota	8700	P	390	0	390	0.00001
ERR3957867_1_kneaddata_paired	Firmicutes_I	18140	P	234	0	234	0.00001
ERR3957867_1_kneaddata_paired	Firmicutes_C	17613	P	204	0	204	0.00001
ERR3957867_1_kneaddata_paired	Deferribacterota	10822	P	73	0	73	0.00000
ERR3957867_1_kneaddata_paired	Elusimicrobiota	11888	P	41	0	41	0.00000
ERR3957867_1_kneaddata_paired	Thermotogota	33086	P	8	0	8	0.00000
ERR3957868_1_kneaddata_paired	Firmicutes_A	14608	P	14923115	85451	15008566	0.84363
ERR3957868_1_kneaddata_paired	Bacteroidota	4587	P	2305535	42061	2347596	0.13196
ERR3957868_1_kneaddata_paired	Firmicutes	12188	P	375755	6779	382534	0.02150
ERR3957868_1_kneaddata_paired	Actinobacteriota	615	P	21466	15	21481	0.00121
ERR3957868_1_kneaddata_paired	Verrucomicrobiota	33333	P	13153	833	13986	0.00079
ERR3957868_1_kneaddata_paired	Proteobacteria	22518	P	9443	235	9678	0.00054
ERR3957868_1_kneaddata_paired	Cyanobacteria	9876	P	2733	34	2767	0.00016
ERR3957868_1_kneaddata_paired	Desulfobacterota_A	11509	P	1339	199	1538	0.00009
ERR3957868_1_kneaddata_paired	Firmicutes_B	17289	P	937	38	975	0.00005
ERR3957868_1_kneaddata_paired	Spirochaetota	32587	P	770	1	771	0.00004
ERR3957868_1_kneaddata_paired	Campylobacterota	8700	P	259	0	259	0.00001
ERR3957868_1_kneaddata_paired	Firmicutes_I	18140	P	168	0	168	0.00001
ERR3957868_1_kneaddata_paired	Deferribacterota	10822	P	112	0	112	0.00001
ERR3957868_1_kneaddata_paired	Firmicutes_C	17613	P	76	0	76	0.00000
ERR3957868_1_kneaddata_paired	Thermotogota	33086	P	20	0	20	0.00000
ERR3957868_1_kneaddata_paired	Elusimicrobiota	11888	P	12	0	12	0.00000
ERR3957869_1_kneaddata_paired	Bacteroidota	4587	P	10003722	25609	10029331	0.47837
ERR3957869_1_kneaddata_paired	Firmicutes_A	14608	P	8084549	44956	8129505	0.38775
ERR3957869_1_kneaddata_paired	Verrucomicrobiota	33333	P	2142680	92182	2234862	0.10660
ERR3957869_1_kneaddata_paired	Actinobacteriota	615	P	292534	574	293108	0.01398
ERR3957869_1_kneaddata_paired	Firmicutes	12188	P	193126	7152	200278	0.00955
ERR3957869_1_kneaddata_paired	Proteobacteria	22518	P	60880	981	61861	0.00295
ERR3957869_1_kneaddata_paired	Cyanobacteria	9876	P	9577	37	9614	0.00046
ERR3957869_1_kneaddata_paired	Firmicutes_B	17289	P	2720	75	2795	0.00013
ERR3957869_1_kneaddata_paired	Desulfobacterota_A	11509	P	2122	227	2349	0.00011
ERR3957869_1_kneaddata_paired	Spirochaetota	32587	P	1590	1	1591	0.00008
ERR3957869_1_kneaddata_paired	Firmicutes_I	18140	P	164	0	164	0.00001
ERR3957869_1_kneaddata_paired	Firmicutes_C	17613	P	122	0	122	0.00001
ERR3957869_1_kneaddata_paired	Campylobacterota	8700	P	67	0	67	0.00000
ERR3957869_1_kneaddata_paired	Deferribacterota	10822	P	20	0	20	0.00000
ERR3957869_1_kneaddata_paired	Elusimicrobiota	11888	P	19	0	19	0.00000
ERR3957869_1_kneaddata_paired	Thermotogota	33086	P	16	0	16	0.00000
ERR3957870_1_kneaddata_paired	Firmicutes_A	14608	P	16619865	103405	16723270	0.72895
ERR3957870_1_kneaddata_paired	Bacteroidota	4587	P	5614048	69835	5683883	0.24776
ERR3957870_1_kneaddata_paired	Verrucomicrobiota	33333	P	250062	16122	266184	0.01160
ERR3957870_1_kneaddata_paired	Firmicutes	12188	P	219444	6358	225802	0.00984
ERR3957870_1_kneaddata_paired	Actinobacteriota	615	P	19204	14	19218	0.00084
ERR3957870_1_kneaddata_paired	Proteobacteria	22518	P	11340	267	11607	0.00051
ERR3957870_1_kneaddata_paired	Desulfobacterota_A	11509	P	3699	646	4345	0.00019
ERR3957870_1_kneaddata_paired	Cyanobacteria	9876	P	3605	62	3667	0.00016
ERR3957870_1_kneaddata_paired	Firmicutes_B	17289	P	1680	69	1749	0.00008
ERR3957870_1_kneaddata_paired	Spirochaetota	32587	P	1295	2	1297	0.00006
ERR3957870_1_kneaddata_paired	Firmicutes_I	18140	P	185	0	185	0.00001
ERR3957870_1_kneaddata_paired	Campylobacterota	8700	P	141	0	141	0.00001
ERR3957870_1_kneaddata_paired	Firmicutes_C	17613	P	135	0	135	0.00001
ERR3957870_1_kneaddata_paired	Deferribacterota	10822	P	20	0	20	0.00000
ERR3957870_1_kneaddata_paired	Thermotogota	33086	P	18	0	18	0.00000
ERR3957870_1_kneaddata_paired	Elusimicrobiota	11888	P	7	0	7	0.00000
ERR3957871_1_kneaddata_paired	Firmicutes_A	14608	P	9067576	44223	9111799	0.42541
ERR3957871_1_kneaddata_paired	Bacteroidota	4587	P	8248768	87117	8335885	0.38918
ERR3957871_1_kneaddata_paired	Firmicutes	12188	P	2022001	50661	2072662	0.09677
ERR3957871_1_kneaddata_paired	Verrucomicrobiota	33333	P	1738915	75573	1814488	0.08471
ERR3957871_1_kneaddata_paired	Actinobacteriota	615	P	59549	27	59576	0.00278
ERR3957871_1_kneaddata_paired	Proteobacteria	22518	P	14125	222	14347	0.00067
ERR3957871_1_kneaddata_paired	Cyanobacteria	9876	P	6146	60	6206	0.00029
ERR3957871_1_kneaddata_paired	Desulfobacterota_A	11509	P	1140	116	1256	0.00006
ERR3957871_1_kneaddata_paired	Spirochaetota	32587	P	1110	1	1111	0.00005
ERR3957871_1_kneaddata_paired	Firmicutes_B	17289	P	1054	29	1083	0.00005
ERR3957871_1_kneaddata_paired	Firmicutes_I	18140	P	199	0	199	0.00001
ERR3957871_1_kneaddata_paired	Firmicutes_C	17613	P	150	0	150	0.00001
ERR3957871_1_kneaddata_paired	Campylobacterota	8700	P	122	0	122	0.00001
ERR3957871_1_kneaddata_paired	Deferribacterota	10822	P	38	0	38	0.00000
ERR3957871_1_kneaddata_paired	Thermotogota	33086	P	14	0	14	0.00000
ERR3957871_1_kneaddata_paired	Elusimicrobiota	11888	P	7	0	7	0.00000
ERR3957872_1_kneaddata_paired	Firmicutes_A	14608	P	13422094	66932	13489026	0.70779
ERR3957872_1_kneaddata_paired	Bacteroidota	4587	P	4553126	84833	4637959	0.24336
ERR3957872_1_kneaddata_paired	Firmicutes	12188	P	729496	17288	746784	0.03918
ERR3957872_1_kneaddata_paired	Firmicutes_B	17289	P	61863	2402	64265	0.00337
ERR3957872_1_kneaddata_paired	Actinobacteriota	615	P	46014	16	46030	0.00242
ERR3957872_1_kneaddata_paired	Verrucomicrobiota	33333	P	45497	2735	48232	0.00253
ERR3957872_1_kneaddata_paired	Proteobacteria	22518	P	13499	289	13788	0.00072
ERR3957872_1_kneaddata_paired	Cyanobacteria	9876	P	8206	111	8317	0.00044
ERR3957872_1_kneaddata_paired	Spirochaetota	32587	P	1760	2	1762	0.00009
ERR3957872_1_kneaddata_paired	Desulfobacterota_A	11509	P	1064	152	1216	0.00006
ERR3957872_1_kneaddata_paired	Campylobacterota	8700	P	295	0	295	0.00002
ERR3957872_1_kneaddata_paired	Firmicutes_I	18140	P	176	0	176	0.00001
ERR3957872_1_kneaddata_paired	Deferribacterota	10822	P	84	0	84	0.00000
ERR3957872_1_kneaddata_paired	Firmicutes_C	17613	P	51	0	51	0.00000
ERR3957872_1_kneaddata_paired	Elusimicrobiota	11888	P	15	0	15	0.00000
ERR3957872_1_kneaddata_paired	Thermotogota	33086	P	6	0	6	0.00000
ERR3957873_1_kneaddata_paired	Bacteroidota	4587	P	9382237	111015	9493252	0.45492
ERR3957873_1_kneaddata_paired	Firmicutes_A	14608	P	7857629	22280	7879909	0.37761
ERR3957873_1_kneaddata_paired	Firmicutes	12188	P	2810828	115072	2925900	0.14021
ERR3957873_1_kneaddata_paired	Actinobacteriota	615	P	343393	213	343606	0.01647
ERR3957873_1_kneaddata_paired	Firmicutes_B	17289	P	139186	3489	142675	0.00684
ERR3957873_1_kneaddata_paired	Proteobacteria	22518	P	59910	869	60779	0.00291
ERR3957873_1_kneaddata_paired	Verrucomicrobiota	33333	P	10478	415	10893	0.00052
ERR3957873_1_kneaddata_paired	Cyanobacteria	9876	P	6287	117	6404	0.00031
ERR3957873_1_kneaddata_paired	Campylobacterota	8700	P	1704	0	1704	0.00008
ERR3957873_1_kneaddata_paired	Spirochaetota	32587	P	1101	0	1101	0.00005
ERR3957873_1_kneaddata_paired	Desulfobacterota_A	11509	P	845	73	918	0.00004
ERR3957873_1_kneaddata_paired	Firmicutes_I	18140	P	539	0	539	0.00003
ERR3957873_1_kneaddata_paired	Deferribacterota	10822	P	120	0	120	0.00001
ERR3957873_1_kneaddata_paired	Firmicutes_C	17613	P	73	0	73	0.00000
ERR3957873_1_kneaddata_paired	Elusimicrobiota	11888	P	31	0	31	0.00000
ERR3957873_1_kneaddata_paired	Thermotogota	33086	P	7	0	7	0.00000
ERR3957874_1_kneaddata_paired	Firmicutes_A	14608	P	10244019	55531	10299550	0.60089
ERR3957874_1_kneaddata_paired	Bacteroidota	4587	P	5330046	26900	5356946	0.31253
ERR3957874_1_kneaddata_paired	Firmicutes	12188	P	880578	8128	888706	0.05185
ERR3957874_1_kneaddata_paired	Verrucomicrobiota	33333	P	316303	16830	333133	0.01944
ERR3957874_1_kneaddata_paired	Actinobacteriota	615	P	198055	147	198202	0.01156
ERR3957874_1_kneaddata_paired	Proteobacteria	22518	P	52031	1062	53093	0.00310
ERR3957874_1_kneaddata_paired	Cyanobacteria	9876	P	4622	67	4689	0.00027
ERR3957874_1_kneaddata_paired	Firmicutes_B	17289	P	2661	91	2752	0.00016
ERR3957874_1_kneaddata_paired	Campylobacterota	8700	P	1116	0	1116	0.00007
ERR3957874_1_kneaddata_paired	Spirochaetota	32587	P	1104	1	1105	0.00006
ERR3957874_1_kneaddata_paired	Desulfobacterota_A	11509	P	665	73	738	0.00004
ERR3957874_1_kneaddata_paired	Firmicutes_I	18140	P	413	0	413	0.00002
ERR3957874_1_kneaddata_paired	Firmicutes_C	17613	P	65	0	65	0.00000
ERR3957874_1_kneaddata_paired	Deferribacterota	10822	P	48	0	48	0.00000
ERR3957874_1_kneaddata_paired	Elusimicrobiota	11888	P	19	0	19	0.00000
ERR3957874_1_kneaddata_paired	Thermotogota	33086	P	9	0	9	0.00000
ERR3957875_1_kneaddata_paired	Firmicutes_A	14608	P	11624538	51849	11676387	0.54707
ERR3957875_1_kneaddata_paired	Bacteroidota	4587	P	8027012	120689	8147701	0.38174
ERR3957875_1_kneaddata_paired	Firmicutes	12188	P	1029325	49212	1078537	0.05053
ERR3957875_1_kneaddata_paired	Verrucomicrobiota	33333	P	225999	10882	236881	0.01110
ERR3957875_1_kneaddata_paired	Actinobacteriota	615	P	158522	132	158654	0.00743
ERR3957875_1_kneaddata_paired	Proteobacteria	22518	P	31042	560	31602	0.00148
ERR3957875_1_kneaddata_paired	Cyanobacteria	9876	P	6548	98	6646	0.00031
ERR3957875_1_kneaddata_paired	Firmicutes_B	17289	P	2149	66	2215	0.00010
ERR3957875_1_kneaddata_paired	Campylobacterota	8700	P	1704	1	1705	0.00008
ERR3957875_1_kneaddata_paired	Spirochaetota	32587	P	1284	1	1285	0.00006
ERR3957875_1_kneaddata_paired	Desulfobacterota_A	11509	P	1202	139	1341	0.00006
ERR3957875_1_kneaddata_paired	Firmicutes_I	18140	P	508	0	508	0.00002
ERR3957875_1_kneaddata_paired	Firmicutes_C	17613	P	43	0	43	0.00000
ERR3957875_1_kneaddata_paired	Deferribacterota	10822	P	41	0	41	0.00000
ERR3957875_1_kneaddata_paired	Elusimicrobiota	11888	P	24	0	24	0.00000
ERR3957875_1_kneaddata_paired	Thermotogota	33086	P	5	0	5	0.00000
ERR3957876_1_kneaddata_paired	Firmicutes_A	14608	P	16591856	90789	16682645	0.84615
ERR3957876_1_kneaddata_paired	Bacteroidota	4587	P	2515793	29045	2544838	0.12907
ERR3957876_1_kneaddata_paired	Firmicutes	12188	P	282629	5165	287794	0.01460
ERR3957876_1_kneaddata_paired	Verrucomicrobiota	33333	P	112498	7030	119528	0.00606
ERR3957876_1_kneaddata_paired	Actinobacteriota	615	P	59494	20	59514	0.00302
ERR3957876_1_kneaddata_paired	Proteobacteria	22518	P	10179	218	10397	0.00053
ERR3957876_1_kneaddata_paired	Cyanobacteria	9876	P	4729	50	4779	0.00024
ERR3957876_1_kneaddata_paired	Desulfobacterota_A	11509	P	2345	376	2721	0.00014
ERR3957876_1_kneaddata_paired	Firmicutes_B	17289	P	1479	60	1539	0.00008
ERR3957876_1_kneaddata_paired	Spirochaetota	32587	P	1438	1	1439	0.00007
ERR3957876_1_kneaddata_paired	Campylobacterota	8700	P	309	0	309	0.00002
ERR3957876_1_kneaddata_paired	Firmicutes_I	18140	P	171	0	171	0.00001
ERR3957876_1_kneaddata_paired	Deferribacterota	10822	P	124	0	124	0.00001
ERR3957876_1_kneaddata_paired	Firmicutes_C	17613	P	87	0	87	0.00000
ERR3957876_1_kneaddata_paired	Thermotogota	33086	P	81	0	81	0.00000
ERR3957876_1_kneaddata_paired	Elusimicrobiota	11888	P	10	0	10	0.00000
ERR3957877_1_kneaddata_paired	Bacteroidota	4587	P	11032413	132396	11164809	0.48298
ERR3957877_1_kneaddata_paired	Firmicutes_A	14608	P	8895052	22943	8917995	0.38579
ERR3957877_1_kneaddata_paired	Firmicutes	12188	P	2573705	144402	2718107	0.11758
ERR3957877_1_kneaddata_paired	Verrucomicrobiota	33333	P	174630	6190	180820	0.00782
ERR3957877_1_kneaddata_paired	Actinobacteriota	615	P	71559	27	71586	0.00310
ERR3957877_1_kneaddata_paired	Proteobacteria	22518	P	48816	629	49445	0.00214
ERR3957877_1_kneaddata_paired	Firmicutes_B	17289	P	5549	125	5674	0.00025
ERR3957877_1_kneaddata_paired	Cyanobacteria	9876	P	4997	70	5067	0.00022
ERR3957877_1_kneaddata_paired	Spirochaetota	32587	P	1134	0	1134	0.00005
ERR3957877_1_kneaddata_paired	Campylobacterota	8700	P	598	0	598	0.00003
ERR3957877_1_kneaddata_paired	Desulfobacterota_A	11509	P	594	41	635	0.00003
ERR3957877_1_kneaddata_paired	Firmicutes_I	18140	P	241	0	241	0.00001
ERR3957877_1_kneaddata_paired	Deferribacterota	10822	P	79	0	79	0.00000
ERR3957877_1_kneaddata_paired	Firmicutes_C	17613	P	51	0	51	0.00000
ERR3957877_1_kneaddata_paired	Elusimicrobiota	11888	P	16	0	16	0.00000
ERR3957877_1_kneaddata_paired	Thermotogota	33086	P	12	0	12	0.00000
ERR3957878_1_kneaddata_paired	Firmicutes_A	14608	P	15162248	73155	15235403	0.84761
ERR3957878_1_kneaddata_paired	Bacteroidota	4587	P	2468379	56183	2524562	0.14045
ERR3957878_1_kneaddata_paired	Firmicutes	12188	P	135863	4133	139996	0.00779
ERR3957878_1_kneaddata_paired	Actinobacteriota	615	P	44755	28	44783	0.00249
ERR3957878_1_kneaddata_paired	Verrucomicrobiota	33333	P	12308	875	13183	0.00073
ERR3957878_1_kneaddata_paired	Proteobacteria	22518	P	7982	198	8180	0.00046
ERR3957878_1_kneaddata_paired	Cyanobacteria	9876	P	3907	44	3951	0.00022
ERR3957878_1_kneaddata_paired	Desulfobacterota_A	11509	P	1524	250	1774	0.00010
ERR3957878_1_kneaddata_paired	Firmicutes_B	17289	P	1406	65	1471	0.00008
ERR3957878_1_kneaddata_paired	Spirochaetota	32587	P	833	0	833	0.00005
ERR3957878_1_kneaddata_paired	Firmicutes_I	18140	P	161	0	161	0.00001
ERR3957878_1_kneaddata_paired	Campylobacterota	8700	P	152	0	152	0.00001
ERR3957878_1_kneaddata_paired	Firmicutes_C	17613	P	60	0	60	0.00000
ERR3957878_1_kneaddata_paired	Deferribacterota	10822	P	47	0	47	0.00000
ERR3957878_1_kneaddata_paired	Thermotogota	33086	P	21	0	21	0.00000
ERR3957878_1_kneaddata_paired	Elusimicrobiota	11888	P	10	0	10	0.00000
ERR3957879_1_kneaddata_paired	Firmicutes_A	14608	P	15036103	48949	15085052	0.56641
ERR3957879_1_kneaddata_paired	Bacteroidota	4587	P	9567929	132458	9700387	0.36423
ERR3957879_1_kneaddata_paired	Firmicutes	12188	P	1337294	72817	1410111	0.05295
ERR3957879_1_kneaddata_paired	Verrucomicrobiota	33333	P	285028	13907	298935	0.01122
ERR3957879_1_kneaddata_paired	Actinobacteriota	615	P	102505	76	102581	0.00385
ERR3957879_1_kneaddata_paired	Proteobacteria	22518	P	24244	420	24664	0.00093
ERR3957879_1_kneaddata_paired	Cyanobacteria	9876	P	5267	82	5349	0.00020
ERR3957879_1_kneaddata_paired	Firmicutes_B	17289	P	2362	73	2435	0.00009
ERR3957879_1_kneaddata_paired	Desulfobacterota_A	11509	P	1247	136	1383	0.00005
ERR3957879_1_kneaddata_paired	Spirochaetota	32587	P	1077	1	1078	0.00004
ERR3957879_1_kneaddata_paired	Firmicutes_I	18140	P	222	0	222	0.00001
ERR3957879_1_kneaddata_paired	Campylobacterota	8700	P	174	0	174	0.00001
ERR3957879_1_kneaddata_paired	Deferribacterota	10822	P	94	0	94	0.00000
ERR3957879_1_kneaddata_paired	Firmicutes_C	17613	P	85	0	85	0.00000
ERR3957879_1_kneaddata_paired	Thermotogota	33086	P	8	0	8	0.00000
ERR3957879_1_kneaddata_paired	Elusimicrobiota	11888	P	7	0	7	0.00000
ERR3957880_1_kneaddata_paired	Firmicutes_A	14608	P	21096838	120013	21216851	0.92739
ERR3957880_1_kneaddata_paired	Bacteroidota	4587	P	983274	18595	1001869	0.04379
ERR3957880_1_kneaddata_paired	Firmicutes	12188	P	595699	11598	607297	0.02654
ERR3957880_1_kneaddata_paired	Verrucomicrobiota	33333	P	19692	1387	21079	0.00092
ERR3957880_1_kneaddata_paired	Actinobacteriota	615	P	18346	11	18357	0.00080
ERR3957880_1_kneaddata_paired	Cyanobacteria	9876	P	3734	31	3765	0.00016
ERR3957880_1_kneaddata_paired	Proteobacteria	22518	P	3621	90	3711	0.00016
ERR3957880_1_kneaddata_paired	Desulfobacterota_A	11509	P	1653	288	1941	0.00008
ERR3957880_1_kneaddata_paired	Spirochaetota	32587	P	1298	1	1299	0.00006
ERR3957880_1_kneaddata_paired	Firmicutes_B	17289	P	1262	57	1319	0.00006
ERR3957880_1_kneaddata_paired	Firmicutes_I	18140	P	150	0	150	0.00001
ERR3957880_1_kneaddata_paired	Campylobacterota	8700	P	124	0	124	0.00001
ERR3957880_1_kneaddata_paired	Firmicutes_C	17613	P	108	0	108	0.00000
ERR3957880_1_kneaddata_paired	Deferribacterota	10822	P	94	0	94	0.00000
ERR3957880_1_kneaddata_paired	Thermotogota	33086	P	53	0	53	0.00000
ERR3957880_1_kneaddata_paired	Elusimicrobiota	11888	P	12	0	12	0.00000
ERR3957881_1_kneaddata_paired	Firmicutes_A	14608	P	16098202	61864	16160066	0.70804
ERR3957881_1_kneaddata_paired	Bacteroidota	4587	P	4595964	12578	4608542	0.20192
ERR3957881_1_kneaddata_paired	Verrucomicrobiota	33333	P	1765262	68029	1833291	0.08032
ERR3957881_1_kneaddata_paired	Actinobacteriota	615	P	151152	33	151185	0.00662
ERR3957881_1_kneaddata_paired	Firmicutes	12188	P	39922	1511	41433	0.00182
ERR3957881_1_kneaddata_paired	Proteobacteria	22518	P	15845	220	16065	0.00070
ERR3957881_1_kneaddata_paired	Cyanobacteria	9876	P	4913	19	4932	0.00022
ERR3957881_1_kneaddata_paired	Desulfobacterota_A	11509	P	3799	371	4170	0.00018
ERR3957881_1_kneaddata_paired	Firmicutes_B	17289	P	2374	58	2432	0.00011
ERR3957881_1_kneaddata_paired	Spirochaetota	32587	P	1063	0	1063	0.00005
ERR3957881_1_kneaddata_paired	Firmicutes_C	17613	P	136	0	136	0.00001
ERR3957881_1_kneaddata_paired	Campylobacterota	8700	P	118	0	118	0.00001
ERR3957881_1_kneaddata_paired	Firmicutes_I	18140	P	100	0	100	0.00000
ERR3957881_1_kneaddata_paired	Elusimicrobiota	11888	P	36	0	36	0.00000
ERR3957881_1_kneaddata_paired	Thermotogota	33086	P	30	0	30	0.00000
ERR3957881_1_kneaddata_paired	Deferribacterota	10822	P	22	0	22	0.00000
ERR3957882_1_kneaddata_paired	Firmicutes_A	14608	P	28892575	101080	28993655	0.92380
ERR3957882_1_kneaddata_paired	Bacteroidota	4587	P	1630454	20624	1651078	0.05261
ERR3957882_1_kneaddata_paired	Firmicutes	12188	P	538543	23106	561649	0.01790
ERR3957882_1_kneaddata_paired	Verrucomicrobiota	33333	P	63250	3310	66560	0.00212
ERR3957882_1_kneaddata_paired	Actinobacteriota	615	P	59081	15	59096	0.00188
ERR3957882_1_kneaddata_paired	Firmicutes_B	17289	P	36360	1218	37578	0.00120
ERR3957882_1_kneaddata_paired	Cyanobacteria	9876	P	6270	120	6390	0.00020
ERR3957882_1_kneaddata_paired	Proteobacteria	22518	P	5445	94	5539	0.00018
ERR3957882_1_kneaddata_paired	Desulfobacterota_A	11509	P	1688	205	1893	0.00006
ERR3957882_1_kneaddata_paired	Spirochaetota	32587	P	872	0	872	0.00003
ERR3957882_1_kneaddata_paired	Campylobacterota	8700	P	336	0	336	0.00001
ERR3957882_1_kneaddata_paired	Firmicutes_I	18140	P	180	0	180	0.00001
ERR3957882_1_kneaddata_paired	Firmicutes_C	17613	P	170	0	170	0.00001
ERR3957882_1_kneaddata_paired	Deferribacterota	10822	P	129	0	129	0.00000
ERR3957882_1_kneaddata_paired	Thermotogota	33086	P	63	0	63	0.00000
ERR3957882_1_kneaddata_paired	Elusimicrobiota	11888	P	23	0	23	0.00000
ERR3957883_1_kneaddata_paired	Firmicutes_A	14608	P	10795555	43342	10838897	0.51918
ERR3957883_1_kneaddata_paired	Bacteroidota	4587	P	7101964	11016	7112980	0.34071
ERR3957883_1_kneaddata_paired	Verrucomicrobiota	33333	P	1671257	56562	1727819	0.08276
ERR3957883_1_kneaddata_paired	Firmicutes	12188	P	600095	21032	621127	0.02975
ERR3957883_1_kneaddata_paired	Firmicutes_B	17289	P	321349	6978	328327	0.01573
ERR3957883_1_kneaddata_paired	Actinobacteriota	615	P	135853	13	135866	0.00651
ERR3957883_1_kneaddata_paired	Proteobacteria	22518	P	97556	1248	98804	0.00473
ERR3957883_1_kneaddata_paired	Cyanobacteria	9876	P	6609	13	6622	0.00032
ERR3957883_1_kneaddata_paired	Desulfobacterota_A	11509	P	4536	412	4948	0.00024
ERR3957883_1_kneaddata_paired	Spirochaetota	32587	P	1027	0	1027	0.00005
ERR3957883_1_kneaddata_paired	Firmicutes_I	18140	P	188	0	188	0.00001
ERR3957883_1_kneaddata_paired	Firmicutes_C	17613	P	118	0	118	0.00001
ERR3957883_1_kneaddata_paired	Campylobacterota	8700	P	109	0	109	0.00001
ERR3957883_1_kneaddata_paired	Elusimicrobiota	11888	P	27	0	27	0.00000
ERR3957883_1_kneaddata_paired	Deferribacterota	10822	P	14	0	14	0.00000
ERR3957883_1_kneaddata_paired	Thermotogota	33086	P	8	0	8	0.00000
ERR3957884_1_kneaddata_paired	Firmicutes_A	14608	P	24190253	95994	24286247	0.91662
ERR3957884_1_kneaddata_paired	Bacteroidota	4587	P	1671763	23456	1695219	0.06398
ERR3957884_1_kneaddata_paired	Firmicutes	12188	P	381524	13909	395433	0.01492
ERR3957884_1_kneaddata_paired	Actinobacteriota	615	P	35897	11	35908	0.00136
ERR3957884_1_kneaddata_paired	Firmicutes_B	17289	P	34616	1288	35904	0.00136
ERR3957884_1_kneaddata_paired	Verrucomicrobiota	33333	P	30038	1732	31770	0.00120
ERR3957884_1_kneaddata_paired	Proteobacteria	22518	P	6796	131	6927	0.00026
ERR3957884_1_kneaddata_paired	Cyanobacteria	9876	P	4188	64	4252	0.00016
ERR3957884_1_kneaddata_paired	Desulfobacterota_A	11509	P	1927	268	2195	0.00008
ERR3957884_1_kneaddata_paired	Spirochaetota	32587	P	1060	1	1061	0.00004
ERR3957884_1_kneaddata_paired	Campylobacterota	8700	P	172	0	172	0.00001
ERR3957884_1_kneaddata_paired	Deferribacterota	10822	P	162	0	162	0.00001
ERR3957884_1_kneaddata_paired	Firmicutes_I	18140	P	117	0	117	0.00000
ERR3957884_1_kneaddata_paired	Firmicutes_C	17613	P	51	0	51	0.00000
ERR3957884_1_kneaddata_paired	Elusimicrobiota	11888	P	28	0	28	0.00000
ERR3957884_1_kneaddata_paired	Thermotogota	33086	P	10	0	10	0.00000
ERR3957885_1_kneaddata_paired	Firmicutes_A	14608	P	12040604	34855	12075459	0.55487
ERR3957885_1_kneaddata_paired	Bacteroidota	4587	P	5519759	5201	5524960	0.25387
ERR3957885_1_kneaddata_paired	Firmicutes	12188	P	1673522	73183	1746705	0.08026
ERR3957885_1_kneaddata_paired	Verrucomicrobiota	33333	P	1619150	32245	1651395	0.07588
ERR3957885_1_kneaddata_paired	Firmicutes_B	17289	P	320888	4102	324990	0.01493
ERR3957885_1_kneaddata_paired	Actinobacteriota	615	P	298863	35	298898	0.01373
ERR3957885_1_kneaddata_paired	Proteobacteria	22518	P	126415	944	127359	0.00585
ERR3957885_1_kneaddata_paired	Cyanobacteria	9876	P	5767	7	5774	0.00027
ERR3957885_1_kneaddata_paired	Desulfobacterota_A	11509	P	5403	299	5702	0.00026
ERR3957885_1_kneaddata_paired	Spirochaetota	32587	P	1012	0	1012	0.00005
ERR3957885_1_kneaddata_paired	Firmicutes_I	18140	P	171	0	171	0.00001
ERR3957885_1_kneaddata_paired	Firmicutes_C	17613	P	137	0	137	0.00001
ERR3957885_1_kneaddata_paired	Campylobacterota	8700	P	82	0	82	0.00000
ERR3957885_1_kneaddata_paired	Elusimicrobiota	11888	P	31	0	31	0.00000
ERR3957885_1_kneaddata_paired	Deferribacterota	10822	P	21	0	21	0.00000
ERR3957885_1_kneaddata_paired	Thermotogota	33086	P	9	0	9	0.00000
ERR3957886_1_kneaddata_paired	Firmicutes_A	14608	P	24292174	102603	24394777	0.86975
ERR3957886_1_kneaddata_paired	Bacteroidota	4587	P	2868006	41760	2909766	0.10374
ERR3957886_1_kneaddata_paired	Firmicutes	12188	P	631091	11838	642929	0.02292
ERR3957886_1_kneaddata_paired	Actinobacteriota	615	P	37884	18	37902	0.00135
ERR3957886_1_kneaddata_paired	Proteobacteria	22518	P	33239	765	34004	0.00121
ERR3957886_1_kneaddata_paired	Verrucomicrobiota	33333	P	15918	946	16864	0.00060
ERR3957886_1_kneaddata_paired	Cyanobacteria	9876	P	5902	183	6085	0.00022
ERR3957886_1_kneaddata_paired	Firmicutes_B	17289	P	1761	68	1829	0.00007
ERR3957886_1_kneaddata_paired	Desulfobacterota_A	11509	P	1617	214	1831	0.00007
ERR3957886_1_kneaddata_paired	Spirochaetota	32587	P	1286	1	1287	0.00005
ERR3957886_1_kneaddata_paired	Campylobacterota	8700	P	327	0	327	0.00001
ERR3957886_1_kneaddata_paired	Firmicutes_I	18140	P	232	0	232	0.00001
ERR3957886_1_kneaddata_paired	Deferribacterota	10822	P	102	0	102	0.00000
ERR3957886_1_kneaddata_paired	Firmicutes_C	17613	P	78	0	78	0.00000
ERR3957886_1_kneaddata_paired	Thermotogota	33086	P	21	0	21	0.00000
ERR3957886_1_kneaddata_paired	Elusimicrobiota	11888	P	17	0	17	0.00000
ERR3957887_1_kneaddata_paired	Firmicutes_A	14608	P	10860725	21795	10882520	0.55399
ERR3957887_1_kneaddata_paired	Bacteroidota	4587	P	4273153	1615	4274768	0.21762
ERR3957887_1_kneaddata_paired	Verrucomicrobiota	33333	P	3647357	65638	3712995	0.18902
ERR3957887_1_kneaddata_paired	Firmicutes	12188	P	473318	14021	487339	0.02481
ERR3957887_1_kneaddata_paired	Actinobacteriota	615	P	188639	83	188722	0.00961
ERR3957887_1_kneaddata_paired	Proteobacteria	22518	P	87240	595	87835	0.00447
ERR3957887_1_kneaddata_paired	Cyanobacteria	9876	P	4064	7	4071	0.00021
ERR3957887_1_kneaddata_paired	Desulfobacterota_A	11509	P	2275	88	2363	0.00012
ERR3957887_1_kneaddata_paired	Firmicutes_B	17289	P	1598	18	1616	0.00008
ERR3957887_1_kneaddata_paired	Spirochaetota	32587	P	1009	0	1009	0.00005
ERR3957887_1_kneaddata_paired	Firmicutes_C	17613	P	202	0	202	0.00001
ERR3957887_1_kneaddata_paired	Firmicutes_I	18140	P	127	0	127	0.00001
ERR3957887_1_kneaddata_paired	Campylobacterota	8700	P	90	0	90	0.00000
ERR3957887_1_kneaddata_paired	Deferribacterota	10822	P	30	0	30	0.00000
ERR3957887_1_kneaddata_paired	Elusimicrobiota	11888	P	18	0	18	0.00000
ERR3957887_1_kneaddata_paired	Thermotogota	33086	P	9	0	9	0.00000
ERR3957888_1_kneaddata_paired	Firmicutes_A	14608	P	9493592	59240	9552832	0.73583
ERR3957888_1_kneaddata_paired	Bacteroidota	4587	P	2405942	66122	2472064	0.19042
ERR3957888_1_kneaddata_paired	Firmicutes	12188	P	879252	14165	893417	0.06882
ERR3957888_1_kneaddata_paired	Actinobacteriota	615	P	38861	14	38875	0.00299
ERR3957888_1_kneaddata_paired	Firmicutes_B	17289	P	8701	410	9111	0.00070
ERR3957888_1_kneaddata_paired	Cyanobacteria	9876	P	5435	62	5497	0.00042
ERR3957888_1_kneaddata_paired	Proteobacteria	22518	P	4559	103	4662	0.00036
ERR3957888_1_kneaddata_paired	Verrucomicrobiota	33333	P	2578	184	2762	0.00021
ERR3957888_1_kneaddata_paired	Spirochaetota	32587	P	1277	2	1279	0.00010
ERR3957888_1_kneaddata_paired	Desulfobacterota_A	11509	P	1183	216	1399	0.00011
ERR3957888_1_kneaddata_paired	Campylobacterota	8700	P	182	0	182	0.00001
ERR3957888_1_kneaddata_paired	Deferribacterota	10822	P	119	0	119	0.00001
ERR3957888_1_kneaddata_paired	Firmicutes_I	18140	P	104	0	104	0.00001
ERR3957888_1_kneaddata_paired	Firmicutes_C	17613	P	43	0	43	0.00000
ERR3957888_1_kneaddata_paired	Elusimicrobiota	11888	P	17	0	17	0.00000
ERR3957888_1_kneaddata_paired	Thermotogota	33086	P	4	0	4	0.00000
ERR3957889_1_kneaddata_paired	Firmicutes_A	14608	P	17240354	68082	17308436	0.81628
ERR3957889_1_kneaddata_paired	Bacteroidota	4587	P	1925858	4593	1930451	0.09104
ERR3957889_1_kneaddata_paired	Verrucomicrobiota	33333	P	1574618	51747	1626365	0.07670
ERR3957889_1_kneaddata_paired	Actinobacteriota	615	P	223858	75	223933	0.01056
ERR3957889_1_kneaddata_paired	Firmicutes	12188	P	57223	1240	58463	0.00276
ERR3957889_1_kneaddata_paired	Proteobacteria	22518	P	44112	543	44655	0.00211
ERR3957889_1_kneaddata_paired	Cyanobacteria	9876	P	5074	26	5100	0.00024
ERR3957889_1_kneaddata_paired	Desulfobacterota_A	11509	P	3352	280	3632	0.00017
ERR3957889_1_kneaddata_paired	Firmicutes_B	17289	P	1866	39	1905	0.00009
ERR3957889_1_kneaddata_paired	Spirochaetota	32587	P	633	0	633	0.00003
ERR3957889_1_kneaddata_paired	Firmicutes_I	18140	P	146	0	146	0.00001
ERR3957889_1_kneaddata_paired	Firmicutes_C	17613	P	125	0	125	0.00001
ERR3957889_1_kneaddata_paired	Campylobacterota	8700	P	107	0	107	0.00001
ERR3957889_1_kneaddata_paired	Elusimicrobiota	11888	P	57	0	57	0.00000
ERR3957889_1_kneaddata_paired	Deferribacterota	10822	P	13	0	13	0.00000
ERR3957889_1_kneaddata_paired	Thermotogota	33086	P	7	0	7	0.00000
ERR3957890_1_kneaddata_paired	Firmicutes_A	14608	P	20025959	115812	20141771	0.87389
ERR3957890_1_kneaddata_paired	Bacteroidota	4587	P	2489323	34422	2523745	0.10950
ERR3957890_1_kneaddata_paired	Firmicutes	12188	P	273075	7298	280373	0.01216
ERR3957890_1_kneaddata_paired	Verrucomicrobiota	33333	P	45763	3738	49501	0.00215
ERR3957890_1_kneaddata_paired	Actinobacteriota	615	P	35679	24	35703	0.00155
ERR3957890_1_kneaddata_paired	Proteobacteria	22518	P	6527	168	6695	0.00029
ERR3957890_1_kneaddata_paired	Cyanobacteria	9876	P	4590	51	4641	0.00020
ERR3957890_1_kneaddata_paired	Desulfobacterota_A	11509	P	1810	359	2169	0.00009
ERR3957890_1_kneaddata_paired	Spirochaetota	32587	P	1608	2	1610	0.00007
ERR3957890_1_kneaddata_paired	Firmicutes_B	17289	P	1302	69	1371	0.00006
ERR3957890_1_kneaddata_paired	Campylobacterota	8700	P	432	0	432	0.00002
ERR3957890_1_kneaddata_paired	Firmicutes_I	18140	P	226	0	226	0.00001
ERR3957890_1_kneaddata_paired	Deferribacterota	10822	P	125	0	125	0.00001
ERR3957890_1_kneaddata_paired	Firmicutes_C	17613	P	95	0	95	0.00000
ERR3957890_1_kneaddata_paired	Thermotogota	33086	P	61	0	61	0.00000
ERR3957890_1_kneaddata_paired	Elusimicrobiota	11888	P	8	0	8	0.00000
ERR3957891_1_kneaddata_paired	Bacteroidota	4587	P	19160212	20717	19180929	0.43815
ERR3957891_1_kneaddata_paired	Firmicutes_A	14608	P	16921551	42431	16963982	0.38751
ERR3957891_1_kneaddata_paired	Verrucomicrobiota	33333	P	6163730	101103	6264833	0.14311
ERR3957891_1_kneaddata_paired	Firmicutes	12188	P	773208	22758	795966	0.01818
ERR3957891_1_kneaddata_paired	Actinobacteriota	615	P	371195	155	371350	0.00848
ERR3957891_1_kneaddata_paired	Proteobacteria	22518	P	180039	1123	181162	0.00414
ERR3957891_1_kneaddata_paired	Cyanobacteria	9876	P	7281	9	7290	0.00017
ERR3957891_1_kneaddata_paired	Desulfobacterota_A	11509	P	5369	216	5585	0.00013
ERR3957891_1_kneaddata_paired	Firmicutes_B	17289	P	3891	40	3931	0.00009
ERR3957891_1_kneaddata_paired	Spirochaetota	32587	P	1301	0	1301	0.00003
ERR3957891_1_kneaddata_paired	Firmicutes_I	18140	P	352	0	352	0.00001
ERR3957891_1_kneaddata_paired	Firmicutes_C	17613	P	269	0	269	0.00001
ERR3957891_1_kneaddata_paired	Campylobacterota	8700	P	201	0	201	0.00000
ERR3957891_1_kneaddata_paired	Deferribacterota	10822	P	28	0	28	0.00000
ERR3957891_1_kneaddata_paired	Thermotogota	33086	P	24	0	24	0.00000
ERR3957891_1_kneaddata_paired	Elusimicrobiota	11888	P	18	0	18	0.00000
ERR3957892_1_kneaddata_paired	Firmicutes_A	14608	P	20599362	89492	20688854	0.76675
ERR3957892_1_kneaddata_paired	Bacteroidota	4587	P	5199531	74548	5274079	0.19546
ERR3957892_1_kneaddata_paired	Firmicutes	12188	P	417484	7861	425345	0.01576
ERR3957892_1_kneaddata_paired	Verrucomicrobiota	33333	P	342038	21689	363727	0.01348
ERR3957892_1_kneaddata_paired	Actinobacteriota	615	P	200897	202	201099	0.00745
ERR3957892_1_kneaddata_paired	Proteobacteria	22518	P	15882	356	16238	0.00060
ERR3957892_1_kneaddata_paired	Cyanobacteria	9876	P	6024	79	6103	0.00023
ERR3957892_1_kneaddata_paired	Firmicutes_B	17289	P	1887	77	1964	0.00007
ERR3957892_1_kneaddata_paired	Desulfobacterota_A	11509	P	1511	205	1716	0.00006
ERR3957892_1_kneaddata_paired	Spirochaetota	32587	P	1451	1	1452	0.00005
ERR3957892_1_kneaddata_paired	Campylobacterota	8700	P	1169	0	1169	0.00004
ERR3957892_1_kneaddata_paired	Firmicutes_I	18140	P	402	0	402	0.00001
ERR3957892_1_kneaddata_paired	Deferribacterota	10822	P	127	0	127	0.00000
ERR3957892_1_kneaddata_paired	Firmicutes_C	17613	P	77	0	77	0.00000
ERR3957892_1_kneaddata_paired	Thermotogota	33086	P	65	0	65	0.00000
ERR3957892_1_kneaddata_paired	Elusimicrobiota	11888	P	30	0	30	0.00000
ERR3957893_1_kneaddata_paired	Firmicutes_A	14608	P	29410937	115538	29526475	0.55536
ERR3957893_1_kneaddata_paired	Bacteroidota	4587	P	18161795	24762	18186557	0.34207
ERR3957893_1_kneaddata_paired	Verrucomicrobiota	33333	P	4116145	117054	4233199	0.07962
ERR3957893_1_kneaddata_paired	Firmicutes	12188	P	537504	25812	563316	0.01060
ERR3957893_1_kneaddata_paired	Actinobacteriota	615	P	385520	250	385770	0.00726
ERR3957893_1_kneaddata_paired	Proteobacteria	22518	P	241704	2605	244309	0.00460
ERR3957893_1_kneaddata_paired	Cyanobacteria	9876	P	11363	23	11386	0.00021
ERR3957893_1_kneaddata_paired	Desulfobacterota_A	11509	P	9255	677	9932	0.00019
ERR3957893_1_kneaddata_paired	Firmicutes_B	17289	P	2489	45	2534	0.00005
ERR3957893_1_kneaddata_paired	Spirochaetota	32587	P	1773	0	1773	0.00003
ERR3957893_1_kneaddata_paired	Campylobacterota	8700	P	470	0	470	0.00001
ERR3957893_1_kneaddata_paired	Firmicutes_I	18140	P	451	0	451	0.00001
ERR3957893_1_kneaddata_paired	Firmicutes_C	17613	P	267	0	267	0.00001
ERR3957893_1_kneaddata_paired	Elusimicrobiota	11888	P	48	0	48	0.00000
ERR3957893_1_kneaddata_paired	Deferribacterota	10822	P	33	0	33	0.00000
ERR3957893_1_kneaddata_paired	Thermotogota	33086	P	21	0	21	0.00000
ERR3957894_1_kneaddata_paired	Firmicutes_A	14608	P	11782453	57719	11840172	0.52492
ERR3957894_1_kneaddata_paired	Bacteroidota	4587	P	9622632	111419	9734051	0.43155
ERR3957894_1_kneaddata_paired	Firmicutes	12188	P	517027	6791	523818	0.02322
ERR3957894_1_kneaddata_paired	Verrucomicrobiota	33333	P	359670	21525	381195	0.01690
ERR3957894_1_kneaddata_paired	Actinobacteriota	615	P	44326	14	44340	0.00197
ERR3957894_1_kneaddata_paired	Proteobacteria	22518	P	21209	462	21671	0.00096
ERR3957894_1_kneaddata_paired	Cyanobacteria	9876	P	5802	78	5880	0.00026
ERR3957894_1_kneaddata_paired	Spirochaetota	32587	P	1427	1	1428	0.00006
ERR3957894_1_kneaddata_paired	Firmicutes_B	17289	P	1256	48	1304	0.00006
ERR3957894_1_kneaddata_paired	Desulfobacterota_A	11509	P	1153	151	1304	0.00006
ERR3957894_1_kneaddata_paired	Campylobacterota	8700	P	495	0	495	0.00002
ERR3957894_1_kneaddata_paired	Firmicutes_I	18140	P	214	0	214	0.00001
ERR3957894_1_kneaddata_paired	Deferribacterota	10822	P	147	0	147	0.00001
ERR3957894_1_kneaddata_paired	Firmicutes_C	17613	P	61	0	61	0.00000
ERR3957894_1_kneaddata_paired	Thermotogota	33086	P	32	0	32	0.00000
ERR3957894_1_kneaddata_paired	Elusimicrobiota	11888	P	10	0	10	0.00000
ERR3957895_1_kneaddata_paired	Firmicutes_A	14608	P	13762422	54812	13817234	0.58690
ERR3957895_1_kneaddata_paired	Bacteroidota	4587	P	6883318	10089	6893407	0.29280
ERR3957895_1_kneaddata_paired	Verrucomicrobiota	33333	P	2035083	55284	2090367	0.08879
ERR3957895_1_kneaddata_paired	Actinobacteriota	615	P	362436	247	362683	0.01541
ERR3957895_1_kneaddata_paired	Firmicutes	12188	P	286864	11903	298767	0.01269
ERR3957895_1_kneaddata_paired	Proteobacteria	22518	P	58241	595	58836	0.00250
ERR3957895_1_kneaddata_paired	Firmicutes_B	17289	P	10655	185	10840	0.00046
ERR3957895_1_kneaddata_paired	Cyanobacteria	9876	P	5182	13	5195	0.00022
ERR3957895_1_kneaddata_paired	Desulfobacterota_A	11509	P	3575	241	3816	0.00016
ERR3957895_1_kneaddata_paired	Spirochaetota	32587	P	1075	0	1075	0.00005
ERR3957895_1_kneaddata_paired	Firmicutes_C	17613	P	147	0	147	0.00001
ERR3957895_1_kneaddata_paired	Firmicutes_I	18140	P	144	0	144	0.00001
ERR3957895_1_kneaddata_paired	Campylobacterota	8700	P	106	0	106	0.00000
ERR3957895_1_kneaddata_paired	Elusimicrobiota	11888	P	24	0	24	0.00000
ERR3957895_1_kneaddata_paired	Deferribacterota	10822	P	16	0	16	0.00000
ERR3957895_1_kneaddata_paired	Thermotogota	33086	P	5	0	5	0.00000
ERR3957896_1_kneaddata_paired	Firmicutes_A	14608	P	14682947	28765	14711712	0.56050
ERR3957896_1_kneaddata_paired	Verrucomicrobiota	33333	P	7014940	114040	7128980	0.27161
ERR3957896_1_kneaddata_paired	Bacteroidota	4587	P	3588290	3303	3591593	0.13684
ERR3957896_1_kneaddata_paired	Firmicutes	12188	P	530649	16053	546702	0.02083
ERR3957896_1_kneaddata_paired	Actinobacteriota	615	P	172036	20	172056	0.00656
ERR3957896_1_kneaddata_paired	Proteobacteria	22518	P	83096	507	83603	0.00319
ERR3957896_1_kneaddata_paired	Cyanobacteria	9876	P	5686	10	5696	0.00022
ERR3957896_1_kneaddata_paired	Desulfobacterota_A	11509	P	3107	110	3217	0.00012
ERR3957896_1_kneaddata_paired	Firmicutes_B	17289	P	2303	24	2327	0.00009
ERR3957896_1_kneaddata_paired	Spirochaetota	32587	P	955	0	955	0.00004
ERR3957896_1_kneaddata_paired	Firmicutes_C	17613	P	277	0	277	0.00001
ERR3957896_1_kneaddata_paired	Firmicutes_I	18140	P	189	0	189	0.00001
ERR3957896_1_kneaddata_paired	Campylobacterota	8700	P	166	0	166	0.00001
ERR3957896_1_kneaddata_paired	Elusimicrobiota	11888	P	46	0	46	0.00000
ERR3957896_1_kneaddata_paired	Thermotogota	33086	P	16	0	16	0.00000
ERR3957896_1_kneaddata_paired	Deferribacterota	10822	P	13	0	13	0.00000
ERR3957897_1_kneaddata_paired	Firmicutes_A	14608	P	21943417	95872	22039289	0.71835
ERR3957897_1_kneaddata_paired	Bacteroidota	4587	P	6291386	16622	6308008	0.20560
ERR3957897_1_kneaddata_paired	Verrucomicrobiota	33333	P	1876343	73141	1949484	0.06354
ERR3957897_1_kneaddata_paired	Firmicutes	12188	P	171197	11106	182303	0.00594
ERR3957897_1_kneaddata_paired	Actinobacteriota	615	P	148227	44	148271	0.00483
ERR3957897_1_kneaddata_paired	Proteobacteria	22518	P	35637	520	36157	0.00118
ERR3957897_1_kneaddata_paired	Cyanobacteria	9876	P	6485	30	6515	0.00021
ERR3957897_1_kneaddata_paired	Desulfobacterota_A	11509	P	5764	585	6349	0.00021
ERR3957897_1_kneaddata_paired	Firmicutes_B	17289	P	2076	51	2127	0.00007
ERR3957897_1_kneaddata_paired	Spirochaetota	32587	P	1422	1	1423	0.00005
ERR3957897_1_kneaddata_paired	Firmicutes_C	17613	P	183	0	183	0.00001
ERR3957897_1_kneaddata_paired	Firmicutes_I	18140	P	151	0	151	0.00000
ERR3957897_1_kneaddata_paired	Campylobacterota	8700	P	120	0	120	0.00000
ERR3957897_1_kneaddata_paired	Elusimicrobiota	11888	P	53	0	53	0.00000
ERR3957897_1_kneaddata_paired	Deferribacterota	10822	P	13	0	13	0.00000
ERR3957897_1_kneaddata_paired	Thermotogota	33086	P	12	0	12	0.00000
ERR3957898_1_kneaddata_paired	Firmicutes_A	14608	P	18107048	87917	18194965	0.82085
ERR3957898_1_kneaddata_paired	Bacteroidota	4587	P	2923771	48065	2971836	0.13407
ERR3957898_1_kneaddata_paired	Firmicutes	12188	P	707655	10110	717765	0.03238
ERR3957898_1_kneaddata_paired	Verrucomicrobiota	33333	P	215748	13885	229633	0.01036
ERR3957898_1_kneaddata_paired	Actinobacteriota	615	P	24994	17	25011	0.00113
ERR3957898_1_kneaddata_paired	Proteobacteria	22518	P	17769	425	18194	0.00082
ERR3957898_1_kneaddata_paired	Cyanobacteria	9876	P	3237	53	3290	0.00015
ERR3957898_1_kneaddata_paired	Desulfobacterota_A	11509	P	1454	223	1677	0.00008
ERR3957898_1_kneaddata_paired	Firmicutes_B	17289	P	1343	55	1398	0.00006
ERR3957898_1_kneaddata_paired	Spirochaetota	32587	P	863	1	864	0.00004
ERR3957898_1_kneaddata_paired	Campylobacterota	8700	P	735	0	735	0.00003
ERR3957898_1_kneaddata_paired	Firmicutes_I	18140	P	315	0	315	0.00001
ERR3957898_1_kneaddata_paired	Firmicutes_C	17613	P	109	0	109	0.00000
ERR3957898_1_kneaddata_paired	Deferribacterota	10822	P	84	0	84	0.00000
ERR3957898_1_kneaddata_paired	Thermotogota	33086	P	27	0	27	0.00000
ERR3957898_1_kneaddata_paired	Elusimicrobiota	11888	P	12	0	12	0.00000
ERR3957899_1_kneaddata_paired	Bacteroidota	4587	P	7981511	6486	7987997	0.40362
ERR3957899_1_kneaddata_paired	Firmicutes_A	14608	P	6571451	15223	6586674	0.33281
ERR3957899_1_kneaddata_paired	Verrucomicrobiota	33333	P	3553477	59005	3612482	0.18253
ERR3957899_1_kneaddata_paired	Firmicutes	12188	P	1164136	33734	1197870	0.06053
ERR3957899_1_kneaddata_paired	Actinobacteriota	615	P	312300	25	312325	0.01578
ERR3957899_1_kneaddata_paired	Proteobacteria	22518	P	80885	501	81386	0.00411
ERR3957899_1_kneaddata_paired	Cyanobacteria	9876	P	6384	5	6389	0.00032
ERR3957899_1_kneaddata_paired	Desulfobacterota_A	11509	P	2423	96	2519	0.00013
ERR3957899_1_kneaddata_paired	Firmicutes_B	17289	P	1692	18	1710	0.00009
ERR3957899_1_kneaddata_paired	Spirochaetota	32587	P	1146	0	1146	0.00006
ERR3957899_1_kneaddata_paired	Firmicutes_C	17613	P	181	0	181	0.00001
ERR3957899_1_kneaddata_paired	Firmicutes_I	18140	P	109	0	109	0.00001
ERR3957899_1_kneaddata_paired	Campylobacterota	8700	P	52	0	52	0.00000
ERR3957899_1_kneaddata_paired	Deferribacterota	10822	P	25	0	25	0.00000
ERR3957899_1_kneaddata_paired	Elusimicrobiota	11888	P	12	0	12	0.00000
ERR3957899_1_kneaddata_paired	Thermotogota	33086	P	9	0	9	0.00000
ERR3957900_1_kneaddata_paired	Firmicutes_A	14608	P	19997020	89340	20086360	0.93230
ERR3957900_1_kneaddata_paired	Bacteroidota	4587	P	1076766	18325	1095091	0.05083
ERR3957900_1_kneaddata_paired	Firmicutes	12188	P	279539	9342	288881	0.01341
ERR3957900_1_kneaddata_paired	Actinobacteriota	615	P	38246	12	38258	0.00178
ERR3957900_1_kneaddata_paired	Firmicutes_B	17289	P	20248	872	21120	0.00098
ERR3957900_1_kneaddata_paired	Verrucomicrobiota	33333	P	4750	315	5065	0.00024
ERR3957900_1_kneaddata_paired	Cyanobacteria	9876	P	4451	65	4516	0.00021
ERR3957900_1_kneaddata_paired	Proteobacteria	22518	P	2548	48	2596	0.00012
ERR3957900_1_kneaddata_paired	Spirochaetota	32587	P	1218	1	1219	0.00006
ERR3957900_1_kneaddata_paired	Desulfobacterota_A	11509	P	1196	193	1389	0.00006
ERR3957900_1_kneaddata_paired	Campylobacterota	8700	P	180	0	180	0.00001
ERR3957900_1_kneaddata_paired	Firmicutes_I	18140	P	111	0	111	0.00001
ERR3957900_1_kneaddata_paired	Deferribacterota	10822	P	81	0	81	0.00000
ERR3957900_1_kneaddata_paired	Firmicutes_C	17613	P	74	0	74	0.00000
ERR3957900_1_kneaddata_paired	Thermotogota	33086	P	21	0	21	0.00000
ERR3957900_1_kneaddata_paired	Elusimicrobiota	11888	P	14	0	14	0.00000
ERR3957901_1_kneaddata_paired	Firmicutes_A	14608	P	12489530	26289	12515819	0.45451
ERR3957901_1_kneaddata_paired	Bacteroidota	4587	P	9368130	10464	9378594	0.34058
ERR3957901_1_kneaddata_paired	Verrucomicrobiota	33333	P	3912175	71241	3983416	0.14466
ERR3957901_1_kneaddata_paired	Firmicutes	12188	P	953913	26831	980744	0.03562
ERR3957901_1_kneaddata_paired	Firmicutes_B	17289	P	406814	4739	411553	0.01495
ERR3957901_1_kneaddata_paired	Actinobacteriota	615	P	181649	20	181669	0.00660
ERR3957901_1_kneaddata_paired	Proteobacteria	22518	P	75190	515	75705	0.00275
ERR3957901_1_kneaddata_paired	Cyanobacteria	9876	P	4703	9	4712	0.00017
ERR3957901_1_kneaddata_paired	Desulfobacterota_A	11509	P	3268	141	3409	0.00012
ERR3957901_1_kneaddata_paired	Spirochaetota	32587	P	865	0	865	0.00003
ERR3957901_1_kneaddata_paired	Firmicutes_C	17613	P	205	0	205	0.00001
ERR3957901_1_kneaddata_paired	Firmicutes_I	18140	P	175	0	175	0.00001
ERR3957901_1_kneaddata_paired	Campylobacterota	8700	P	162	0	162	0.00001
ERR3957901_1_kneaddata_paired	Deferribacterota	10822	P	42	0	42	0.00000
ERR3957901_1_kneaddata_paired	Elusimicrobiota	11888	P	26	0	26	0.00000
ERR3957901_1_kneaddata_paired	Thermotogota	33086	P	6	0	6	0.00000
ERR3957902_1_kneaddata_paired	Firmicutes_A	14608	P	15096489	84975	15181464	0.88580
ERR3957902_1_kneaddata_paired	Bacteroidota	4587	P	1479448	32365	1511813	0.08821
ERR3957902_1_kneaddata_paired	Firmicutes	12188	P	374484	7244	381728	0.02227
ERR3957902_1_kneaddata_paired	Firmicutes_B	17289	P	24581	1052	25633	0.00150
ERR3957902_1_kneaddata_paired	Actinobacteriota	615	P	23102	9	23111	0.00135
ERR3957902_1_kneaddata_paired	Verrucomicrobiota	33333	P	5132	342	5474	0.00032
ERR3957902_1_kneaddata_paired	Cyanobacteria	9876	P	3301	37	3338	0.00019
ERR3957902_1_kneaddata_paired	Proteobacteria	22518	P	2968	56	3024	0.00018
ERR3957902_1_kneaddata_paired	Desulfobacterota_A	11509	P	1509	243	1752	0.00010
ERR3957902_1_kneaddata_paired	Spirochaetota	32587	P	907	1	908	0.00005
ERR3957902_1_kneaddata_paired	Campylobacterota	8700	P	140	0	140	0.00001
ERR3957902_1_kneaddata_paired	Deferribacterota	10822	P	103	0	103	0.00001
ERR3957902_1_kneaddata_paired	Firmicutes_I	18140	P	94	0	94	0.00001
ERR3957902_1_kneaddata_paired	Firmicutes_C	17613	P	62	0	62	0.00000
ERR3957902_1_kneaddata_paired	Thermotogota	33086	P	35	0	35	0.00000
ERR3957902_1_kneaddata_paired	Elusimicrobiota	11888	P	19	0	19	0.00000
ERR3957903_1_kneaddata_paired	Firmicutes_A	14608	P	13782913	38655	13821568	0.58587
ERR3957903_1_kneaddata_paired	Bacteroidota	4587	P	5608472	7659	5616131	0.23806
ERR3957903_1_kneaddata_paired	Verrucomicrobiota	33333	P	2834631	62814	2897445	0.12282
ERR3957903_1_kneaddata_paired	Firmicutes_B	17289	P	437811	6212	444023	0.01882
ERR3957903_1_kneaddata_paired	Firmicutes	12188	P	410466	15189	425655	0.01804
ERR3957903_1_kneaddata_paired	Actinobacteriota	615	P	336417	13	336430	0.01426
ERR3957903_1_kneaddata_paired	Proteobacteria	22518	P	41309	341	41650	0.00177
ERR3957903_1_kneaddata_paired	Cyanobacteria	9876	P	3573	10	3583	0.00015
ERR3957903_1_kneaddata_paired	Desulfobacterota_A	11509	P	3502	182	3684	0.00016
ERR3957903_1_kneaddata_paired	Spirochaetota	32587	P	954	0	954	0.00004
ERR3957903_1_kneaddata_paired	Firmicutes_C	17613	P	244	0	244	0.00001
ERR3957903_1_kneaddata_paired	Campylobacterota	8700	P	138	0	138	0.00001
ERR3957903_1_kneaddata_paired	Firmicutes_I	18140	P	137	0	137	0.00001
ERR3957903_1_kneaddata_paired	Deferribacterota	10822	P	45	0	45	0.00000
ERR3957903_1_kneaddata_paired	Elusimicrobiota	11888	P	20	0	20	0.00000
ERR3957903_1_kneaddata_paired	Thermotogota	33086	P	15	0	15	0.00000
ERR3957904_1_kneaddata_paired	Firmicutes_A	14608	P	16657919	82390	16740309	0.85881
ERR3957904_1_kneaddata_paired	Bacteroidota	4587	P	2281913	27351	2309264	0.11847
ERR3957904_1_kneaddata_paired	Firmicutes	12188	P	280089	11814	291903	0.01498
ERR3957904_1_kneaddata_paired	Verrucomicrobiota	33333	P	63916	3215	67131	0.00344
ERR3957904_1_kneaddata_paired	Actinobacteriota	615	P	36915	9	36924	0.00189
ERR3957904_1_kneaddata_paired	Firmicutes_B	17289	P	29092	941	30033	0.00154
ERR3957904_1_kneaddata_paired	Proteobacteria	22518	P	10004	176	10180	0.00052
ERR3957904_1_kneaddata_paired	Cyanobacteria	9876	P	3701	40	3741	0.00019
ERR3957904_1_kneaddata_paired	Desulfobacterota_A	11509	P	1350	158	1508	0.00008
ERR3957904_1_kneaddata_paired	Spirochaetota	32587	P	953	0	953	0.00005
ERR3957904_1_kneaddata_paired	Campylobacterota	8700	P	152	0	152	0.00001
ERR3957904_1_kneaddata_paired	Firmicutes_I	18140	P	99	0	99	0.00001
ERR3957904_1_kneaddata_paired	Firmicutes_C	17613	P	90	0	90	0.00000
ERR3957904_1_kneaddata_paired	Deferribacterota	10822	P	71	0	71	0.00000
ERR3957904_1_kneaddata_paired	Elusimicrobiota	11888	P	18	0	18	0.00000
ERR3957904_1_kneaddata_paired	Thermotogota	33086	P	11	0	11	0.00000
ERR3957905_1_kneaddata_paired	Firmicutes_A	14608	P	11297212	31284	11328496	0.55358
ERR3957905_1_kneaddata_paired	Bacteroidota	4587	P	6055968	8365	6064333	0.29634
ERR3957905_1_kneaddata_paired	Verrucomicrobiota	33333	P	2151436	49642	2201078	0.10756
ERR3957905_1_kneaddata_paired	Firmicutes_B	17289	P	363772	5364	369136	0.01804
ERR3957905_1_kneaddata_paired	Actinobacteriota	615	P	210526	33	210559	0.01029
ERR3957905_1_kneaddata_paired	Firmicutes	12188	P	182674	5669	188343	0.00920
ERR3957905_1_kneaddata_paired	Proteobacteria	22518	P	94105	835	94940	0.00464
ERR3957905_1_kneaddata_paired	Cyanobacteria	9876	P	3262	9	3271	0.00016
ERR3957905_1_kneaddata_paired	Desulfobacterota_A	11509	P	2808	156	2964	0.00014
ERR3957905_1_kneaddata_paired	Spirochaetota	32587	P	653	0	653	0.00003
ERR3957905_1_kneaddata_paired	Firmicutes_I	18140	P	133	0	133	0.00001
ERR3957905_1_kneaddata_paired	Firmicutes_C	17613	P	122	0	122	0.00001
ERR3957905_1_kneaddata_paired	Campylobacterota	8700	P	64	0	64	0.00000
ERR3957905_1_kneaddata_paired	Deferribacterota	10822	P	25	0	25	0.00000
ERR3957905_1_kneaddata_paired	Elusimicrobiota	11888	P	21	0	21	0.00000
ERR3957905_1_kneaddata_paired	Thermotogota	33086	P	9	0	9	0.00000
ERR3957906_1_kneaddata_paired	Firmicutes_A	14608	P	13502784	69495	13572279	0.89028
ERR3957906_1_kneaddata_paired	Bacteroidota	4587	P	1317648	24036	1341684	0.08801
ERR3957906_1_kneaddata_paired	Firmicutes	12188	P	257168	5264	262432	0.01721
ERR3957906_1_kneaddata_paired	Actinobacteriota	615	P	30197	9	30206	0.00198
ERR3957906_1_kneaddata_paired	Verrucomicrobiota	33333	P	23665	1280	24945	0.00164
ERR3957906_1_kneaddata_paired	Proteobacteria	22518	P	6262	140	6402	0.00042
ERR3957906_1_kneaddata_paired	Cyanobacteria	9876	P	2603	27	2630	0.00017
ERR3957906_1_kneaddata_paired	Desulfobacterota_A	11509	P	1831	242	2073	0.00014
ERR3957906_1_kneaddata_paired	Firmicutes_B	17289	P	989	34	1023	0.00007
ERR3957906_1_kneaddata_paired	Spirochaetota	32587	P	814	1	815	0.00005
ERR3957906_1_kneaddata_paired	Campylobacterota	8700	P	191	0	191	0.00001
ERR3957906_1_kneaddata_paired	Deferribacterota	10822	P	116	0	116	0.00001
ERR3957906_1_kneaddata_paired	Firmicutes_I	18140	P	103	0	103	0.00001
ERR3957906_1_kneaddata_paired	Firmicutes_C	17613	P	81	0	81	0.00001
ERR3957906_1_kneaddata_paired	Elusimicrobiota	11888	P	11	0	11	0.00000
ERR3957906_1_kneaddata_paired	Thermotogota	33086	P	6	0	6	0.00000
ERR3957907_1_kneaddata_paired	Firmicutes_A	14608	P	19318069	108958	19427027	0.82901
ERR3957907_1_kneaddata_paired	Bacteroidota	4587	P	3072275	53392	3125667	0.13338
ERR3957907_1_kneaddata_paired	Firmicutes	12188	P	688356	11804	700160	0.02988
ERR3957907_1_kneaddata_paired	Verrucomicrobiota	33333	P	112231	7331	119562	0.00510
ERR3957907_1_kneaddata_paired	Actinobacteriota	615	P	36336	21	36357	0.00155
ERR3957907_1_kneaddata_paired	Proteobacteria	22518	P	12438	300	12738	0.00054
ERR3957907_1_kneaddata_paired	Cyanobacteria	9876	P	6255	122	6377	0.00027
ERR3957907_1_kneaddata_paired	Spirochaetota	32587	P	1491	1	1492	0.00006
ERR3957907_1_kneaddata_paired	Firmicutes_B	17289	P	1416	59	1475	0.00006
ERR3957907_1_kneaddata_paired	Desulfobacterota_A	11509	P	1288	191	1479	0.00006
ERR3957907_1_kneaddata_paired	Campylobacterota	8700	P	1015	0	1015	0.00004
ERR3957907_1_kneaddata_paired	Firmicutes_I	18140	P	382	0	382	0.00002
ERR3957907_1_kneaddata_paired	Deferribacterota	10822	P	110	0	110	0.00000
ERR3957907_1_kneaddata_paired	Firmicutes_C	17613	P	87	0	87	0.00000
ERR3957907_1_kneaddata_paired	Thermotogota	33086	P	17	0	17	0.00000
ERR3957907_1_kneaddata_paired	Elusimicrobiota	11888	P	10	0	10	0.00000
ERR3957908_1_kneaddata_paired	Firmicutes_A	14608	P	16065860	84999	16150859	0.93532
ERR3957908_1_kneaddata_paired	Bacteroidota	4587	P	771520	11736	783256	0.04536
ERR3957908_1_kneaddata_paired	Firmicutes	12188	P	269062	6705	275767	0.01597
ERR3957908_1_kneaddata_paired	Actinobacteriota	615	P	29276	9	29285	0.00170
ERR3957908_1_kneaddata_paired	Verrucomicrobiota	33333	P	12848	786	13634	0.00079
ERR3957908_1_kneaddata_paired	Desulfobacterota_A	11509	P	4354	740	5094	0.00030
ERR3957908_1_kneaddata_paired	Cyanobacteria	9876	P	4081	84	4165	0.00024
ERR3957908_1_kneaddata_paired	Proteobacteria	22518	P	3156	61	3217	0.00019
ERR3957908_1_kneaddata_paired	Firmicutes_B	17289	P	1093	42	1135	0.00007
ERR3957908_1_kneaddata_paired	Spirochaetota	32587	P	845	1	846	0.00005
ERR3957908_1_kneaddata_paired	Firmicutes_C	17613	P	155	0	155	0.00001
ERR3957908_1_kneaddata_paired	Campylobacterota	8700	P	110	0	110	0.00001
ERR3957908_1_kneaddata_paired	Firmicutes_I	18140	P	87	0	87	0.00001
ERR3957908_1_kneaddata_paired	Deferribacterota	10822	P	82	0	82	0.00000
ERR3957908_1_kneaddata_paired	Thermotogota	33086	P	29	0	29	0.00000
ERR3957908_1_kneaddata_paired	Elusimicrobiota	11888	P	16	0	16	0.00000
ERR3957909_1_kneaddata_paired	Firmicutes_A	14608	P	14972792	56597	15029389	0.61996
ERR3957909_1_kneaddata_paired	Bacteroidota	4587	P	5719150	7660	5726810	0.23623
ERR3957909_1_kneaddata_paired	Verrucomicrobiota	33333	P	2354107	64067	2418174	0.09975
ERR3957909_1_kneaddata_paired	Firmicutes	12188	P	547605	29929	577534	0.02382
ERR3957909_1_kneaddata_paired	Actinobacteriota	615	P	389939	149	390088	0.01609
ERR3957909_1_kneaddata_paired	Proteobacteria	22518	P	84044	862	84906	0.00350
ERR3957909_1_kneaddata_paired	Cyanobacteria	9876	P	7983	20	8003	0.00033
ERR3957909_1_kneaddata_paired	Desulfobacterota_A	11509	P	3032	203	3235	0.00013
ERR3957909_1_kneaddata_paired	Firmicutes_B	17289	P	2266	39	2305	0.00010
ERR3957909_1_kneaddata_paired	Spirochaetota	32587	P	1368	0	1368	0.00006
ERR3957909_1_kneaddata_paired	Firmicutes_I	18140	P	186	0	186	0.00001
ERR3957909_1_kneaddata_paired	Firmicutes_C	17613	P	182	0	182	0.00001
ERR3957909_1_kneaddata_paired	Campylobacterota	8700	P	128	0	128	0.00001
ERR3957909_1_kneaddata_paired	Elusimicrobiota	11888	P	30	0	30	0.00000
ERR3957909_1_kneaddata_paired	Deferribacterota	10822	P	25	0	25	0.00000
ERR3957909_1_kneaddata_paired	Thermotogota	33086	P	9	0	9	0.00000
ERR3957910_1_kneaddata_paired	Firmicutes_A	14608	P	10020339	43615	10063954	0.50481
ERR3957910_1_kneaddata_paired	Bacteroidota	4587	P	8921793	134581	9056374	0.45427
ERR3957910_1_kneaddata_paired	Firmicutes	12188	P	385753	4438	390191	0.01957
ERR3957910_1_kneaddata_paired	Verrucomicrobiota	33333	P	293746	16179	309925	0.01555
ERR3957910_1_kneaddata_paired	Actinobacteriota	615	P	54371	24	54395	0.00273
ERR3957910_1_kneaddata_paired	Proteobacteria	22518	P	50614	1049	51663	0.00259
ERR3957910_1_kneaddata_paired	Cyanobacteria	9876	P	5592	92	5684	0.00029
ERR3957910_1_kneaddata_paired	Firmicutes_B	17289	P	1248	44	1292	0.00006
ERR3957910_1_kneaddata_paired	Spirochaetota	32587	P	942	1	943	0.00005
ERR3957910_1_kneaddata_paired	Desulfobacterota_A	11509	P	735	80	815	0.00004
ERR3957910_1_kneaddata_paired	Campylobacterota	8700	P	346	0	346	0.00002
ERR3957910_1_kneaddata_paired	Firmicutes_I	18140	P	220	0	220	0.00001
ERR3957910_1_kneaddata_paired	Deferribacterota	10822	P	132	0	132	0.00001
ERR3957910_1_kneaddata_paired	Firmicutes_C	17613	P	68	0	68	0.00000
ERR3957910_1_kneaddata_paired	Thermotogota	33086	P	20	0	20	0.00000
ERR3957910_1_kneaddata_paired	Elusimicrobiota	11888	P	17	0	17	0.00000
ERR3957911_1_kneaddata_paired	Firmicutes_A	14608	P	14200722	53150	14253872	0.54501
ERR3957911_1_kneaddata_paired	Bacteroidota	4587	P	8294942	12914	8307856	0.31766
ERR3957911_1_kneaddata_paired	Verrucomicrobiota	33333	P	2549966	57324	2607290	0.09969
ERR3957911_1_kneaddata_paired	Firmicutes	12188	P	488894	19582	508476	0.01944
ERR3957911_1_kneaddata_paired	Actinobacteriota	615	P	453382	120	453502	0.01734
ERR3957911_1_kneaddata_paired	Proteobacteria	22518	P	8030	61	8091	0.00031
ERR3957911_1_kneaddata_paired	Cyanobacteria	9876	P	4850	14	4864	0.00019
ERR3957911_1_kneaddata_paired	Desulfobacterota_A	11509	P	4525	257	4782	0.00018
ERR3957911_1_kneaddata_paired	Firmicutes_B	17289	P	2887	41	2928	0.00011
ERR3957911_1_kneaddata_paired	Spirochaetota	32587	P	841	0	841	0.00003
ERR3957911_1_kneaddata_paired	Campylobacterota	8700	P	223	0	223	0.00001
ERR3957911_1_kneaddata_paired	Firmicutes_I	18140	P	206	0	206	0.00001
ERR3957911_1_kneaddata_paired	Firmicutes_C	17613	P	189	0	189	0.00001
ERR3957911_1_kneaddata_paired	Deferribacterota	10822	P	62	0	62	0.00000
ERR3957911_1_kneaddata_paired	Elusimicrobiota	11888	P	29	0	29	0.00000
ERR3957911_1_kneaddata_paired	Thermotogota	33086	P	15	0	15	0.00000
ERR3957912_1_kneaddata_paired	Firmicutes_A	14608	P	17997185	115328	18112513	0.82985
ERR3957912_1_kneaddata_paired	Bacteroidota	4587	P	3310874	75369	3386243	0.15514
ERR3957912_1_kneaddata_paired	Firmicutes	12188	P	183381	4599	187980	0.00861
ERR3957912_1_kneaddata_paired	Verrucomicrobiota	33333	P	67282	5841	73123	0.00335
ERR3957912_1_kneaddata_paired	Firmicutes_B	17289	P	27024	1502	28526	0.00131
ERR3957912_1_kneaddata_paired	Actinobacteriota	615	P	26459	20	26479	0.00121
ERR3957912_1_kneaddata_paired	Proteobacteria	22518	P	4963	140	5103	0.00023
ERR3957912_1_kneaddata_paired	Cyanobacteria	9876	P	2757	63	2820	0.00013
ERR3957912_1_kneaddata_paired	Desulfobacterota_A	11509	P	1860	390	2250	0.00010
ERR3957912_1_kneaddata_paired	Spirochaetota	32587	P	786	1	787	0.00004
ERR3957912_1_kneaddata_paired	Firmicutes_C	17613	P	138	0	138	0.00001
ERR3957912_1_kneaddata_paired	Firmicutes_I	18140	P	114	0	114	0.00001
ERR3957912_1_kneaddata_paired	Deferribacterota	10822	P	108	0	108	0.00000
ERR3957912_1_kneaddata_paired	Campylobacterota	8700	P	97	0	97	0.00000
ERR3957912_1_kneaddata_paired	Thermotogota	33086	P	18	0	18	0.00000
ERR3957912_1_kneaddata_paired	Elusimicrobiota	11888	P	13	0	13	0.00000
ERR3957913_1_kneaddata_paired	Bacteroidota	4587	P	15021581	26774	15048355	0.55975
ERR3957913_1_kneaddata_paired	Firmicutes_A	14608	P	8882509	34435	8916944	0.33168
ERR3957913_1_kneaddata_paired	Verrucomicrobiota	33333	P	2451187	66503	2517690	0.09365
ERR3957913_1_kneaddata_paired	Actinobacteriota	615	P	191364	115	191479	0.00712
ERR3957913_1_kneaddata_paired	Proteobacteria	22518	P	106460	1082	107542	0.00400
ERR3957913_1_kneaddata_paired	Firmicutes	12188	P	86161	2342	88503	0.00329
ERR3957913_1_kneaddata_paired	Cyanobacteria	9876	P	6356	14	6370	0.00024
ERR3957913_1_kneaddata_paired	Desulfobacterota_A	11509	P	3281	226	3507	0.00013
ERR3957913_1_kneaddata_paired	Firmicutes_B	17289	P	2320	40	2360	0.00009
ERR3957913_1_kneaddata_paired	Spirochaetota	32587	P	828	0	828	0.00003
ERR3957913_1_kneaddata_paired	Firmicutes_I	18140	P	224	0	224	0.00001
ERR3957913_1_kneaddata_paired	Firmicutes_C	17613	P	138	0	138	0.00001
ERR3957913_1_kneaddata_paired	Campylobacterota	8700	P	80	0	80	0.00000
ERR3957913_1_kneaddata_paired	Elusimicrobiota	11888	P	20	0	20	0.00000
ERR3957913_1_kneaddata_paired	Deferribacterota	10822	P	16	0	16	0.00000
ERR3957913_1_kneaddata_paired	Thermotogota	33086	P	7	0	7	0.00000
ERR3957914_1_kneaddata_paired	Firmicutes_A	14608	P	8617349	53696	8671045	0.46018
ERR3957914_1_kneaddata_paired	Bacteroidota	4587	P	7647463	143287	7790750	0.41347
ERR3957914_1_kneaddata_paired	Firmicutes	12188	P	1665525	22290	1687815	0.08957
ERR3957914_1_kneaddata_paired	Verrucomicrobiota	33333	P	521788	35933	557721	0.02960
ERR3957914_1_kneaddata_paired	Actinobacteriota	615	P	67293	56	67349	0.00357
ERR3957914_1_kneaddata_paired	Proteobacteria	22518	P	32611	809	33420	0.00177
ERR3957914_1_kneaddata_paired	Cyanobacteria	9876	P	20560	251	20811	0.00110
ERR3957914_1_kneaddata_paired	Campylobacterota	8700	P	6485	6	6491	0.00034
ERR3957914_1_kneaddata_paired	Spirochaetota	32587	P	2652	2	2654	0.00014
ERR3957914_1_kneaddata_paired	Firmicutes_I	18140	P	1747	0	1747	0.00009
ERR3957914_1_kneaddata_paired	Firmicutes_B	17289	P	1626	71	1697	0.00009
ERR3957914_1_kneaddata_paired	Desulfobacterota_A	11509	P	702	98	800	0.00004
ERR3957914_1_kneaddata_paired	Deferribacterota	10822	P	136	0	136	0.00001
ERR3957914_1_kneaddata_paired	Firmicutes_C	17613	P	53	0	53	0.00000
ERR3957914_1_kneaddata_paired	Thermotogota	33086	P	31	0	31	0.00000
ERR3957914_1_kneaddata_paired	Elusimicrobiota	11888	P	11	0	11	0.00000
ERR3957915_1_kneaddata_paired	Firmicutes_A	14608	P	11659646	25856	11685502	0.42389
ERR3957915_1_kneaddata_paired	Bacteroidota	4587	P	10356520	9149	10365669	0.37601
ERR3957915_1_kneaddata_paired	Verrucomicrobiota	33333	P	4449382	62534	4511916	0.16367
ERR3957915_1_kneaddata_paired	Firmicutes	12188	P	578714	15091	593805	0.02154
ERR3957915_1_kneaddata_paired	Actinobacteriota	615	P	311879	49	311928	0.01132
ERR3957915_1_kneaddata_paired	Proteobacteria	22518	P	88440	466	88906	0.00323
ERR3957915_1_kneaddata_paired	Desulfobacterota_A	11509	P	3773	131	3904	0.00014
ERR3957915_1_kneaddata_paired	Firmicutes_B	17289	P	2399	21	2420	0.00009
ERR3957915_1_kneaddata_paired	Cyanobacteria	9876	P	2327	3	2330	0.00008
ERR3957915_1_kneaddata_paired	Spirochaetota	32587	P	481	0	481	0.00002
ERR3957915_1_kneaddata_paired	Firmicutes_C	17613	P	242	0	242	0.00001
ERR3957915_1_kneaddata_paired	Firmicutes_I	18140	P	170	0	170	0.00001
ERR3957915_1_kneaddata_paired	Campylobacterota	8700	P	158	0	158	0.00001
ERR3957915_1_kneaddata_paired	Deferribacterota	10822	P	27	0	27	0.00000
ERR3957915_1_kneaddata_paired	Elusimicrobiota	11888	P	19	0	19	0.00000
ERR3957915_1_kneaddata_paired	Thermotogota	33086	P	17	0	17	0.00000
ERR3957916_1_kneaddata_paired	Firmicutes_A	14608	P	12790569	88470	12879039	0.89327
ERR3957916_1_kneaddata_paired	Bacteroidota	4587	P	1030011	21792	1051803	0.07295
ERR3957916_1_kneaddata_paired	Firmicutes	12188	P	436083	10831	446914	0.03100
ERR3957916_1_kneaddata_paired	Verrucomicrobiota	33333	P	15782	1432	17214	0.00119
ERR3957916_1_kneaddata_paired	Actinobacteriota	615	P	12838	14	12852	0.00089
ERR3957916_1_kneaddata_paired	Cyanobacteria	9876	P	3524	40	3564	0.00025
ERR3957916_1_kneaddata_paired	Proteobacteria	22518	P	2898	76	2974	0.00021
ERR3957916_1_kneaddata_paired	Spirochaetota	32587	P	1057	2	1059	0.00007
ERR3957916_1_kneaddata_paired	Firmicutes_B	17289	P	994	58	1052	0.00007
ERR3957916_1_kneaddata_paired	Desulfobacterota_A	11509	P	917	199	1116	0.00008
ERR3957916_1_kneaddata_paired	Firmicutes_I	18140	P	105	0	105	0.00001
ERR3957916_1_kneaddata_paired	Campylobacterota	8700	P	81	0	81	0.00001
ERR3957916_1_kneaddata_paired	Firmicutes_C	17613	P	50	0	50	0.00000
ERR3957916_1_kneaddata_paired	Deferribacterota	10822	P	47	0	47	0.00000
ERR3957916_1_kneaddata_paired	Thermotogota	33086	P	40	0	40	0.00000
ERR3957916_1_kneaddata_paired	Elusimicrobiota	11888	P	7	0	7	0.00000
ERR3957917_1_kneaddata_paired	Firmicutes_A	14608	P	13754086	35094	13789180	0.51138
ERR3957917_1_kneaddata_paired	Bacteroidota	4587	P	8378172	11163	8389335	0.31112
ERR3957917_1_kneaddata_paired	Verrucomicrobiota	33333	P	3446658	64512	3511170	0.13021
ERR3957917_1_kneaddata_paired	Firmicutes	12188	P	874529	36238	910767	0.03378
ERR3957917_1_kneaddata_paired	Actinobacteriota	615	P	302923	50	302973	0.01124
ERR3957917_1_kneaddata_paired	Proteobacteria	22518	P	47460	331	47791	0.00177
ERR3957917_1_kneaddata_paired	Desulfobacterota_A	11509	P	5705	277	5982	0.00022
ERR3957917_1_kneaddata_paired	Cyanobacteria	9876	P	3409	7	3416	0.00013
ERR3957917_1_kneaddata_paired	Firmicutes_B	17289	P	2876	34	2910	0.00011
ERR3957917_1_kneaddata_paired	Spirochaetota	32587	P	608	0	608	0.00002
ERR3957917_1_kneaddata_paired	Firmicutes_C	17613	P	212	0	212	0.00001
ERR3957917_1_kneaddata_paired	Firmicutes_I	18140	P	172	0	172	0.00001
ERR3957917_1_kneaddata_paired	Campylobacterota	8700	P	92	0	92	0.00000
ERR3957917_1_kneaddata_paired	Elusimicrobiota	11888	P	24	0	24	0.00000
ERR3957917_1_kneaddata_paired	Deferribacterota	10822	P	19	0	19	0.00000
ERR3957917_1_kneaddata_paired	Thermotogota	33086	P	16	0	16	0.00000
ERR3957918_1_kneaddata_paired	Firmicutes_A	14608	P	11540461	74768	11615229	0.89212
ERR3957918_1_kneaddata_paired	Bacteroidota	4587	P	1155347	39858	1195205	0.09180
ERR3957918_1_kneaddata_paired	Firmicutes	12188	P	157823	5302	163125	0.01253
ERR3957918_1_kneaddata_paired	Actinobacteriota	615	P	25319	14	25333	0.00195
ERR3957918_1_kneaddata_paired	Verrucomicrobiota	33333	P	10116	910	11026	0.00085
ERR3957918_1_kneaddata_paired	Proteobacteria	22518	P	3683	106	3789	0.00029
ERR3957918_1_kneaddata_paired	Cyanobacteria	9876	P	2995	40	3035	0.00023
ERR3957918_1_kneaddata_paired	Spirochaetota	32587	P	856	1	857	0.00007
ERR3957918_1_kneaddata_paired	Firmicutes_B	17289	P	852	49	901	0.00007
ERR3957918_1_kneaddata_paired	Desulfobacterota_A	11509	P	814	169	983	0.00008
ERR3957918_1_kneaddata_paired	Firmicutes_I	18140	P	125	0	125	0.00001
ERR3957918_1_kneaddata_paired	Campylobacterota	8700	P	114	0	114	0.00001
ERR3957918_1_kneaddata_paired	Firmicutes_C	17613	P	63	0	63	0.00000
ERR3957918_1_kneaddata_paired	Deferribacterota	10822	P	48	0	48	0.00000
ERR3957918_1_kneaddata_paired	Elusimicrobiota	11888	P	11	0	11	0.00000
ERR3957918_1_kneaddata_paired	Thermotogota	33086	P	2	0	2	0.00000
ERR3957919_1_kneaddata_paired	Firmicutes_A	14608	P	10551858	49293	10601151	0.51254
ERR3957919_1_kneaddata_paired	Bacteroidota	4587	P	8057085	21737	8078822	0.39059
ERR3957919_1_kneaddata_paired	Verrucomicrobiota	33333	P	1719311	67132	1786443	0.08637
ERR3957919_1_kneaddata_paired	Actinobacteriota	615	P	130275	13	130288	0.00630
ERR3957919_1_kneaddata_paired	Firmicutes	12188	P	50469	1237	51706	0.00250
ERR3957919_1_kneaddata_paired	Proteobacteria	22518	P	20942	305	21247	0.00103
ERR3957919_1_kneaddata_paired	Cyanobacteria	9876	P	5505	20	5525	0.00027
ERR3957919_1_kneaddata_paired	Firmicutes_B	17289	P	3946	98	4044	0.00020
ERR3957919_1_kneaddata_paired	Desulfobacterota_A	11509	P	2872	287	3159	0.00015
ERR3957919_1_kneaddata_paired	Spirochaetota	32587	P	739	0	739	0.00004
ERR3957919_1_kneaddata_paired	Firmicutes_I	18140	P	118	0	118	0.00001
ERR3957919_1_kneaddata_paired	Firmicutes_C	17613	P	77	0	77	0.00000
ERR3957919_1_kneaddata_paired	Campylobacterota	8700	P	29	0	29	0.00000
ERR3957919_1_kneaddata_paired	Elusimicrobiota	11888	P	18	0	18	0.00000
ERR3957919_1_kneaddata_paired	Deferribacterota	10822	P	7	0	7	0.00000
ERR3957919_1_kneaddata_paired	Thermotogota	33086	P	5	0	5	0.00000
ERR580745_kneaddata	Bacteroidota	4587	P	9201675	137001	9338676	0.66894
ERR580745_kneaddata	Firmicutes_A	14608	P	2582684	74391	2657075	0.19033
ERR580745_kneaddata	Firmicutes	12188	P	1353297	15277	1368574	0.09803
ERR580745_kneaddata	Actinobacteriota	615	P	317163	2089	319252	0.02287
ERR580745_kneaddata	Proteobacteria	22518	P	93665	1460	95125	0.00681
ERR580745_kneaddata	Desulfobacterota_A	11509	P	86397	276	86673	0.00621
ERR580745_kneaddata	Deferribacterota	10822	P	31390	400	31790	0.00228
ERR580745_kneaddata	Verrucomicrobiota	33333	P	29300	5141	34441	0.00247
ERR580745_kneaddata	Cyanobacteria	9876	P	25734	675	26409	0.00189
ERR580745_kneaddata	Firmicutes_B	17289	P	1402	186	1588	0.00011
ERR580745_kneaddata	Spirochaetota	32587	P	475	2	477	0.00003
ERR580745_kneaddata	Campylobacterota	8700	P	155	0	155	0.00001
ERR580745_kneaddata	Firmicutes_I	18140	P	38	0	38	0.00000
ERR580745_kneaddata	Firmicutes_C	17613	P	33	0	33	0.00000
ERR580745_kneaddata	Elusimicrobiota	11888	P	9	0	9	0.00000
ERR580745_kneaddata	Thermotogota	33086	P	6	0	6	0.00000
ERR580746_kneaddata	Bacteroidota	4587	P	7598802	127503	7726305	0.55906
ERR580746_kneaddata	Firmicutes_A	14608	P	4474505	82582	4557087	0.32974
ERR580746_kneaddata	Firmicutes	12188	P	1070559	16973	1087532	0.07869
ERR580746_kneaddata	Actinobacteriota	615	P	193937	1663	195600	0.01415
ERR580746_kneaddata	Desulfobacterota_A	11509	P	168885	955	169840	0.01229
ERR580746_kneaddata	Proteobacteria	22518	P	39795	853	40648	0.00294
ERR580746_kneaddata	Cyanobacteria	9876	P	17810	760	18570	0.00134
ERR580746_kneaddata	Deferribacterota	10822	P	17632	282	17914	0.00130
ERR580746_kneaddata	Verrucomicrobiota	33333	P	3325	721	4046	0.00029
ERR580746_kneaddata	Firmicutes_B	17289	P	1338	224	1562	0.00011
ERR580746_kneaddata	Spirochaetota	32587	P	654	2	656	0.00005
ERR580746_kneaddata	Campylobacterota	8700	P	125	0	125	0.00001
ERR580746_kneaddata	Firmicutes_C	17613	P	94	0	94	0.00001
ERR580746_kneaddata	Firmicutes_I	18140	P	52	0	52	0.00000
ERR580746_kneaddata	Elusimicrobiota	11888	P	14	0	14	0.00000
ERR580746_kneaddata	Thermotogota	33086	P	9	0	9	0.00000
ERR580842_kneaddata	Bacteroidota	4587	P	4747347	87326	4834673	0.56030
ERR580842_kneaddata	Firmicutes_A	14608	P	3255362	46305	3301667	0.38264
ERR580842_kneaddata	Firmicutes	12188	P	304706	5197	309903	0.03592
ERR580842_kneaddata	Proteobacteria	22518	P	49454	638	50092	0.00581
ERR580842_kneaddata	Deferribacterota	10822	P	41650	488	42138	0.00488
ERR580842_kneaddata	Actinobacteriota	615	P	31153	566	31719	0.00368
ERR580842_kneaddata	Desulfobacterota_A	11509	P	27851	231	28082	0.00325
ERR580842_kneaddata	Cyanobacteria	9876	P	20415	356	20771	0.00241
ERR580842_kneaddata	Verrucomicrobiota	33333	P	6268	999	7267	0.00084
ERR580842_kneaddata	Firmicutes_B	17289	P	1800	220	2020	0.00023
ERR580842_kneaddata	Spirochaetota	32587	P	156	0	156	0.00002
ERR580842_kneaddata	Campylobacterota	8700	P	88	0	88	0.00001
ERR580842_kneaddata	Firmicutes_I	18140	P	29	0	29	0.00000
ERR580842_kneaddata	Firmicutes_C	17613	P	25	0	25	0.00000
ERR580842_kneaddata	Elusimicrobiota	11888	P	16	0	16	0.00000
ERR580842_kneaddata	Thermotogota	33086	P	6	0	6	0.00000
ERR580843_kneaddata	Bacteroidota	4587	P	7738363	136194	7874557	0.50850
ERR580843_kneaddata	Firmicutes_A	14608	P	6522438	95947	6618385	0.42738
ERR580843_kneaddata	Firmicutes	12188	P	697961	10144	708105	0.04573
ERR580843_kneaddata	Actinobacteriota	615	P	74840	918	75758	0.00489
ERR580843_kneaddata	Desulfobacterota_A	11509	P	58480	552	59032	0.00381
ERR580843_kneaddata	Verrucomicrobiota	33333	P	57492	10160	67652	0.00437
ERR580843_kneaddata	Cyanobacteria	9876	P	31576	654	32230	0.00208
ERR580843_kneaddata	Proteobacteria	22518	P	30737	572	31309	0.00202
ERR580843_kneaddata	Deferribacterota	10822	P	16326	210	16536	0.00107
ERR580843_kneaddata	Firmicutes_B	17289	P	1635	220	1855	0.00012
ERR580843_kneaddata	Spirochaetota	32587	P	257	1	258	0.00002
ERR580843_kneaddata	Campylobacterota	8700	P	102	0	102	0.00001
ERR580843_kneaddata	Firmicutes_I	18140	P	88	0	88	0.00001
ERR580843_kneaddata	Firmicutes_C	17613	P	71	0	71	0.00000
ERR580843_kneaddata	Elusimicrobiota	11888	P	19	0	19	0.00000
ERR580843_kneaddata	Thermotogota	33086	P	12	0	12	0.00000
ERR580844_kneaddata	Firmicutes_A	14608	P	8503399	75674	8579073	0.63180
ERR580844_kneaddata	Bacteroidota	4587	P	4078049	28788	4106837	0.30245
ERR580844_kneaddata	Firmicutes	12188	P	499386	98399	597785	0.04402
ERR580844_kneaddata	Deferribacterota	10822	P	192754	1164	193918	0.01428
ERR580844_kneaddata	Actinobacteriota	615	P	60938	434	61372	0.00452
ERR580844_kneaddata	Firmicutes_B	17289	P	23766	1497	25263	0.00186
ERR580844_kneaddata	Proteobacteria	22518	P	5412	23	5435	0.00040
ERR580844_kneaddata	Verrucomicrobiota	33333	P	3803	332	4135	0.00030
ERR580844_kneaddata	Desulfobacterota_A	11509	P	2364	361	2725	0.00020
ERR580844_kneaddata	Cyanobacteria	9876	P	1476	119	1595	0.00012
ERR580844_kneaddata	Spirochaetota	32587	P	296	2	298	0.00002
ERR580844_kneaddata	Campylobacterota	8700	P	93	0	93	0.00001
ERR580844_kneaddata	Firmicutes_C	17613	P	83	0	83	0.00001
ERR580844_kneaddata	Firmicutes_I	18140	P	66	0	66	0.00000
ERR580844_kneaddata	Elusimicrobiota	11888	P	12	0	12	0.00000
ERR580844_kneaddata	Thermotogota	33086	P	7	0	7	0.00000
ERR580845_kneaddata	Bacteroidota	4587	P	7078655	74970	7153625	0.75620
ERR580845_kneaddata	Firmicutes_A	14608	P	1573526	22144	1595670	0.16868
ERR580845_kneaddata	Firmicutes	12188	P	559791	28487	588278	0.06219
ERR580845_kneaddata	Firmicutes_B	17289	P	45666	2783	48449	0.00512
ERR580845_kneaddata	Deferribacterota	10822	P	32309	188	32497	0.00344
ERR580845_kneaddata	Proteobacteria	22518	P	18279	47	18326	0.00194
ERR580845_kneaddata	Actinobacteriota	615	P	17971	191	18162	0.00192
ERR580845_kneaddata	Cyanobacteria	9876	P	2821	171	2992	0.00032
ERR580845_kneaddata	Desulfobacterota_A	11509	P	1155	63	1218	0.00013
ERR580845_kneaddata	Verrucomicrobiota	33333	P	340	27	367	0.00004
ERR580845_kneaddata	Spirochaetota	32587	P	226	1	227	0.00002
ERR580845_kneaddata	Campylobacterota	8700	P	78	0	78	0.00001
ERR580845_kneaddata	Firmicutes_C	17613	P	27	0	27	0.00000
ERR580845_kneaddata	Firmicutes_I	18140	P	26	0	26	0.00000
ERR580845_kneaddata	Thermotogota	33086	P	9	0	9	0.00000
ERR580845_kneaddata	Elusimicrobiota	11888	P	2	0	2	0.00000
ERR580846_kneaddata	Firmicutes_A	14608	P	5910416	36306	5946722	0.45949
ERR580846_kneaddata	Bacteroidota	4587	P	5771739	71392	5843131	0.45149
ERR580846_kneaddata	Firmicutes	12188	P	974100	85841	1059941	0.08190
ERR580846_kneaddata	Actinobacteriota	615	P	68021	404	68425	0.00529
ERR580846_kneaddata	Proteobacteria	22518	P	10467	24	10491	0.00081
ERR580846_kneaddata	Firmicutes_B	17289	P	7256	336	7592	0.00059
ERR580846_kneaddata	Cyanobacteria	9876	P	2454	99	2553	0.00020
ERR580846_kneaddata	Desulfobacterota_A	11509	P	1069	132	1201	0.00009
ERR580846_kneaddata	Verrucomicrobiota	33333	P	889	59	948	0.00007
ERR580846_kneaddata	Deferribacterota	10822	P	453	1	454	0.00004
ERR580846_kneaddata	Spirochaetota	32587	P	296	1	297	0.00002
ERR580846_kneaddata	Campylobacterota	8700	P	44	0	44	0.00000
ERR580846_kneaddata	Firmicutes_I	18140	P	36	0	36	0.00000
ERR580846_kneaddata	Firmicutes_C	17613	P	30	0	30	0.00000
ERR580846_kneaddata	Thermotogota	33086	P	16	0	16	0.00000
ERR580846_kneaddata	Elusimicrobiota	11888	P	4	0	4	0.00000
ERR580847_kneaddata	Bacteroidota	4587	P	6532675	68684	6601359	0.67614
ERR580847_kneaddata	Firmicutes_A	14608	P	2249809	23879	2273688	0.23288
ERR580847_kneaddata	Firmicutes	12188	P	632125	63545	695670	0.07125
ERR580847_kneaddata	Actinobacteriota	615	P	128294	447	128741	0.01319
ERR580847_kneaddata	Deferribacterota	10822	P	28533	203	28736	0.00294
ERR580847_kneaddata	Proteobacteria	22518	P	15625	65	15690	0.00161
ERR580847_kneaddata	Firmicutes_B	17289	P	12971	965	13936	0.00143
ERR580847_kneaddata	Cyanobacteria	9876	P	2484	295	2779	0.00028
ERR580847_kneaddata	Desulfobacterota_A	11509	P	1659	82	1741	0.00018
ERR580847_kneaddata	Spirochaetota	32587	P	402	3	405	0.00004
ERR580847_kneaddata	Verrucomicrobiota	33333	P	383	40	423	0.00004
ERR580847_kneaddata	Campylobacterota	8700	P	72	0	72	0.00001
ERR580847_kneaddata	Firmicutes_I	18140	P	30	0	30	0.00000
ERR580847_kneaddata	Firmicutes_C	17613	P	23	0	23	0.00000
ERR580847_kneaddata	Thermotogota	33086	P	8	0	8	0.00000
ERR580847_kneaddata	Elusimicrobiota	11888	P	4	0	4	0.00000
ERR580894_kneaddata	Bacteroidota	4587	P	9364514	140013	9504527	0.70990
ERR580894_kneaddata	Firmicutes_A	14608	P	3286632	59764	3346396	0.24994
ERR580894_kneaddata	Firmicutes	12188	P	239665	5404	245069	0.01830
ERR580894_kneaddata	Verrucomicrobiota	33333	P	108242	19408	127650	0.00953
ERR580894_kneaddata	Desulfobacterota_A	11509	P	39675	251	39926	0.00298
ERR580894_kneaddata	Deferribacterota	10822	P	39508	517	40025	0.00299
ERR580894_kneaddata	Proteobacteria	22518	P	32901	662	33563	0.00251
ERR580894_kneaddata	Cyanobacteria	9876	P	28585	707	29292	0.00219
ERR580894_kneaddata	Actinobacteriota	615	P	20822	285	21107	0.00158
ERR580894_kneaddata	Firmicutes_B	17289	P	590	80	670	0.00005
ERR580894_kneaddata	Spirochaetota	32587	P	175	0	175	0.00001
ERR580894_kneaddata	Campylobacterota	8700	P	76	0	76	0.00001
ERR580894_kneaddata	Firmicutes_C	17613	P	36	0	36	0.00000
ERR580894_kneaddata	Firmicutes_I	18140	P	35	0	35	0.00000
ERR580894_kneaddata	Thermotogota	33086	P	9	0	9	0.00000
ERR580894_kneaddata	Elusimicrobiota	11888	P	6	0	6	0.00000
ERR580895_kneaddata	Bacteroidota	4587	P	9705525	136825	9842350	0.76119
ERR580895_kneaddata	Firmicutes_A	14608	P	2284702	55983	2340685	0.18102
ERR580895_kneaddata	Firmicutes	12188	P	371007	6790	377797	0.02922
ERR580895_kneaddata	Verrucomicrobiota	33333	P	106810	17759	124569	0.00963
ERR580895_kneaddata	Proteobacteria	22518	P	80070	1781	81851	0.00633
ERR580895_kneaddata	Cyanobacteria	9876	P	79433	1576	81009	0.00627
ERR580895_kneaddata	Desulfobacterota_A	11509	P	28418	117	28535	0.00221
ERR580895_kneaddata	Deferribacterota	10822	P	26111	319	26430	0.00204
ERR580895_kneaddata	Actinobacteriota	615	P	25760	283	26043	0.00201
ERR580895_kneaddata	Firmicutes_B	17289	P	561	71	632	0.00005
ERR580895_kneaddata	Spirochaetota	32587	P	177	0	177	0.00001
ERR580895_kneaddata	Campylobacterota	8700	P	118	0	118	0.00001
ERR580895_kneaddata	Firmicutes_I	18140	P	38	0	38	0.00000
ERR580895_kneaddata	Firmicutes_C	17613	P	35	0	35	0.00000
ERR580895_kneaddata	Thermotogota	33086	P	10	0	10	0.00000
ERR580895_kneaddata	Elusimicrobiota	11888	P	5	0	5	0.00000
ERR580896_kneaddata	Bacteroidota	4587	P	6754775	126195	6880970	0.55754
ERR580896_kneaddata	Firmicutes_A	14608	P	4839383	81131	4920514	0.39869
ERR580896_kneaddata	Firmicutes	12188	P	234809	5561	240370	0.01948
ERR580896_kneaddata	Deferribacterota	10822	P	143035	1986	145021	0.01175
ERR580896_kneaddata	Proteobacteria	22518	P	56669	1140	57809	0.00468
ERR580896_kneaddata	Desulfobacterota_A	11509	P	44339	751	45090	0.00365
ERR580896_kneaddata	Cyanobacteria	9876	P	37104	952	38056	0.00308
ERR580896_kneaddata	Actinobacteriota	615	P	8308	215	8523	0.00069
ERR580896_kneaddata	Verrucomicrobiota	33333	P	3526	657	4183	0.00034
ERR580896_kneaddata	Firmicutes_B	17289	P	652	94	746	0.00006
ERR580896_kneaddata	Spirochaetota	32587	P	190	1	191	0.00002
ERR580896_kneaddata	Campylobacterota	8700	P	100	0	100	0.00001
ERR580896_kneaddata	Firmicutes_I	18140	P	52	0	52	0.00000
ERR580896_kneaddata	Firmicutes_C	17613	P	44	0	44	0.00000
ERR580896_kneaddata	Elusimicrobiota	11888	P	10	0	10	0.00000
ERR580896_kneaddata	Thermotogota	33086	P	4	0	4	0.00000
ERR580897_kneaddata	Bacteroidota	4587	P	7437389	106026	7543415	0.71279
ERR580897_kneaddata	Firmicutes_A	14608	P	2512911	47574	2560485	0.24194
ERR580897_kneaddata	Firmicutes	12188	P	356002	7413	363415	0.03434
ERR580897_kneaddata	Deferribacterota	10822	P	41200	538	41738	0.00394
ERR580897_kneaddata	Proteobacteria	22518	P	23136	476	23612	0.00223
ERR580897_kneaddata	Desulfobacterota_A	11509	P	19508	112	19620	0.00185
ERR580897_kneaddata	Cyanobacteria	9876	P	17164	532	17696	0.00167
ERR580897_kneaddata	Actinobacteriota	615	P	9024	196	9220	0.00087
ERR580897_kneaddata	Verrucomicrobiota	33333	P	2459	430	2889	0.00027
ERR580897_kneaddata	Firmicutes_B	17289	P	430	58	488	0.00005
ERR580897_kneaddata	Spirochaetota	32587	P	173	1	174	0.00002
ERR580897_kneaddata	Campylobacterota	8700	P	89	0	89	0.00001
ERR580897_kneaddata	Firmicutes_I	18140	P	39	0	39	0.00000
ERR580897_kneaddata	Firmicutes_C	17613	P	31	0	31	0.00000
ERR580897_kneaddata	Thermotogota	33086	P	18	0	18	0.00000
ERR580897_kneaddata	Elusimicrobiota	11888	P	9	0	9	0.00000
ERR580898_kneaddata	Firmicutes_A	14608	P	7059435	69412	7128847	0.49204
ERR580898_kneaddata	Bacteroidota	4587	P	4923135	76059	4999194	0.34505
ERR580898_kneaddata	Firmicutes	12188	P	863079	61963	925042	0.06385
ERR580898_kneaddata	Deferribacterota	10822	P	554380	5205	559585	0.03862
ERR580898_kneaddata	Actinobacteriota	615	P	303660	1553	305213	0.02107
ERR580898_kneaddata	Verrucomicrobiota	33333	P	228498	29360	257858	0.01780
ERR580898_kneaddata	Desulfobacterota_A	11509	P	220409	1031	221440	0.01528
ERR580898_kneaddata	Proteobacteria	22518	P	63468	1209	64677	0.00446
ERR580898_kneaddata	Cyanobacteria	9876	P	23270	334	23604	0.00163
ERR580898_kneaddata	Firmicutes_B	17289	P	1450	141	1591	0.00011
ERR580898_kneaddata	Spirochaetota	32587	P	823	2	825	0.00006
ERR580898_kneaddata	Campylobacterota	8700	P	216	0	216	0.00001
ERR580898_kneaddata	Firmicutes_I	18140	P	83	0	83	0.00001
ERR580898_kneaddata	Firmicutes_C	17613	P	79	0	79	0.00001
ERR580898_kneaddata	Thermotogota	33086	P	26	0	26	0.00000
ERR580898_kneaddata	Elusimicrobiota	11888	P	14	0	14	0.00000
ERR580899_kneaddata	Bacteroidota	4587	P	7791585	79047	7870632	0.56409
ERR580899_kneaddata	Firmicutes_A	14608	P	3613835	37317	3651152	0.26168
ERR580899_kneaddata	Firmicutes	12188	P	1209208	56587	1265795	0.09072
ERR580899_kneaddata	Verrucomicrobiota	33333	P	530278	62411	592689	0.04248
ERR580899_kneaddata	Actinobacteriota	615	P	306997	1231	308228	0.02209
ERR580899_kneaddata	Desulfobacterota_A	11509	P	117448	410	117858	0.00845
ERR580899_kneaddata	Proteobacteria	22518	P	91430	2390	93820	0.00672
ERR580899_kneaddata	Deferribacterota	10822	P	32842	281	33123	0.00237
ERR580899_kneaddata	Cyanobacteria	9876	P	15871	246	16117	0.00116
ERR580899_kneaddata	Firmicutes_B	17289	P	2456	220	2676	0.00019
ERR580899_kneaddata	Spirochaetota	32587	P	447	1	448	0.00003
ERR580899_kneaddata	Campylobacterota	8700	P	86	0	86	0.00001
ERR580899_kneaddata	Firmicutes_C	17613	P	70	0	70	0.00001
ERR580899_kneaddata	Firmicutes_I	18140	P	63	0	63	0.00000
ERR580899_kneaddata	Elusimicrobiota	11888	P	6	0	6	0.00000
ERR580899_kneaddata	Thermotogota	33086	P	3	0	3	0.00000
ERR580900_kneaddata	Bacteroidota	4587	P	8494397	139623	8634020	0.58571
ERR580900_kneaddata	Firmicutes_A	14608	P	3938904	48785	3987689	0.27051
ERR580900_kneaddata	Firmicutes	12188	P	1468661	46858	1515519	0.10281
ERR580900_kneaddata	Actinobacteriota	615	P	286306	1676	287982	0.01954
ERR580900_kneaddata	Desulfobacterota_A	11509	P	168883	748	169631	0.01151
ERR580900_kneaddata	Proteobacteria	22518	P	57287	1792	59079	0.00401
ERR580900_kneaddata	Verrucomicrobiota	33333	P	53707	9561	63268	0.00429
ERR580900_kneaddata	Deferribacterota	10822	P	13121	169	13290	0.00090
ERR580900_kneaddata	Cyanobacteria	9876	P	8460	367	8827	0.00060
ERR580900_kneaddata	Firmicutes_B	17289	P	914	123	1037	0.00007
ERR580900_kneaddata	Spirochaetota	32587	P	650	1	651	0.00004
ERR580900_kneaddata	Campylobacterota	8700	P	73	0	73	0.00000
ERR580900_kneaddata	Firmicutes_I	18140	P	60	0	60	0.00000
ERR580900_kneaddata	Firmicutes_C	17613	P	34	0	34	0.00000
ERR580900_kneaddata	Thermotogota	33086	P	9	0	9	0.00000
ERR580900_kneaddata	Elusimicrobiota	11888	P	7	0	7	0.00000
ERR580901_kneaddata	Bacteroidota	4587	P	7115645	102152	7217797	0.49407
ERR580901_kneaddata	Firmicutes_A	14608	P	5277572	56873	5334445	0.36515
ERR580901_kneaddata	Firmicutes	12188	P	1136416	59111	1195527	0.08184
ERR580901_kneaddata	Desulfobacterota_A	11509	P	360559	1072	361631	0.02475
ERR580901_kneaddata	Actinobacteriota	615	P	234469	1303	235772	0.01614
ERR580901_kneaddata	Verrucomicrobiota	33333	P	124809	18482	143291	0.00981
ERR580901_kneaddata	Deferribacterota	10822	P	50416	543	50959	0.00349
ERR580901_kneaddata	Cyanobacteria	9876	P	33381	335	33716	0.00231
ERR580901_kneaddata	Proteobacteria	22518	P	32037	995	33032	0.00226
ERR580901_kneaddata	Spirochaetota	32587	P	1503	3	1506	0.00010
ERR580901_kneaddata	Firmicutes_B	17289	P	795	89	884	0.00006
ERR580901_kneaddata	Firmicutes_C	17613	P	101	0	101	0.00001
ERR580901_kneaddata	Campylobacterota	8700	P	97	0	97	0.00001
ERR580901_kneaddata	Firmicutes_I	18140	P	75	0	75	0.00001
ERR580901_kneaddata	Thermotogota	33086	P	11	0	11	0.00000
ERR580901_kneaddata	Elusimicrobiota	11888	P	9	0	9	0.00000
ERR580903_kneaddata	Bacteroidota	4587	P	7114660	118569	7233229	0.53988
ERR580903_kneaddata	Firmicutes_A	14608	P	3680232	66509	3746741	0.27965
ERR580903_kneaddata	Firmicutes	12188	P	1853023	25845	1878868	0.14024
ERR580903_kneaddata	Actinobacteriota	615	P	284931	2660	287591	0.02147
ERR580903_kneaddata	Desulfobacterota_A	11509	P	74236	436	74672	0.00557
ERR580903_kneaddata	Verrucomicrobiota	33333	P	66379	14116	80495	0.00601
ERR580903_kneaddata	Proteobacteria	22518	P	42758	1092	43850	0.00327
ERR580903_kneaddata	Cyanobacteria	9876	P	26197	752	26949	0.00201
ERR580903_kneaddata	Deferribacterota	10822	P	23456	365	23821	0.00178
ERR580903_kneaddata	Firmicutes_B	17289	P	916	149	1065	0.00008
ERR580903_kneaddata	Spirochaetota	32587	P	372	1	373	0.00003
ERR580903_kneaddata	Campylobacterota	8700	P	106	0	106	0.00001
ERR580903_kneaddata	Firmicutes_C	17613	P	63	0	63	0.00000
ERR580903_kneaddata	Firmicutes_I	18140	P	54	0	54	0.00000
ERR580903_kneaddata	Thermotogota	33086	P	17	0	17	0.00000
ERR580903_kneaddata	Elusimicrobiota	11888	P	14	0	14	0.00000
ERR580904_kneaddata	Bacteroidota	4587	P	6447573	92684	6540257	0.57164
ERR580904_kneaddata	Firmicutes_A	14608	P	3351411	60353	3411764	0.29820
ERR580904_kneaddata	Firmicutes	12188	P	1004676	16033	1020709	0.08921
ERR580904_kneaddata	Actinobacteriota	615	P	176799	1908	178707	0.01562
ERR580904_kneaddata	Verrucomicrobiota	33333	P	99914	20625	120539	0.01054
ERR580904_kneaddata	Desulfobacterota_A	11509	P	68531	407	68938	0.00603
ERR580904_kneaddata	Proteobacteria	22518	P	43131	945	44076	0.00385
ERR580904_kneaddata	Cyanobacteria	9876	P	40132	807	40939	0.00358
ERR580904_kneaddata	Deferribacterota	10822	P	7516	112	7628	0.00067
ERR580904_kneaddata	Firmicutes_B	17289	P	6080	955	7035	0.00061
ERR580904_kneaddata	Spirochaetota	32587	P	330	1	331	0.00003
ERR580904_kneaddata	Campylobacterota	8700	P	135	0	135	0.00001
ERR580904_kneaddata	Firmicutes_I	18140	P	58	0	58	0.00001
ERR580904_kneaddata	Firmicutes_C	17613	P	48	0	48	0.00000
ERR580904_kneaddata	Elusimicrobiota	11888	P	8	0	8	0.00000
ERR580904_kneaddata	Thermotogota	33086	P	8	0	8	0.00000
ERR580906_kneaddata	Bacteroidota	4587	P	7044880	114057	7158937	0.59406
ERR580906_kneaddata	Firmicutes_A	14608	P	3506976	76284	3583260	0.29734
ERR580906_kneaddata	Firmicutes	12188	P	893064	11652	904716	0.07507
ERR580906_kneaddata	Actinobacteriota	615	P	116105	867	116972	0.00971
ERR580906_kneaddata	Verrucomicrobiota	33333	P	109160	20694	129854	0.01078
ERR580906_kneaddata	Proteobacteria	22518	P	74248	1727	75975	0.00630
ERR580906_kneaddata	Desulfobacterota_A	11509	P	42809	343	43152	0.00358
ERR580906_kneaddata	Cyanobacteria	9876	P	29320	687	30007	0.00249
ERR580906_kneaddata	Deferribacterota	10822	P	6331	87	6418	0.00053
ERR580906_kneaddata	Firmicutes_B	17289	P	909	131	1040	0.00009
ERR580906_kneaddata	Spirochaetota	32587	P	285	1	286	0.00002
ERR580906_kneaddata	Campylobacterota	8700	P	120	0	120	0.00001
ERR580906_kneaddata	Firmicutes_I	18140	P	62	0	62	0.00001
ERR580906_kneaddata	Firmicutes_C	17613	P	45	0	45	0.00000
ERR580906_kneaddata	Elusimicrobiota	11888	P	12	0	12	0.00000
ERR580906_kneaddata	Thermotogota	33086	P	9	0	9	0.00000
ERR580907_kneaddata	Bacteroidota	4587	P	12964926	168862	13133788	0.81090
ERR580907_kneaddata	Firmicutes_A	14608	P	1687250	37710	1724960	0.10650
ERR580907_kneaddata	Verrucomicrobiota	33333	P	602633	85566	688199	0.04249
ERR580907_kneaddata	Firmicutes	12188	P	331269	3482	334751	0.02067
ERR580907_kneaddata	Proteobacteria	22518	P	237529	3830	241359	0.01490
ERR580907_kneaddata	Cyanobacteria	9876	P	31946	571	32517	0.00201
ERR580907_kneaddata	Actinobacteriota	615	P	17798	140	17938	0.00111
ERR580907_kneaddata	Deferribacterota	10822	P	13976	144	14120	0.00087
ERR580907_kneaddata	Desulfobacterota_A	11509	P	8308	114	8422	0.00052
ERR580907_kneaddata	Firmicutes_B	17289	P	222	24	246	0.00002
ERR580907_kneaddata	Campylobacterota	8700	P	165	0	165	0.00001
ERR580907_kneaddata	Spirochaetota	32587	P	105	0	105	0.00001
ERR580907_kneaddata	Firmicutes_C	17613	P	33	0	33	0.00000
ERR580907_kneaddata	Firmicutes_I	18140	P	31	0	31	0.00000
ERR580907_kneaddata	Thermotogota	33086	P	10	0	10	0.00000
ERR580907_kneaddata	Elusimicrobiota	11888	P	6	0	6	0.00000
ERR580908_kneaddata	Bacteroidota	4587	P	12410668	224649	12635317	0.88459
ERR580908_kneaddata	Firmicutes_A	14608	P	1125342	42403	1167745	0.08175
ERR580908_kneaddata	Firmicutes	12188	P	295192	6895	302087	0.02115
ERR580908_kneaddata	Proteobacteria	22518	P	114189	2427	116616	0.00816
ERR580908_kneaddata	Actinobacteriota	615	P	19927	204	20131	0.00141
ERR580908_kneaddata	Cyanobacteria	9876	P	19193	523	19716	0.00138
ERR580908_kneaddata	Deferribacterota	10822	P	11978	174	12152	0.00085
ERR580908_kneaddata	Desulfobacterota_A	11509	P	7561	128	7689	0.00054
ERR580908_kneaddata	Firmicutes_B	17289	P	1032	156	1188	0.00008
ERR580908_kneaddata	Verrucomicrobiota	33333	P	650	122	772	0.00005
ERR580908_kneaddata	Campylobacterota	8700	P	131	0	131	0.00001
ERR580908_kneaddata	Spirochaetota	32587	P	128	1	129	0.00001
ERR580908_kneaddata	Firmicutes_I	18140	P	36	0	36	0.00000
ERR580908_kneaddata	Firmicutes_C	17613	P	27	0	27	0.00000
ERR580908_kneaddata	Elusimicrobiota	11888	P	9	0	9	0.00000
ERR580908_kneaddata	Thermotogota	33086	P	4	0	4	0.00000
ERR580909_kneaddata	Bacteroidota	4587	P	9898392	170060	10068452	0.69485
ERR580909_kneaddata	Firmicutes_A	14608	P	2063411	51992	2115403	0.14599
ERR580909_kneaddata	Firmicutes	12188	P	1866123	27812	1893935	0.13070
ERR580909_kneaddata	Actinobacteriota	615	P	276973	1653	278626	0.01923
ERR580909_kneaddata	Verrucomicrobiota	33333	P	42115	7127	49242	0.00340
ERR580909_kneaddata	Proteobacteria	22518	P	29033	638	29671	0.00205
ERR580909_kneaddata	Desulfobacterota_A	11509	P	19984	175	20159	0.00139
ERR580909_kneaddata	Firmicutes_B	17289	P	14555	1887	16442	0.00113
ERR580909_kneaddata	Deferribacterota	10822	P	10539	131	10670	0.00074
ERR580909_kneaddata	Cyanobacteria	9876	P	6857	363	7220	0.00050
ERR580909_kneaddata	Spirochaetota	32587	P	188	1	189	0.00001
ERR580909_kneaddata	Campylobacterota	8700	P	93	0	93	0.00001
ERR580909_kneaddata	Firmicutes_C	17613	P	41	0	41	0.00000
ERR580909_kneaddata	Firmicutes_I	18140	P	39	0	39	0.00000
ERR580909_kneaddata	Elusimicrobiota	11888	P	7	0	7	0.00000
ERR580909_kneaddata	Thermotogota	33086	P	6	0	6	0.00000
ERR580910_kneaddata	Bacteroidota	4587	P	12237976	200265	12438241	0.84415
ERR580910_kneaddata	Firmicutes_A	14608	P	1580570	37017	1617587	0.10978
ERR580910_kneaddata	Firmicutes	12188	P	306469	3487	309956	0.02104
ERR580910_kneaddata	Verrucomicrobiota	33333	P	171904	27254	199158	0.01352
ERR580910_kneaddata	Proteobacteria	22518	P	89268	1708	90976	0.00617
ERR580910_kneaddata	Cyanobacteria	9876	P	24367	690	25057	0.00170
ERR580910_kneaddata	Deferribacterota	10822	P	24111	278	24389	0.00166
ERR580910_kneaddata	Desulfobacterota_A	11509	P	16943	142	17085	0.00116
ERR580910_kneaddata	Actinobacteriota	615	P	10952	119	11071	0.00075
ERR580910_kneaddata	Firmicutes_B	17289	P	562	68	630	0.00004
ERR580910_kneaddata	Spirochaetota	32587	P	192	1	193	0.00001
ERR580910_kneaddata	Campylobacterota	8700	P	129	0	129	0.00001
ERR580910_kneaddata	Firmicutes_C	17613	P	40	0	40	0.00000
ERR580910_kneaddata	Firmicutes_I	18140	P	35	0	35	0.00000
ERR580910_kneaddata	Elusimicrobiota	11888	P	16	0	16	0.00000
ERR580910_kneaddata	Thermotogota	33086	P	4	0	4	0.00000
ERR675498_1_kneaddata_paired	Bacteroidota	4587	P	6270520	30276	6300796	0.45271
ERR675498_1_kneaddata_paired	Firmicutes_A	14608	P	5386698	12329	5399027	0.38792
ERR675498_1_kneaddata_paired	Verrucomicrobiota	33333	P	847891	14456	862347	0.06196
ERR675498_1_kneaddata_paired	Proteobacteria	22518	P	678890	766	679656	0.04883
ERR675498_1_kneaddata_paired	Firmicutes	12188	P	513510	8486	521996	0.03750
ERR675498_1_kneaddata_paired	Desulfobacterota_A	11509	P	139070	329	139399	0.01002
ERR675498_1_kneaddata_paired	Actinobacteriota	615	P	12278	7	12285	0.00088
ERR675498_1_kneaddata_paired	Cyanobacteria	9876	P	1201	7	1208	0.00009
ERR675498_1_kneaddata_paired	Spirochaetota	32587	P	589	0	589	0.00004
ERR675498_1_kneaddata_paired	Firmicutes_B	17289	P	398	4	402	0.00003
ERR675498_1_kneaddata_paired	Campylobacterota	8700	P	147	0	147	0.00001
ERR675498_1_kneaddata_paired	Deferribacterota	10822	P	62	0	62	0.00000
ERR675498_1_kneaddata_paired	Firmicutes_C	17613	P	55	0	55	0.00000
ERR675498_1_kneaddata_paired	Firmicutes_I	18140	P	52	0	52	0.00000
ERR675498_1_kneaddata_paired	Thermotogota	33086	P	13	0	13	0.00000
ERR675498_1_kneaddata_paired	Elusimicrobiota	11888	P	3	0	3	0.00000
ERR675499_1_kneaddata_paired	Firmicutes_A	14608	P	8661996	41975	8703971	0.61831
ERR675499_1_kneaddata_paired	Bacteroidota	4587	P	3494911	42121	3537032	0.25126
ERR675499_1_kneaddata_paired	Firmicutes	12188	P	1661135	13065	1674200	0.11893
ERR675499_1_kneaddata_paired	Actinobacteriota	615	P	77314	105	77419	0.00550
ERR675499_1_kneaddata_paired	Desulfobacterota_A	11509	P	48625	830	49455	0.00351
ERR675499_1_kneaddata_paired	Proteobacteria	22518	P	22731	60	22791	0.00162
ERR675499_1_kneaddata_paired	Verrucomicrobiota	33333	P	8641	352	8993	0.00064
ERR675499_1_kneaddata_paired	Cyanobacteria	9876	P	864	5	869	0.00006
ERR675499_1_kneaddata_paired	Firmicutes_B	17289	P	843	21	864	0.00006
ERR675499_1_kneaddata_paired	Spirochaetota	32587	P	521	0	521	0.00004
ERR675499_1_kneaddata_paired	Campylobacterota	8700	P	450	0	450	0.00003
ERR675499_1_kneaddata_paired	Deferribacterota	10822	P	173	0	173	0.00001
ERR675499_1_kneaddata_paired	Firmicutes_C	17613	P	107	0	107	0.00001
ERR675499_1_kneaddata_paired	Firmicutes_I	18140	P	42	0	42	0.00000
ERR675499_1_kneaddata_paired	Thermotogota	33086	P	25	0	25	0.00000
ERR675499_1_kneaddata_paired	Elusimicrobiota	11888	P	4	0	4	0.00000
ERR675500_1_kneaddata_paired	Bacteroidota	4587	P	10838729	35059	10873788	0.60699
ERR675500_1_kneaddata_paired	Firmicutes_A	14608	P	5176835	10754	5187589	0.28958
ERR675500_1_kneaddata_paired	Verrucomicrobiota	33333	P	761262	11863	773125	0.04316
ERR675500_1_kneaddata_paired	Firmicutes	12188	P	569547	18519	588066	0.03283
ERR675500_1_kneaddata_paired	Proteobacteria	22518	P	230054	284	230338	0.01286
ERR675500_1_kneaddata_paired	Firmicutes_B	17289	P	158185	1519	159704	0.00892
ERR675500_1_kneaddata_paired	Desulfobacterota_A	11509	P	87721	199	87920	0.00491
ERR675500_1_kneaddata_paired	Actinobacteriota	615	P	10243	5	10248	0.00057
ERR675500_1_kneaddata_paired	Cyanobacteria	9876	P	2179	8	2187	0.00012
ERR675500_1_kneaddata_paired	Spirochaetota	32587	P	742	0	742	0.00004
ERR675500_1_kneaddata_paired	Campylobacterota	8700	P	262	0	262	0.00001
ERR675500_1_kneaddata_paired	Deferribacterota	10822	P	82	0	82	0.00000
ERR675500_1_kneaddata_paired	Firmicutes_C	17613	P	49	0	49	0.00000
ERR675500_1_kneaddata_paired	Firmicutes_I	18140	P	32	0	32	0.00000
ERR675500_1_kneaddata_paired	Elusimicrobiota	11888	P	4	0	4	0.00000
ERR675500_1_kneaddata_paired	Thermotogota	33086	P	4	0	4	0.00000
ERR675501_1_kneaddata_paired	Firmicutes_A	14608	P	10776368	37127	10813495	0.65246
ERR675501_1_kneaddata_paired	Bacteroidota	4587	P	4725895	48957	4774852	0.28810
ERR675501_1_kneaddata_paired	Firmicutes	12188	P	688419	2819	691238	0.04171
ERR675501_1_kneaddata_paired	Verrucomicrobiota	33333	P	181532	5688	187220	0.01130
ERR675501_1_kneaddata_paired	Desulfobacterota_A	11509	P	49419	908	50327	0.00304
ERR675501_1_kneaddata_paired	Actinobacteriota	615	P	46246	49	46295	0.00279
ERR675501_1_kneaddata_paired	Proteobacteria	22518	P	6553	24	6577	0.00040
ERR675501_1_kneaddata_paired	Cyanobacteria	9876	P	1234	16	1250	0.00008
ERR675501_1_kneaddata_paired	Firmicutes_B	17289	P	793	15	808	0.00005
ERR675501_1_kneaddata_paired	Spirochaetota	32587	P	619	0	619	0.00004
ERR675501_1_kneaddata_paired	Campylobacterota	8700	P	234	0	234	0.00001
ERR675501_1_kneaddata_paired	Deferribacterota	10822	P	194	0	194	0.00001
ERR675501_1_kneaddata_paired	Firmicutes_C	17613	P	120	0	120	0.00001
ERR675501_1_kneaddata_paired	Firmicutes_I	18140	P	69	0	69	0.00000
ERR675501_1_kneaddata_paired	Elusimicrobiota	11888	P	12	0	12	0.00000
ERR675501_1_kneaddata_paired	Thermotogota	33086	P	12	0	12	0.00000
ERR675502_1_kneaddata_paired	Bacteroidota	4587	P	9464203	42525	9506728	0.55606
ERR675502_1_kneaddata_paired	Firmicutes_A	14608	P	6409282	18339	6427621	0.37596
ERR675502_1_kneaddata_paired	Verrucomicrobiota	33333	P	433188	9521	442709	0.02589
ERR675502_1_kneaddata_paired	Proteobacteria	22518	P	416219	599	416818	0.02438
ERR675502_1_kneaddata_paired	Firmicutes	12188	P	162979	629	163608	0.00957
ERR675502_1_kneaddata_paired	Desulfobacterota_A	11509	P	130912	353	131265	0.00768
ERR675502_1_kneaddata_paired	Actinobacteriota	615	P	4276	4	4280	0.00025
ERR675502_1_kneaddata_paired	Cyanobacteria	9876	P	2492	19	2511	0.00015
ERR675502_1_kneaddata_paired	Spirochaetota	32587	P	452	0	452	0.00003
ERR675502_1_kneaddata_paired	Firmicutes_B	17289	P	308	4	312	0.00002
ERR675502_1_kneaddata_paired	Campylobacterota	8700	P	260	0	260	0.00002
ERR675502_1_kneaddata_paired	Firmicutes_C	17613	P	75	0	75	0.00000
ERR675502_1_kneaddata_paired	Firmicutes_I	18140	P	46	0	46	0.00000
ERR675502_1_kneaddata_paired	Deferribacterota	10822	P	28	0	28	0.00000
ERR675502_1_kneaddata_paired	Thermotogota	33086	P	8	0	8	0.00000
ERR675502_1_kneaddata_paired	Elusimicrobiota	11888	P	4	0	4	0.00000
ERR675503_1_kneaddata_paired	Firmicutes_A	14608	P	14844095	73308	14917403	0.82884
ERR675503_1_kneaddata_paired	Bacteroidota	4587	P	1425034	20964	1445998	0.08034
ERR675503_1_kneaddata_paired	Firmicutes	12188	P	785691	6940	792631	0.04404
ERR675503_1_kneaddata_paired	Verrucomicrobiota	33333	P	552195	24407	576602	0.03204
ERR675503_1_kneaddata_paired	Desulfobacterota_A	11509	P	124222	2567	126789	0.00704
ERR675503_1_kneaddata_paired	Proteobacteria	22518	P	76590	230	76820	0.00427
ERR675503_1_kneaddata_paired	Actinobacteriota	615	P	57605	105	57710	0.00321
ERR675503_1_kneaddata_paired	Cyanobacteria	9876	P	1473	19	1492	0.00008
ERR675503_1_kneaddata_paired	Firmicutes_B	17289	P	1172	31	1203	0.00007
ERR675503_1_kneaddata_paired	Spirochaetota	32587	P	536	0	536	0.00003
ERR675503_1_kneaddata_paired	Campylobacterota	8700	P	363	0	363	0.00002
ERR675503_1_kneaddata_paired	Firmicutes_C	17613	P	185	0	185	0.00001
ERR675503_1_kneaddata_paired	Firmicutes_I	18140	P	130	0	130	0.00001
ERR675503_1_kneaddata_paired	Deferribacterota	10822	P	56	0	56	0.00000
ERR675503_1_kneaddata_paired	Thermotogota	33086	P	29	0	29	0.00000
ERR675503_1_kneaddata_paired	Elusimicrobiota	11888	P	12	0	12	0.00000
ERR675504_1_kneaddata_paired	Bacteroidota	4587	P	8441338	42554	8483892	0.47820
ERR675504_1_kneaddata_paired	Firmicutes_A	14608	P	8239145	23594	8262739	0.46574
ERR675504_1_kneaddata_paired	Verrucomicrobiota	33333	P	408895	9465	418360	0.02358
ERR675504_1_kneaddata_paired	Firmicutes	12188	P	343090	8586	351676	0.01982
ERR675504_1_kneaddata_paired	Proteobacteria	22518	P	120345	222	120567	0.00680
ERR675504_1_kneaddata_paired	Desulfobacterota_A	11509	P	95283	391	95674	0.00539
ERR675504_1_kneaddata_paired	Actinobacteriota	615	P	4583	4	4587	0.00026
ERR675504_1_kneaddata_paired	Cyanobacteria	9876	P	2281	17	2298	0.00013
ERR675504_1_kneaddata_paired	Firmicutes_B	17289	P	508	7	515	0.00003
ERR675504_1_kneaddata_paired	Spirochaetota	32587	P	374	0	374	0.00002
ERR675504_1_kneaddata_paired	Campylobacterota	8700	P	206	0	206	0.00001
ERR675504_1_kneaddata_paired	Deferribacterota	10822	P	98	0	98	0.00001
ERR675504_1_kneaddata_paired	Firmicutes_C	17613	P	60	0	60	0.00000
ERR675504_1_kneaddata_paired	Firmicutes_I	18140	P	58	0	58	0.00000
ERR675504_1_kneaddata_paired	Thermotogota	33086	P	9	0	9	0.00000
ERR675504_1_kneaddata_paired	Elusimicrobiota	11888	P	5	0	5	0.00000
ERR675505_1_kneaddata_paired	Firmicutes_A	14608	P	9050762	49244	9100006	0.54715
ERR675505_1_kneaddata_paired	Firmicutes	12188	P	4778682	30239	4808921	0.28914
ERR675505_1_kneaddata_paired	Bacteroidota	4587	P	2299674	33711	2333385	0.14030
ERR675505_1_kneaddata_paired	Verrucomicrobiota	33333	P	156746	8906	165652	0.00996
ERR675505_1_kneaddata_paired	Proteobacteria	22518	P	150692	576	151268	0.00910
ERR675505_1_kneaddata_paired	Actinobacteriota	615	P	41864	108	41972	0.00252
ERR675505_1_kneaddata_paired	Desulfobacterota_A	11509	P	25492	1544	27036	0.00163
ERR675505_1_kneaddata_paired	Cyanobacteria	9876	P	1456	29	1485	0.00009
ERR675505_1_kneaddata_paired	Firmicutes_B	17289	P	951	33	984	0.00006
ERR675505_1_kneaddata_paired	Campylobacterota	8700	P	465	0	465	0.00003
ERR675505_1_kneaddata_paired	Spirochaetota	32587	P	194	0	194	0.00001
ERR675505_1_kneaddata_paired	Deferribacterota	10822	P	169	0	169	0.00001
ERR675505_1_kneaddata_paired	Firmicutes_C	17613	P	86	0	86	0.00001
ERR675505_1_kneaddata_paired	Firmicutes_I	18140	P	78	0	78	0.00000
ERR675505_1_kneaddata_paired	Thermotogota	33086	P	37	0	37	0.00000
ERR675505_1_kneaddata_paired	Elusimicrobiota	11888	P	6	0	6	0.00000
ERR675506_1_kneaddata_paired	Bacteroidota	4587	P	7284190	29651	7313841	0.55272
ERR675506_1_kneaddata_paired	Firmicutes_A	14608	P	4866425	10978	4877403	0.36859
ERR675506_1_kneaddata_paired	Verrucomicrobiota	33333	P	478286	8053	486339	0.03675
ERR675506_1_kneaddata_paired	Firmicutes	12188	P	295251	7485	302736	0.02288
ERR675506_1_kneaddata_paired	Desulfobacterota_A	11509	P	143861	312	144173	0.01090
ERR675506_1_kneaddata_paired	Proteobacteria	22518	P	99759	102	99861	0.00755
ERR675506_1_kneaddata_paired	Actinobacteriota	615	P	5981	4	5985	0.00045
ERR675506_1_kneaddata_paired	Cyanobacteria	9876	P	697	5	702	0.00005
ERR675506_1_kneaddata_paired	Spirochaetota	32587	P	548	0	548	0.00004
ERR675506_1_kneaddata_paired	Firmicutes_B	17289	P	382	3	385	0.00003
ERR675506_1_kneaddata_paired	Campylobacterota	8700	P	276	0	276	0.00002
ERR675506_1_kneaddata_paired	Firmicutes_I	18140	P	73	0	73	0.00001
ERR675506_1_kneaddata_paired	Firmicutes_C	17613	P	46	0	46	0.00000
ERR675506_1_kneaddata_paired	Deferribacterota	10822	P	38	0	38	0.00000
ERR675506_1_kneaddata_paired	Thermotogota	33086	P	12	0	12	0.00000
ERR675506_1_kneaddata_paired	Elusimicrobiota	11888	P	4	0	4	0.00000
ERR675507_1_kneaddata_paired	Firmicutes_A	14608	P	8526316	26626	8552942	0.60731
ERR675507_1_kneaddata_paired	Bacteroidota	4587	P	3157789	21670	3179459	0.22576
ERR675507_1_kneaddata_paired	Verrucomicrobiota	33333	P	1408132	36207	1444339	0.10256
ERR675507_1_kneaddata_paired	Firmicutes	12188	P	535770	1977	537747	0.03818
ERR675507_1_kneaddata_paired	Firmicutes_B	17289	P	181809	2884	184693	0.01311
ERR675507_1_kneaddata_paired	Desulfobacterota_A	11509	P	115739	893	116632	0.00828
ERR675507_1_kneaddata_paired	Actinobacteriota	615	P	35785	39	35824	0.00254
ERR675507_1_kneaddata_paired	Proteobacteria	22518	P	28892	51	28943	0.00206
ERR675507_1_kneaddata_paired	Cyanobacteria	9876	P	1210	13	1223	0.00009
ERR675507_1_kneaddata_paired	Spirochaetota	32587	P	1026	0	1026	0.00007
ERR675507_1_kneaddata_paired	Campylobacterota	8700	P	167	0	167	0.00001
ERR675507_1_kneaddata_paired	Deferribacterota	10822	P	109	0	109	0.00001
ERR675507_1_kneaddata_paired	Firmicutes_I	18140	P	102	0	102	0.00001
ERR675507_1_kneaddata_paired	Firmicutes_C	17613	P	99	0	99	0.00001
ERR675507_1_kneaddata_paired	Thermotogota	33086	P	22	0	22	0.00000
ERR675507_1_kneaddata_paired	Elusimicrobiota	11888	P	15	0	15	0.00000
ERR675508_1_kneaddata_paired	Bacteroidota	4587	P	14604070	59031	14663101	0.60583
ERR675508_1_kneaddata_paired	Firmicutes_A	14608	P	7027883	15006	7042889	0.29099
ERR675508_1_kneaddata_paired	Verrucomicrobiota	33333	P	1202602	20014	1222616	0.05051
ERR675508_1_kneaddata_paired	Firmicutes	12188	P	698862	12864	711726	0.02941
ERR675508_1_kneaddata_paired	Proteobacteria	22518	P	303681	347	304028	0.01256
ERR675508_1_kneaddata_paired	Desulfobacterota_A	11509	P	234895	385	235280	0.00972
ERR675508_1_kneaddata_paired	Actinobacteriota	615	P	19876	10	19886	0.00082
ERR675508_1_kneaddata_paired	Cyanobacteria	9876	P	1395	10	1405	0.00006
ERR675508_1_kneaddata_paired	Firmicutes_B	17289	P	770	7	777	0.00003
ERR675508_1_kneaddata_paired	Spirochaetota	32587	P	648	0	648	0.00003
ERR675508_1_kneaddata_paired	Campylobacterota	8700	P	530	0	530	0.00002
ERR675508_1_kneaddata_paired	Firmicutes_I	18140	P	113	0	113	0.00000
ERR675508_1_kneaddata_paired	Firmicutes_C	17613	P	91	0	91	0.00000
ERR675508_1_kneaddata_paired	Deferribacterota	10822	P	57	0	57	0.00000
ERR675508_1_kneaddata_paired	Elusimicrobiota	11888	P	7	0	7	0.00000
ERR675508_1_kneaddata_paired	Thermotogota	33086	P	7	0	7	0.00000
ERR675509_1_kneaddata_paired	Firmicutes_A	14608	P	10487752	48453	10536205	0.79118
ERR675509_1_kneaddata_paired	Bacteroidota	4587	P	1336957	14431	1351388	0.10148
ERR675509_1_kneaddata_paired	Verrucomicrobiota	33333	P	550361	25459	575820	0.04324
ERR675509_1_kneaddata_paired	Firmicutes	12188	P	407401	2514	409915	0.03078
ERR675509_1_kneaddata_paired	Firmicutes_B	17289	P	248565	7096	255661	0.01920
ERR675509_1_kneaddata_paired	Desulfobacterota_A	11509	P	80221	1043	81264	0.00610
ERR675509_1_kneaddata_paired	Actinobacteriota	615	P	78745	157	78902	0.00592
ERR675509_1_kneaddata_paired	Proteobacteria	22518	P	25997	58	26055	0.00196
ERR675509_1_kneaddata_paired	Cyanobacteria	9876	P	860	11	871	0.00007
ERR675509_1_kneaddata_paired	Spirochaetota	32587	P	559	0	559	0.00004
ERR675509_1_kneaddata_paired	Firmicutes_C	17613	P	207	0	207	0.00002
ERR675509_1_kneaddata_paired	Campylobacterota	8700	P	179	0	179	0.00001
ERR675509_1_kneaddata_paired	Firmicutes_I	18140	P	87	0	87	0.00001
ERR675509_1_kneaddata_paired	Deferribacterota	10822	P	22	0	22	0.00000
ERR675509_1_kneaddata_paired	Elusimicrobiota	11888	P	11	0	11	0.00000
ERR675509_1_kneaddata_paired	Thermotogota	33086	P	7	0	7	0.00000
ERR675510_1_kneaddata_paired	Bacteroidota	4587	P	10818880	40122	10859002	0.57144
ERR675510_1_kneaddata_paired	Firmicutes_A	14608	P	6078792	13103	6091895	0.32058
ERR675510_1_kneaddata_paired	Verrucomicrobiota	33333	P	787801	13750	801551	0.04218
ERR675510_1_kneaddata_paired	Firmicutes	12188	P	785724	27695	813419	0.04281
ERR675510_1_kneaddata_paired	Desulfobacterota_A	11509	P	199678	311	199989	0.01052
ERR675510_1_kneaddata_paired	Proteobacteria	22518	P	191963	266	192229	0.01012
ERR675510_1_kneaddata_paired	Actinobacteriota	615	P	39120	19	39139	0.00206
ERR675510_1_kneaddata_paired	Cyanobacteria	9876	P	4208	57	4265	0.00022
ERR675510_1_kneaddata_paired	Firmicutes_B	17289	P	488	5	493	0.00003
ERR675510_1_kneaddata_paired	Spirochaetota	32587	P	364	0	364	0.00002
ERR675510_1_kneaddata_paired	Campylobacterota	8700	P	227	0	227	0.00001
ERR675510_1_kneaddata_paired	Deferribacterota	10822	P	67	0	67	0.00000
ERR675510_1_kneaddata_paired	Firmicutes_C	17613	P	55	0	55	0.00000
ERR675510_1_kneaddata_paired	Firmicutes_I	18140	P	47	0	47	0.00000
ERR675510_1_kneaddata_paired	Thermotogota	33086	P	8	0	8	0.00000
ERR675510_1_kneaddata_paired	Elusimicrobiota	11888	P	5	0	5	0.00000
ERR675511_1_kneaddata_paired	Firmicutes_A	14608	P	14119302	64940	14184242	0.74535
ERR675511_1_kneaddata_paired	Bacteroidota	4587	P	3395484	28782	3424266	0.17994
ERR675511_1_kneaddata_paired	Firmicutes	12188	P	596788	5310	602098	0.03164
ERR675511_1_kneaddata_paired	Verrucomicrobiota	33333	P	452085	20208	472293	0.02482
ERR675511_1_kneaddata_paired	Desulfobacterota_A	11509	P	254976	1722	256698	0.01349
ERR675511_1_kneaddata_paired	Actinobacteriota	615	P	49808	90	49898	0.00262
ERR675511_1_kneaddata_paired	Proteobacteria	22518	P	36588	92	36680	0.00193
ERR675511_1_kneaddata_paired	Firmicutes_B	17289	P	1624	44	1668	0.00009
ERR675511_1_kneaddata_paired	Cyanobacteria	9876	P	1465	20	1485	0.00008
ERR675511_1_kneaddata_paired	Campylobacterota	8700	P	315	0	315	0.00002
ERR675511_1_kneaddata_paired	Spirochaetota	32587	P	218	0	218	0.00001
ERR675511_1_kneaddata_paired	Firmicutes_C	17613	P	196	0	196	0.00001
ERR675511_1_kneaddata_paired	Firmicutes_I	18140	P	137	0	137	0.00001
ERR675511_1_kneaddata_paired	Thermotogota	33086	P	38	0	38	0.00000
ERR675511_1_kneaddata_paired	Deferribacterota	10822	P	28	0	28	0.00000
ERR675511_1_kneaddata_paired	Elusimicrobiota	11888	P	10	0	10	0.00000
ERR675512_1_kneaddata_paired	Bacteroidota	4587	P	12713787	60816	12774603	0.55007
ERR675512_1_kneaddata_paired	Firmicutes_A	14608	P	8815948	20237	8836185	0.38048
ERR675512_1_kneaddata_paired	Verrucomicrobiota	33333	P	814831	17610	832441	0.03584
ERR675512_1_kneaddata_paired	Desulfobacterota_A	11509	P	383021	549	383570	0.01652
ERR675512_1_kneaddata_paired	Firmicutes	12188	P	231566	718	232284	0.01000
ERR675512_1_kneaddata_paired	Proteobacteria	22518	P	134470	200	134670	0.00580
ERR675512_1_kneaddata_paired	Actinobacteriota	615	P	26070	24	26094	0.00112
ERR675512_1_kneaddata_paired	Cyanobacteria	9876	P	2204	11	2215	0.00010
ERR675512_1_kneaddata_paired	Firmicutes_B	17289	P	570	7	577	0.00002
ERR675512_1_kneaddata_paired	Spirochaetota	32587	P	537	0	537	0.00002
ERR675512_1_kneaddata_paired	Campylobacterota	8700	P	289	0	289	0.00001
ERR675512_1_kneaddata_paired	Firmicutes_C	17613	P	109	0	109	0.00000
ERR675512_1_kneaddata_paired	Firmicutes_I	18140	P	78	0	78	0.00000
ERR675512_1_kneaddata_paired	Deferribacterota	10822	P	53	0	53	0.00000
ERR675512_1_kneaddata_paired	Thermotogota	33086	P	18	0	18	0.00000
ERR675512_1_kneaddata_paired	Elusimicrobiota	11888	P	9	0	9	0.00000
ERR675513_1_kneaddata_paired	Firmicutes_A	14608	P	10031651	44713	10076364	0.66172
ERR675513_1_kneaddata_paired	Bacteroidota	4587	P	4035250	41699	4076949	0.26773
ERR675513_1_kneaddata_paired	Firmicutes	12188	P	737453	3741	741194	0.04867
ERR675513_1_kneaddata_paired	Desulfobacterota_A	11509	P	225406	1313	226719	0.01489
ERR675513_1_kneaddata_paired	Actinobacteriota	615	P	61275	102	61377	0.00403
ERR675513_1_kneaddata_paired	Proteobacteria	22518	P	27855	93	27948	0.00184
ERR675513_1_kneaddata_paired	Verrucomicrobiota	33333	P	13650	547	14197	0.00093
ERR675513_1_kneaddata_paired	Cyanobacteria	9876	P	865	17	882	0.00006
ERR675513_1_kneaddata_paired	Firmicutes_B	17289	P	766	18	784	0.00005
ERR675513_1_kneaddata_paired	Spirochaetota	32587	P	688	0	688	0.00005
ERR675513_1_kneaddata_paired	Campylobacterota	8700	P	178	0	178	0.00001
ERR675513_1_kneaddata_paired	Firmicutes_C	17613	P	147	0	147	0.00001
ERR675513_1_kneaddata_paired	Firmicutes_I	18140	P	89	0	89	0.00001
ERR675513_1_kneaddata_paired	Deferribacterota	10822	P	86	0	86	0.00001
ERR675513_1_kneaddata_paired	Elusimicrobiota	11888	P	17	0	17	0.00000
ERR675513_1_kneaddata_paired	Thermotogota	33086	P	2	0	2	0.00000
ERR675514_1_kneaddata_paired	Bacteroidota	4587	P	7688401	31982	7720383	0.50720
ERR675514_1_kneaddata_paired	Firmicutes_A	14608	P	5989037	12970	6002007	0.39431
ERR675514_1_kneaddata_paired	Firmicutes	12188	P	764371	23757	788128	0.05178
ERR675514_1_kneaddata_paired	Verrucomicrobiota	33333	P	328457	6177	334634	0.02198
ERR675514_1_kneaddata_paired	Firmicutes_B	17289	P	168937	1963	170900	0.01123
ERR675514_1_kneaddata_paired	Proteobacteria	22518	P	119401	162	119563	0.00785
ERR675514_1_kneaddata_paired	Desulfobacterota_A	11509	P	66616	265	66881	0.00439
ERR675514_1_kneaddata_paired	Actinobacteriota	615	P	17651	14	17665	0.00116
ERR675514_1_kneaddata_paired	Cyanobacteria	9876	P	653	4	657	0.00004
ERR675514_1_kneaddata_paired	Spirochaetota	32587	P	461	0	461	0.00003
ERR675514_1_kneaddata_paired	Campylobacterota	8700	P	209	0	209	0.00001
ERR675514_1_kneaddata_paired	Firmicutes_I	18140	P	72	0	72	0.00000
ERR675514_1_kneaddata_paired	Firmicutes_C	17613	P	51	0	51	0.00000
ERR675514_1_kneaddata_paired	Deferribacterota	10822	P	48	0	48	0.00000
ERR675514_1_kneaddata_paired	Elusimicrobiota	11888	P	10	0	10	0.00000
ERR675514_1_kneaddata_paired	Thermotogota	33086	P	7	0	7	0.00000
ERR675515_1_kneaddata_paired	Firmicutes_A	14608	P	11787122	60361	11847483	0.78563
ERR675515_1_kneaddata_paired	Bacteroidota	4587	P	2049972	15560	2065532	0.13697
ERR675515_1_kneaddata_paired	Firmicutes	12188	P	450199	1857	452056	0.02998
ERR675515_1_kneaddata_paired	Verrucomicrobiota	33333	P	300929	10915	311844	0.02068
ERR675515_1_kneaddata_paired	Desulfobacterota_A	11509	P	175087	1291	176378	0.01170
ERR675515_1_kneaddata_paired	Proteobacteria	22518	P	149290	387	149677	0.00993
ERR675515_1_kneaddata_paired	Actinobacteriota	615	P	74272	119	74391	0.00493
ERR675515_1_kneaddata_paired	Firmicutes_B	17289	P	1137	25	1162	0.00008
ERR675515_1_kneaddata_paired	Cyanobacteria	9876	P	865	8	873	0.00006
ERR675515_1_kneaddata_paired	Campylobacterota	8700	P	335	0	335	0.00002
ERR675515_1_kneaddata_paired	Spirochaetota	32587	P	263	0	263	0.00002
ERR675515_1_kneaddata_paired	Firmicutes_C	17613	P	133	0	133	0.00001
ERR675515_1_kneaddata_paired	Firmicutes_I	18140	P	82	0	82	0.00001
ERR675515_1_kneaddata_paired	Deferribacterota	10822	P	50	0	50	0.00000
ERR675515_1_kneaddata_paired	Thermotogota	33086	P	41	0	41	0.00000
ERR675515_1_kneaddata_paired	Elusimicrobiota	11888	P	8	0	8	0.00000
ERR675516_1_kneaddata_paired	Bacteroidota	4587	P	13058628	49234	13107862	0.56582
ERR675516_1_kneaddata_paired	Firmicutes_A	14608	P	6971787	14518	6986305	0.30157
ERR675516_1_kneaddata_paired	Firmicutes	12188	P	1344023	35412	1379435	0.05954
ERR675516_1_kneaddata_paired	Verrucomicrobiota	33333	P	1032087	17638	1049725	0.04531
ERR675516_1_kneaddata_paired	Desulfobacterota_A	11509	P	329907	461	330368	0.01426
ERR675516_1_kneaddata_paired	Proteobacteria	22518	P	292262	381	292643	0.01263
ERR675516_1_kneaddata_paired	Actinobacteriota	615	P	15833	13	15846	0.00068
ERR675516_1_kneaddata_paired	Firmicutes_B	17289	P	1399	14	1413	0.00006
ERR675516_1_kneaddata_paired	Cyanobacteria	9876	P	1060	7	1067	0.00005
ERR675516_1_kneaddata_paired	Spirochaetota	32587	P	990	0	990	0.00004
ERR675516_1_kneaddata_paired	Campylobacterota	8700	P	418	0	418	0.00002
ERR675516_1_kneaddata_paired	Firmicutes_I	18140	P	87	0	87	0.00000
ERR675516_1_kneaddata_paired	Deferribacterota	10822	P	81	0	81	0.00000
ERR675516_1_kneaddata_paired	Firmicutes_C	17613	P	66	0	66	0.00000
ERR675516_1_kneaddata_paired	Thermotogota	33086	P	7	0	7	0.00000
ERR675516_1_kneaddata_paired	Elusimicrobiota	11888	P	6	0	6	0.00000
ERR675517_1_kneaddata_paired	Firmicutes_A	14608	P	10384529	32018	10416547	0.65697
ERR675517_1_kneaddata_paired	Bacteroidota	4587	P	4795383	46613	4841996	0.30538
ERR675517_1_kneaddata_paired	Firmicutes	12188	P	273946	1572	275518	0.01738
ERR675517_1_kneaddata_paired	Verrucomicrobiota	33333	P	182843	5960	188803	0.01191
ERR675517_1_kneaddata_paired	Desulfobacterota_A	11509	P	80380	788	81168	0.00512
ERR675517_1_kneaddata_paired	Actinobacteriota	615	P	42116	52	42168	0.00266
ERR675517_1_kneaddata_paired	Proteobacteria	22518	P	6308	22	6330	0.00040
ERR675517_1_kneaddata_paired	Firmicutes_B	17289	P	1028	20	1048	0.00007
ERR675517_1_kneaddata_paired	Cyanobacteria	9876	P	872	12	884	0.00006
ERR675517_1_kneaddata_paired	Spirochaetota	32587	P	579	0	579	0.00004
ERR675517_1_kneaddata_paired	Campylobacterota	8700	P	164	0	164	0.00001
ERR675517_1_kneaddata_paired	Firmicutes_C	17613	P	119	0	119	0.00001
ERR675517_1_kneaddata_paired	Firmicutes_I	18140	P	69	0	69	0.00000
ERR675517_1_kneaddata_paired	Deferribacterota	10822	P	41	0	41	0.00000
ERR675517_1_kneaddata_paired	Thermotogota	33086	P	18	0	18	0.00000
ERR675517_1_kneaddata_paired	Elusimicrobiota	11888	P	15	0	15	0.00000
ERR675518_1_kneaddata_paired	Bacteroidota	4587	P	11587063	15662	11602725	0.60851
ERR675518_1_kneaddata_paired	Firmicutes_A	14608	P	2862302	6706	2869008	0.15047
ERR675518_1_kneaddata_paired	Verrucomicrobiota	33333	P	1968992	28364	1997356	0.10475
ERR675518_1_kneaddata_paired	Firmicutes	12188	P	1639127	52586	1691713	0.08872
ERR675518_1_kneaddata_paired	Desulfobacterota_A	11509	P	434885	17094	451979	0.02370
ERR675518_1_kneaddata_paired	Actinobacteriota	615	P	271704	2117	273821	0.01436
ERR675518_1_kneaddata_paired	Proteobacteria	22518	P	83468	128	83596	0.00438
ERR675518_1_kneaddata_paired	Deferribacterota	10822	P	80329	72	80401	0.00422
ERR675518_1_kneaddata_paired	Cyanobacteria	9876	P	16193	221	16414	0.00086
ERR675518_1_kneaddata_paired	Spirochaetota	32587	P	196	0	196	0.00001
ERR675518_1_kneaddata_paired	Firmicutes_B	17289	P	184	1	185	0.00001
ERR675518_1_kneaddata_paired	Campylobacterota	8700	P	83	0	83	0.00000
ERR675518_1_kneaddata_paired	Firmicutes_I	18140	P	50	0	50	0.00000
ERR675518_1_kneaddata_paired	Firmicutes_C	17613	P	32	0	32	0.00000
ERR675518_1_kneaddata_paired	Elusimicrobiota	11888	P	6	0	6	0.00000
ERR675518_1_kneaddata_paired	Thermotogota	33086	P	2	0	2	0.00000
ERR675519_1_kneaddata_paired	Firmicutes_A	14608	P	9282958	16207	9299165	0.52635
ERR675519_1_kneaddata_paired	Bacteroidota	4587	P	2650589	9522	2660111	0.15057
ERR675519_1_kneaddata_paired	Firmicutes	12188	P	2481092	46482	2527574	0.14307
ERR675519_1_kneaddata_paired	Verrucomicrobiota	33333	P	2099242	30582	2129824	0.12055
ERR675519_1_kneaddata_paired	Desulfobacterota_A	11509	P	545456	21153	566609	0.03207
ERR675519_1_kneaddata_paired	Actinobacteriota	615	P	411069	2876	413945	0.02343
ERR675519_1_kneaddata_paired	Deferribacterota	10822	P	37242	34	37276	0.00211
ERR675519_1_kneaddata_paired	Firmicutes_B	17289	P	26929	242	27171	0.00154
ERR675519_1_kneaddata_paired	Proteobacteria	22518	P	4030	3	4033	0.00023
ERR675519_1_kneaddata_paired	Cyanobacteria	9876	P	774	5	779	0.00004
ERR675519_1_kneaddata_paired	Spirochaetota	32587	P	396	0	396	0.00002
ERR675519_1_kneaddata_paired	Campylobacterota	8700	P	157	0	157	0.00001
ERR675519_1_kneaddata_paired	Firmicutes_C	17613	P	136	0	136	0.00001
ERR675519_1_kneaddata_paired	Firmicutes_I	18140	P	92	0	92	0.00001
ERR675519_1_kneaddata_paired	Thermotogota	33086	P	14	0	14	0.00000
ERR675519_1_kneaddata_paired	Elusimicrobiota	11888	P	5	0	5	0.00000
ERR675520_1_kneaddata_paired	Bacteroidota	4587	P	11789957	17034	11806991	0.69096
ERR675520_1_kneaddata_paired	Firmicutes_A	14608	P	2739756	8253	2748009	0.16082
ERR675520_1_kneaddata_paired	Verrucomicrobiota	33333	P	1545705	32428	1578133	0.09235
ERR675520_1_kneaddata_paired	Firmicutes	12188	P	594036	25481	619517	0.03626
ERR675520_1_kneaddata_paired	Desulfobacterota_A	11509	P	240575	12311	252886	0.01480
ERR675520_1_kneaddata_paired	Deferribacterota	10822	P	49916	65	49981	0.00293
ERR675520_1_kneaddata_paired	Actinobacteriota	615	P	13972	16	13988	0.00082
ERR675520_1_kneaddata_paired	Proteobacteria	22518	P	13417	11	13428	0.00079
ERR675520_1_kneaddata_paired	Cyanobacteria	9876	P	4162	29	4191	0.00025
ERR675520_1_kneaddata_paired	Firmicutes_B	17289	P	207	2	209	0.00001
ERR675520_1_kneaddata_paired	Spirochaetota	32587	P	166	0	166	0.00001
ERR675520_1_kneaddata_paired	Campylobacterota	8700	P	103	0	103	0.00001
ERR675520_1_kneaddata_paired	Firmicutes_C	17613	P	49	0	49	0.00000
ERR675520_1_kneaddata_paired	Firmicutes_I	18140	P	48	0	48	0.00000
ERR675520_1_kneaddata_paired	Elusimicrobiota	11888	P	4	0	4	0.00000
ERR675520_1_kneaddata_paired	Thermotogota	33086	P	4	0	4	0.00000
ERR675521_1_kneaddata_paired	Firmicutes_A	14608	P	11057701	28282	11085983	0.69035
ERR675521_1_kneaddata_paired	Bacteroidota	4587	P	1831468	4810	1836278	0.11435
ERR675521_1_kneaddata_paired	Firmicutes	12188	P	1570583	34713	1605296	0.09997
ERR675521_1_kneaddata_paired	Verrucomicrobiota	33333	P	1058676	25664	1084340	0.06752
ERR675521_1_kneaddata_paired	Desulfobacterota_A	11509	P	302023	18605	320628	0.01997
ERR675521_1_kneaddata_paired	Actinobacteriota	615	P	61907	68	61975	0.00386
ERR675521_1_kneaddata_paired	Deferribacterota	10822	P	53027	80	53107	0.00331
ERR675521_1_kneaddata_paired	Firmicutes_B	17289	P	4969	74	5043	0.00031
ERR675521_1_kneaddata_paired	Proteobacteria	22518	P	4121	7	4128	0.00026
ERR675521_1_kneaddata_paired	Cyanobacteria	9876	P	978	11	989	0.00006
ERR675521_1_kneaddata_paired	Spirochaetota	32587	P	358	0	358	0.00002
ERR675521_1_kneaddata_paired	Campylobacterota	8700	P	165	0	165	0.00001
ERR675521_1_kneaddata_paired	Firmicutes_C	17613	P	125	0	125	0.00001
ERR675521_1_kneaddata_paired	Firmicutes_I	18140	P	107	0	107	0.00001
ERR675521_1_kneaddata_paired	Thermotogota	33086	P	19	0	19	0.00000
ERR675521_1_kneaddata_paired	Elusimicrobiota	11888	P	14	0	14	0.00000
ERR675522_1_kneaddata_paired	Bacteroidota	4587	P	8125290	7253	8132543	0.54220
ERR675522_1_kneaddata_paired	Firmicutes_A	14608	P	2899179	4320	2903499	0.19358
ERR675522_1_kneaddata_paired	Firmicutes	12188	P	1662728	47801	1710529	0.11404
ERR675522_1_kneaddata_paired	Verrucomicrobiota	33333	P	1500361	18875	1519236	0.10129
ERR675522_1_kneaddata_paired	Actinobacteriota	615	P	380273	2389	382662	0.02551
ERR675522_1_kneaddata_paired	Desulfobacterota_A	11509	P	224377	7352	231729	0.01545
ERR675522_1_kneaddata_paired	Deferribacterota	10822	P	72902	57	72959	0.00486
ERR675522_1_kneaddata_paired	Proteobacteria	22518	P	44704	56	44760	0.00298
ERR675522_1_kneaddata_paired	Cyanobacteria	9876	P	783	7	790	0.00005
ERR675522_1_kneaddata_paired	Spirochaetota	32587	P	163	0	163	0.00001
ERR675522_1_kneaddata_paired	Firmicutes_B	17289	P	109	0	109	0.00001
ERR675522_1_kneaddata_paired	Campylobacterota	8700	P	65	0	65	0.00000
ERR675522_1_kneaddata_paired	Firmicutes_C	17613	P	45	0	45	0.00000
ERR675522_1_kneaddata_paired	Firmicutes_I	18140	P	38	0	38	0.00000
ERR675522_1_kneaddata_paired	Elusimicrobiota	11888	P	12	0	12	0.00000
ERR675522_1_kneaddata_paired	Thermotogota	33086	P	2	0	2	0.00000
ERR675523_1_kneaddata_paired	Firmicutes_A	14608	P	8329995	23301	8353296	0.52693
ERR675523_1_kneaddata_paired	Bacteroidota	4587	P	2758482	7763	2766245	0.17450
ERR675523_1_kneaddata_paired	Verrucomicrobiota	33333	P	2330083	64784	2394867	0.15107
ERR675523_1_kneaddata_paired	Firmicutes	12188	P	1866071	30704	1896775	0.11965
ERR675523_1_kneaddata_paired	Desulfobacterota_A	11509	P	247567	17597	265164	0.01673
ERR675523_1_kneaddata_paired	Actinobacteriota	615	P	67558	314	67872	0.00428
ERR675523_1_kneaddata_paired	Firmicutes_B	17289	P	50314	863	51177	0.00323
ERR675523_1_kneaddata_paired	Deferribacterota	10822	P	48515	84	48599	0.00307
ERR675523_1_kneaddata_paired	Proteobacteria	22518	P	6182	13	6195	0.00039
ERR675523_1_kneaddata_paired	Cyanobacteria	9876	P	1464	18	1482	0.00009
ERR675523_1_kneaddata_paired	Campylobacterota	8700	P	440	0	440	0.00003
ERR675523_1_kneaddata_paired	Spirochaetota	32587	P	391	0	391	0.00002
ERR675523_1_kneaddata_paired	Firmicutes_C	17613	P	134	0	134	0.00001
ERR675523_1_kneaddata_paired	Firmicutes_I	18140	P	119	0	119	0.00001
ERR675523_1_kneaddata_paired	Thermotogota	33086	P	14	0	14	0.00000
ERR675523_1_kneaddata_paired	Elusimicrobiota	11888	P	11	0	11	0.00000
ERR675524_1_kneaddata_paired	Bacteroidota	4587	P	11887435	9697	11897132	0.58286
ERR675524_1_kneaddata_paired	Verrucomicrobiota	33333	P	2955616	36868	2992484	0.14661
ERR675524_1_kneaddata_paired	Firmicutes_A	14608	P	2662295	4487	2666782	0.13065
ERR675524_1_kneaddata_paired	Firmicutes	12188	P	1930404	54554	1984958	0.09725
ERR675524_1_kneaddata_paired	Actinobacteriota	615	P	405205	2692	407897	0.01998
ERR675524_1_kneaddata_paired	Desulfobacterota_A	11509	P	238985	7647	246632	0.01208
ERR675524_1_kneaddata_paired	Proteobacteria	22518	P	162610	210	162820	0.00798
ERR675524_1_kneaddata_paired	Deferribacterota	10822	P	50392	39	50431	0.00247
ERR675524_1_kneaddata_paired	Cyanobacteria	9876	P	2040	10	2050	0.00010
ERR675524_1_kneaddata_paired	Firmicutes_B	17289	P	190	1	191	0.00001
ERR675524_1_kneaddata_paired	Spirochaetota	32587	P	145	0	145	0.00001
ERR675524_1_kneaddata_paired	Campylobacterota	8700	P	101	0	101	0.00000
ERR675524_1_kneaddata_paired	Firmicutes_C	17613	P	63	0	63	0.00000
ERR675524_1_kneaddata_paired	Firmicutes_I	18140	P	46	0	46	0.00000
ERR675524_1_kneaddata_paired	Elusimicrobiota	11888	P	5	0	5	0.00000
ERR675524_1_kneaddata_paired	Thermotogota	33086	P	1	0	1	0.00000
ERR675525_1_kneaddata_paired	Firmicutes_A	14608	P	8149425	25645	8175070	0.59374
ERR675525_1_kneaddata_paired	Bacteroidota	4587	P	3054806	8294	3063100	0.22247
ERR675525_1_kneaddata_paired	Verrucomicrobiota	33333	P	1825969	49443	1875412	0.13621
ERR675525_1_kneaddata_paired	Firmicutes	12188	P	309099	1227	310326	0.02254
ERR675525_1_kneaddata_paired	Desulfobacterota_A	11509	P	210677	13876	224553	0.01631
ERR675525_1_kneaddata_paired	Actinobacteriota	615	P	59790	78	59868	0.00435
ERR675525_1_kneaddata_paired	Deferribacterota	10822	P	52211	88	52299	0.00380
ERR675525_1_kneaddata_paired	Proteobacteria	22518	P	5215	9	5224	0.00038
ERR675525_1_kneaddata_paired	Cyanobacteria	9876	P	1368	20	1388	0.00010
ERR675525_1_kneaddata_paired	Firmicutes_B	17289	P	918	15	933	0.00007
ERR675525_1_kneaddata_paired	Spirochaetota	32587	P	242	0	242	0.00002
ERR675525_1_kneaddata_paired	Campylobacterota	8700	P	168	0	168	0.00001
ERR675525_1_kneaddata_paired	Firmicutes_C	17613	P	144	0	144	0.00001
ERR675525_1_kneaddata_paired	Firmicutes_I	18140	P	71	0	71	0.00001
ERR675525_1_kneaddata_paired	Thermotogota	33086	P	19	0	19	0.00000
ERR675525_1_kneaddata_paired	Elusimicrobiota	11888	P	12	0	12	0.00000
ERR675526_1_kneaddata_paired	Bacteroidota	4587	P	12901164	20000	12921164	0.57834
ERR675526_1_kneaddata_paired	Firmicutes_A	14608	P	5635701	18020	5653721	0.25305
ERR675526_1_kneaddata_paired	Verrucomicrobiota	33333	P	1789377	36199	1825576	0.08171
ERR675526_1_kneaddata_paired	Firmicutes	12188	P	1121762	50477	1172239	0.05247
ERR675526_1_kneaddata_paired	Desulfobacterota_A	11509	P	326211	16709	342920	0.01535
ERR675526_1_kneaddata_paired	Deferribacterota	10822	P	200812	255	201067	0.00900
ERR675526_1_kneaddata_paired	Actinobacteriota	615	P	188448	1947	190395	0.00852
ERR675526_1_kneaddata_paired	Proteobacteria	22518	P	31196	32	31228	0.00140
ERR675526_1_kneaddata_paired	Cyanobacteria	9876	P	2610	35	2645	0.00012
ERR675526_1_kneaddata_paired	Firmicutes_B	17289	P	369	4	373	0.00002
ERR675526_1_kneaddata_paired	Spirochaetota	32587	P	327	0	327	0.00001
ERR675526_1_kneaddata_paired	Campylobacterota	8700	P	80	0	80	0.00000
ERR675526_1_kneaddata_paired	Firmicutes_I	18140	P	70	0	70	0.00000
ERR675526_1_kneaddata_paired	Firmicutes_C	17613	P	56	0	56	0.00000
ERR675526_1_kneaddata_paired	Elusimicrobiota	11888	P	18	0	18	0.00000
ERR675526_1_kneaddata_paired	Thermotogota	33086	P	2	0	2	0.00000
ERR675527_1_kneaddata_paired	Bacteroidota	4587	P	10121994	16173	10138167	0.71634
ERR675527_1_kneaddata_paired	Firmicutes_A	14608	P	2722246	9295	2731541	0.19300
ERR675527_1_kneaddata_paired	Verrucomicrobiota	33333	P	663178	15460	678638	0.04795
ERR675527_1_kneaddata_paired	Firmicutes	12188	P	304878	13717	318595	0.02251
ERR675527_1_kneaddata_paired	Desulfobacterota_A	11509	P	179301	9222	188523	0.01332
ERR675527_1_kneaddata_paired	Actinobacteriota	615	P	70480	798	71278	0.00504
ERR675527_1_kneaddata_paired	Deferribacterota	10822	P	13764	20	13784	0.00097
ERR675527_1_kneaddata_paired	Cyanobacteria	9876	P	7565	26	7591	0.00054
ERR675527_1_kneaddata_paired	Proteobacteria	22518	P	4014	5	4019	0.00028
ERR675527_1_kneaddata_paired	Firmicutes_B	17289	P	409	5	414	0.00003
ERR675527_1_kneaddata_paired	Spirochaetota	32587	P	100	0	100	0.00001
ERR675527_1_kneaddata_paired	Campylobacterota	8700	P	50	0	50	0.00000
ERR675527_1_kneaddata_paired	Firmicutes_I	18140	P	43	0	43	0.00000
ERR675527_1_kneaddata_paired	Firmicutes_C	17613	P	33	0	33	0.00000
ERR675527_1_kneaddata_paired	Elusimicrobiota	11888	P	5	0	5	0.00000
ERR675527_1_kneaddata_paired	Thermotogota	33086	P	3	0	3	0.00000
ERR675528_1_kneaddata_paired	Firmicutes_A	14608	P	11433859	25258	11459117	0.65803
ERR675528_1_kneaddata_paired	Bacteroidota	4587	P	1924163	4768	1928931	0.11077
ERR675528_1_kneaddata_paired	Firmicutes	12188	P	1592318	43015	1635333	0.09391
ERR675528_1_kneaddata_paired	Verrucomicrobiota	33333	P	1529188	35522	1564710	0.08985
ERR675528_1_kneaddata_paired	Desulfobacterota_A	11509	P	489634	29229	518863	0.02980
ERR675528_1_kneaddata_paired	Deferribacterota	10822	P	160877	234	161111	0.00925
ERR675528_1_kneaddata_paired	Actinobacteriota	615	P	102732	108	102840	0.00591
ERR675528_1_kneaddata_paired	Firmicutes_B	17289	P	37048	530	37578	0.00216
ERR675528_1_kneaddata_paired	Proteobacteria	22518	P	3854	10	3864	0.00022
ERR675528_1_kneaddata_paired	Cyanobacteria	9876	P	927	8	935	0.00005
ERR675528_1_kneaddata_paired	Spirochaetota	32587	P	572	0	572	0.00003
ERR675528_1_kneaddata_paired	Firmicutes_C	17613	P	181	0	181	0.00001
ERR675528_1_kneaddata_paired	Campylobacterota	8700	P	157	0	157	0.00001
ERR675528_1_kneaddata_paired	Firmicutes_I	18140	P	110	0	110	0.00001
ERR675528_1_kneaddata_paired	Elusimicrobiota	11888	P	9	0	9	0.00000
ERR675528_1_kneaddata_paired	Thermotogota	33086	P	1	0	1	0.00000
ERR675529_1_kneaddata_paired	Bacteroidota	4587	P	11578993	20055	11599048	0.71934
ERR675529_1_kneaddata_paired	Firmicutes_A	14608	P	3131472	14718	3146190	0.19512
ERR675529_1_kneaddata_paired	Verrucomicrobiota	33333	P	904329	24439	928768	0.05760
ERR675529_1_kneaddata_paired	Desulfobacterota_A	11509	P	241219	15850	257069	0.01594
ERR675529_1_kneaddata_paired	Firmicutes	12188	P	68792	360	69152	0.00429
ERR675529_1_kneaddata_paired	Proteobacteria	22518	P	58771	151	58922	0.00365
ERR675529_1_kneaddata_paired	Deferribacterota	10822	P	41900	71	41971	0.00260
ERR675529_1_kneaddata_paired	Actinobacteriota	615	P	17457	28	17485	0.00108
ERR675529_1_kneaddata_paired	Cyanobacteria	9876	P	5275	56	5331	0.00033
ERR675529_1_kneaddata_paired	Campylobacterota	8700	P	146	0	146	0.00001
ERR675529_1_kneaddata_paired	Firmicutes_B	17289	P	143	2	145	0.00001
ERR675529_1_kneaddata_paired	Spirochaetota	32587	P	109	0	109	0.00001
ERR675529_1_kneaddata_paired	Firmicutes_I	18140	P	88	0	88	0.00001
ERR675529_1_kneaddata_paired	Firmicutes_C	17613	P	35	0	35	0.00000
ERR675529_1_kneaddata_paired	Elusimicrobiota	11888	P	16	0	16	0.00000
ERR675529_1_kneaddata_paired	Thermotogota	33086	P	10	0	10	0.00000
ERR675530_1_kneaddata_paired	Firmicutes_A	14608	P	6736516	9425	6745941	0.51390
ERR675530_1_kneaddata_paired	Bacteroidota	4587	P	2080751	7977	2088728	0.15912
ERR675530_1_kneaddata_paired	Firmicutes	12188	P	1718396	35799	1754195	0.13363
ERR675530_1_kneaddata_paired	Verrucomicrobiota	33333	P	1636778	24929	1661707	0.12659
ERR675530_1_kneaddata_paired	Actinobacteriota	615	P	529995	3834	533829	0.04067
ERR675530_1_kneaddata_paired	Desulfobacterota_A	11509	P	263127	10009	273136	0.02081
ERR675530_1_kneaddata_paired	Deferribacterota	10822	P	47366	45	47411	0.00361
ERR675530_1_kneaddata_paired	Firmicutes_B	17289	P	16526	155	16681	0.00127
ERR675530_1_kneaddata_paired	Proteobacteria	22518	P	4114	4	4118	0.00031
ERR675530_1_kneaddata_paired	Cyanobacteria	9876	P	615	5	620	0.00005
ERR675530_1_kneaddata_paired	Spirochaetota	32587	P	373	0	373	0.00003
ERR675530_1_kneaddata_paired	Campylobacterota	8700	P	104	0	104	0.00001
ERR675530_1_kneaddata_paired	Firmicutes_C	17613	P	80	0	80	0.00001
ERR675530_1_kneaddata_paired	Firmicutes_I	18140	P	73	0	73	0.00001
ERR675530_1_kneaddata_paired	Thermotogota	33086	P	13	0	13	0.00000
ERR675530_1_kneaddata_paired	Elusimicrobiota	11888	P	11	0	11	0.00000
ERR675531_1_kneaddata_paired	Firmicutes_A	14608	P	9823840	23608	9847448	0.65391
ERR675531_1_kneaddata_paired	Bacteroidota	4587	P	2858194	7823	2866017	0.19032
ERR675531_1_kneaddata_paired	Verrucomicrobiota	33333	P	1573417	39030	1612447	0.10707
ERR675531_1_kneaddata_paired	Desulfobacterota_A	11509	P	298606	18784	317390	0.02108
ERR675531_1_kneaddata_paired	Firmicutes	12188	P	282302	1063	283365	0.01882
ERR675531_1_kneaddata_paired	Actinobacteriota	615	P	66813	92	66905	0.00444
ERR675531_1_kneaddata_paired	Deferribacterota	10822	P	47574	74	47648	0.00316
ERR675531_1_kneaddata_paired	Firmicutes_B	17289	P	12120	185	12305	0.00082
ERR675531_1_kneaddata_paired	Proteobacteria	22518	P	3706	7	3713	0.00025
ERR675531_1_kneaddata_paired	Cyanobacteria	9876	P	1267	18	1285	0.00009
ERR675531_1_kneaddata_paired	Spirochaetota	32587	P	404	0	404	0.00003
ERR675531_1_kneaddata_paired	Campylobacterota	8700	P	144	0	144	0.00001
ERR675531_1_kneaddata_paired	Firmicutes_C	17613	P	109	0	109	0.00001
ERR675531_1_kneaddata_paired	Firmicutes_I	18140	P	84	0	84	0.00001
ERR675531_1_kneaddata_paired	Thermotogota	33086	P	20	0	20	0.00000
ERR675531_1_kneaddata_paired	Elusimicrobiota	11888	P	15	0	15	0.00000
ERR675532_1_kneaddata_paired	Firmicutes_A	14608	P	10527079	44283	10571362	0.73555
ERR675532_1_kneaddata_paired	Bacteroidota	4587	P	3086386	13406	3099792	0.21568
ERR675532_1_kneaddata_paired	Desulfobacterota_A	11509	P	265488	26408	291896	0.02031
ERR675532_1_kneaddata_paired	Firmicutes	12188	P	225780	1406	227186	0.01581
ERR675532_1_kneaddata_paired	Deferribacterota	10822	P	104265	272	104537	0.00727
ERR675532_1_kneaddata_paired	Verrucomicrobiota	33333	P	36147	1512	37659	0.00262
ERR675532_1_kneaddata_paired	Actinobacteriota	615	P	32252	63	32315	0.00225
ERR675532_1_kneaddata_paired	Proteobacteria	22518	P	4963	18	4981	0.00035
ERR675532_1_kneaddata_paired	Cyanobacteria	9876	P	942	19	961	0.00007
ERR675532_1_kneaddata_paired	Firmicutes_B	17289	P	522	13	535	0.00004
ERR675532_1_kneaddata_paired	Spirochaetota	32587	P	450	0	450	0.00003
ERR675532_1_kneaddata_paired	Campylobacterota	8700	P	159	0	159	0.00001
ERR675532_1_kneaddata_paired	Firmicutes_I	18140	P	111	0	111	0.00001
ERR675532_1_kneaddata_paired	Firmicutes_C	17613	P	100	0	100	0.00001
ERR675532_1_kneaddata_paired	Thermotogota	33086	P	25	0	25	0.00000
ERR675532_1_kneaddata_paired	Elusimicrobiota	11888	P	14	0	14	0.00000
ERR675533_1_kneaddata_paired	Firmicutes_A	14608	P	17560320	109128	17669448	0.88400
ERR675533_1_kneaddata_paired	Bacteroidota	4587	P	2091283	20244	2111527	0.10564
ERR675533_1_kneaddata_paired	Firmicutes	12188	P	127238	2800	130038	0.00651
ERR675533_1_kneaddata_paired	Verrucomicrobiota	33333	P	35553	2298	37851	0.00189
ERR675533_1_kneaddata_paired	Actinobacteriota	615	P	27148	165	27313	0.00137
ERR675533_1_kneaddata_paired	Desulfobacterota_A	11509	P	5319	896	6215	0.00031
ERR675533_1_kneaddata_paired	Firmicutes_B	17289	P	2599	107	2706	0.00014
ERR675533_1_kneaddata_paired	Cyanobacteria	9876	P	1247	19	1266	0.00006
ERR675533_1_kneaddata_paired	Proteobacteria	22518	P	968	12	980	0.00005
ERR675533_1_kneaddata_paired	Spirochaetota	32587	P	267	1	268	0.00001
ERR675533_1_kneaddata_paired	Firmicutes_I	18140	P	189	0	189	0.00001
ERR675533_1_kneaddata_paired	Firmicutes_C	17613	P	140	0	140	0.00001
ERR675533_1_kneaddata_paired	Campylobacterota	8700	P	69	0	69	0.00000
ERR675533_1_kneaddata_paired	Deferribacterota	10822	P	36	0	36	0.00000
ERR675533_1_kneaddata_paired	Elusimicrobiota	11888	P	11	0	11	0.00000
ERR675533_1_kneaddata_paired	Thermotogota	33086	P	4	0	4	0.00000
ERR675534_1_kneaddata_paired	Firmicutes_A	14608	P	14966519	101635	15068154	0.86669
ERR675534_1_kneaddata_paired	Bacteroidota	4587	P	1975396	17694	1993090	0.11464
ERR675534_1_kneaddata_paired	Firmicutes	12188	P	263463	6384	269847	0.01552
ERR675534_1_kneaddata_paired	Actinobacteriota	615	P	37088	194	37282	0.00214
ERR675534_1_kneaddata_paired	Verrucomicrobiota	33333	P	6885	411	7296	0.00042
ERR675534_1_kneaddata_paired	Desulfobacterota_A	11509	P	4569	699	5268	0.00030
ERR675534_1_kneaddata_paired	Firmicutes_B	17289	P	1982	74	2056	0.00012
ERR675534_1_kneaddata_paired	Cyanobacteria	9876	P	1168	16	1184	0.00007
ERR675534_1_kneaddata_paired	Proteobacteria	22518	P	1025	17	1042	0.00006
ERR675534_1_kneaddata_paired	Spirochaetota	32587	P	238	1	239	0.00001
ERR675534_1_kneaddata_paired	Firmicutes_I	18140	P	147	0	147	0.00001
ERR675534_1_kneaddata_paired	Firmicutes_C	17613	P	107	0	107	0.00001
ERR675534_1_kneaddata_paired	Campylobacterota	8700	P	45	0	45	0.00000
ERR675534_1_kneaddata_paired	Deferribacterota	10822	P	37	0	37	0.00000
ERR675534_1_kneaddata_paired	Elusimicrobiota	11888	P	7	0	7	0.00000
ERR675534_1_kneaddata_paired	Thermotogota	33086	P	2	0	2	0.00000
ERR675535_1_kneaddata_paired	Firmicutes_A	14608	P	12731882	86802	12818684	0.85855
ERR675535_1_kneaddata_paired	Bacteroidota	4587	P	1883741	16764	1900505	0.12729
ERR675535_1_kneaddata_paired	Firmicutes	12188	P	175007	3148	178155	0.01193
ERR675535_1_kneaddata_paired	Actinobacteriota	615	P	21317	97	21414	0.00143
ERR675535_1_kneaddata_paired	Verrucomicrobiota	33333	P	3487	210	3697	0.00025
ERR675535_1_kneaddata_paired	Desulfobacterota_A	11509	P	3049	460	3509	0.00024
ERR675535_1_kneaddata_paired	Firmicutes_B	17289	P	2133	80	2213	0.00015
ERR675535_1_kneaddata_paired	Cyanobacteria	9876	P	1078	19	1097	0.00007
ERR675535_1_kneaddata_paired	Proteobacteria	22518	P	782	6	788	0.00005
ERR675535_1_kneaddata_paired	Spirochaetota	32587	P	196	0	196	0.00001
ERR675535_1_kneaddata_paired	Firmicutes_I	18140	P	161	0	161	0.00001
ERR675535_1_kneaddata_paired	Firmicutes_C	17613	P	119	0	119	0.00001
ERR675535_1_kneaddata_paired	Deferribacterota	10822	P	60	0	60	0.00000
ERR675535_1_kneaddata_paired	Campylobacterota	8700	P	46	0	46	0.00000
ERR675535_1_kneaddata_paired	Elusimicrobiota	11888	P	10	0	10	0.00000
ERR675535_1_kneaddata_paired	Thermotogota	33086	P	5	0	5	0.00000
ERR675536_1_kneaddata_paired	Firmicutes_A	14608	P	9440137	54559	9494696	0.89702
ERR675536_1_kneaddata_paired	Bacteroidota	4587	P	929853	8700	938553	0.08867
ERR675536_1_kneaddata_paired	Firmicutes	12188	P	115348	3057	118405	0.01119
ERR675536_1_kneaddata_paired	Actinobacteriota	615	P	18709	86	18795	0.00178
ERR675536_1_kneaddata_paired	Verrucomicrobiota	33333	P	7603	462	8065	0.00076
ERR675536_1_kneaddata_paired	Desulfobacterota_A	11509	P	2251	331	2582	0.00024
ERR675536_1_kneaddata_paired	Firmicutes_B	17289	P	1744	66	1810	0.00017
ERR675536_1_kneaddata_paired	Cyanobacteria	9876	P	964	19	983	0.00009
ERR675536_1_kneaddata_paired	Proteobacteria	22518	P	489	3	492	0.00005
ERR675536_1_kneaddata_paired	Spirochaetota	32587	P	96	0	96	0.00001
ERR675536_1_kneaddata_paired	Firmicutes_I	18140	P	95	0	95	0.00001
ERR675536_1_kneaddata_paired	Firmicutes_C	17613	P	57	0	57	0.00001
ERR675536_1_kneaddata_paired	Campylobacterota	8700	P	23	0	23	0.00000
ERR675536_1_kneaddata_paired	Deferribacterota	10822	P	19	0	19	0.00000
ERR675536_1_kneaddata_paired	Thermotogota	33086	P	10	0	10	0.00000
ERR675536_1_kneaddata_paired	Elusimicrobiota	11888	P	7	0	7	0.00000
ERR675537_1_kneaddata_paired	Firmicutes_A	14608	P	7410652	43776	7454428	0.87003
ERR675537_1_kneaddata_paired	Bacteroidota	4587	P	1026652	11954	1038606	0.12122
ERR675537_1_kneaddata_paired	Firmicutes	12188	P	60552	1925	62477	0.00729
ERR675537_1_kneaddata_paired	Actinobacteriota	615	P	5618	25	5643	0.00066
ERR675537_1_kneaddata_paired	Desulfobacterota_A	11509	P	2335	398	2733	0.00032
ERR675537_1_kneaddata_paired	Firmicutes_B	17289	P	1892	77	1969	0.00023
ERR675537_1_kneaddata_paired	Cyanobacteria	9876	P	914	22	936	0.00011
ERR675537_1_kneaddata_paired	Proteobacteria	22518	P	399	3	402	0.00005
ERR675537_1_kneaddata_paired	Verrucomicrobiota	33333	P	393	23	416	0.00005
ERR675537_1_kneaddata_paired	Spirochaetota	32587	P	131	0	131	0.00002
ERR675537_1_kneaddata_paired	Firmicutes_I	18140	P	108	0	108	0.00001
ERR675537_1_kneaddata_paired	Firmicutes_C	17613	P	69	0	69	0.00001
ERR675537_1_kneaddata_paired	Campylobacterota	8700	P	34	0	34	0.00000
ERR675537_1_kneaddata_paired	Deferribacterota	10822	P	30	0	30	0.00000
ERR675537_1_kneaddata_paired	Thermotogota	33086	P	11	0	11	0.00000
ERR675537_1_kneaddata_paired	Elusimicrobiota	11888	P	3	0	3	0.00000
ERR675538_1_kneaddata_paired	Firmicutes_A	14608	P	7208275	49274	7257549	0.86233
ERR675538_1_kneaddata_paired	Bacteroidota	4587	P	723627	6379	730006	0.08674
ERR675538_1_kneaddata_paired	Firmicutes	12188	P	402649	9049	411698	0.04892
ERR675538_1_kneaddata_paired	Actinobacteriota	615	P	7347	50	7397	0.00088
ERR675538_1_kneaddata_paired	Desulfobacterota_A	11509	P	3973	602	4575	0.00054
ERR675538_1_kneaddata_paired	Cyanobacteria	9876	P	2031	15	2046	0.00024
ERR675538_1_kneaddata_paired	Firmicutes_B	17289	P	1227	42	1269	0.00015
ERR675538_1_kneaddata_paired	Verrucomicrobiota	33333	P	657	34	691	0.00008
ERR675538_1_kneaddata_paired	Proteobacteria	22518	P	479	7	486	0.00006
ERR675538_1_kneaddata_paired	Spirochaetota	32587	P	252	0	252	0.00003
ERR675538_1_kneaddata_paired	Firmicutes_C	17613	P	93	0	93	0.00001
ERR675538_1_kneaddata_paired	Firmicutes_I	18140	P	93	0	93	0.00001
ERR675538_1_kneaddata_paired	Campylobacterota	8700	P	40	0	40	0.00000
ERR675538_1_kneaddata_paired	Deferribacterota	10822	P	31	0	31	0.00000
ERR675538_1_kneaddata_paired	Elusimicrobiota	11888	P	7	0	7	0.00000
ERR675538_1_kneaddata_paired	Thermotogota	33086	P	1	0	1	0.00000
ERR675539_1_kneaddata_paired	Firmicutes_A	14608	P	13219825	83677	13303502	0.85706
ERR675539_1_kneaddata_paired	Bacteroidota	4587	P	1968675	20916	1989591	0.12818
ERR675539_1_kneaddata_paired	Firmicutes	12188	P	199527	4529	204056	0.01315
ERR675539_1_kneaddata_paired	Actinobacteriota	615	P	9822	75	9897	0.00064
ERR675539_1_kneaddata_paired	Desulfobacterota_A	11509	P	4326	764	5090	0.00033
ERR675539_1_kneaddata_paired	Verrucomicrobiota	33333	P	3877	273	4150	0.00027
ERR675539_1_kneaddata_paired	Firmicutes_B	17289	P	2716	118	2834	0.00018
ERR675539_1_kneaddata_paired	Cyanobacteria	9876	P	1376	28	1404	0.00009
ERR675539_1_kneaddata_paired	Proteobacteria	22518	P	979	18	997	0.00006
ERR675539_1_kneaddata_paired	Spirochaetota	32587	P	244	1	245	0.00002
ERR675539_1_kneaddata_paired	Firmicutes_I	18140	P	143	0	143	0.00001
ERR675539_1_kneaddata_paired	Firmicutes_C	17613	P	102	0	102	0.00001
ERR675539_1_kneaddata_paired	Campylobacterota	8700	P	66	0	66	0.00000
ERR675539_1_kneaddata_paired	Deferribacterota	10822	P	59	0	59	0.00000
ERR675539_1_kneaddata_paired	Elusimicrobiota	11888	P	16	0	16	0.00000
ERR675539_1_kneaddata_paired	Thermotogota	33086	P	11	0	11	0.00000
ERR675540_1_kneaddata_paired	Firmicutes_A	14608	P	10089346	62058	10151404	0.89570
ERR675540_1_kneaddata_paired	Bacteroidota	4587	P	1008641	5941	1014582	0.08952
ERR675540_1_kneaddata_paired	Firmicutes	12188	P	149503	2234	151737	0.01339
ERR675540_1_kneaddata_paired	Actinobacteriota	615	P	7117	32	7149	0.00063
ERR675540_1_kneaddata_paired	Desulfobacterota_A	11509	P	3475	430	3905	0.00034
ERR675540_1_kneaddata_paired	Firmicutes_B	17289	P	1972	57	2029	0.00018
ERR675540_1_kneaddata_paired	Cyanobacteria	9876	P	899	11	910	0.00008
ERR675540_1_kneaddata_paired	Proteobacteria	22518	P	705	7	712	0.00006
ERR675540_1_kneaddata_paired	Verrucomicrobiota	33333	P	513	22	535	0.00005
ERR675540_1_kneaddata_paired	Spirochaetota	32587	P	237	0	237	0.00002
ERR675540_1_kneaddata_paired	Firmicutes_I	18140	P	103	0	103	0.00001
ERR675540_1_kneaddata_paired	Firmicutes_C	17613	P	77	0	77	0.00001
ERR675540_1_kneaddata_paired	Campylobacterota	8700	P	43	0	43	0.00000
ERR675540_1_kneaddata_paired	Deferribacterota	10822	P	39	0	39	0.00000
ERR675540_1_kneaddata_paired	Elusimicrobiota	11888	P	17	0	17	0.00000
ERR675540_1_kneaddata_paired	Thermotogota	33086	P	7	0	7	0.00000
ERR675541_1_kneaddata_paired	Firmicutes_A	14608	P	9463154	40115	9503269	0.60097
ERR675541_1_kneaddata_paired	Bacteroidota	4587	P	4912238	82651	4994889	0.31587
ERR675541_1_kneaddata_paired	Firmicutes	12188	P	1261574	4348	1265922	0.08005
ERR675541_1_kneaddata_paired	Actinobacteriota	615	P	39503	38	39541	0.00250
ERR675541_1_kneaddata_paired	Cyanobacteria	9876	P	4235	73	4308	0.00027
ERR675541_1_kneaddata_paired	Desulfobacterota_A	11509	P	1460	142	1602	0.00010
ERR675541_1_kneaddata_paired	Firmicutes_B	17289	P	1220	33	1253	0.00008
ERR675541_1_kneaddata_paired	Proteobacteria	22518	P	688	5	693	0.00004
ERR675541_1_kneaddata_paired	Campylobacterota	8700	P	394	0	394	0.00002
ERR675541_1_kneaddata_paired	Spirochaetota	32587	P	361	0	361	0.00002
ERR675541_1_kneaddata_paired	Verrucomicrobiota	33333	P	316	13	329	0.00002
ERR675541_1_kneaddata_paired	Deferribacterota	10822	P	263	0	263	0.00002
ERR675541_1_kneaddata_paired	Firmicutes_I	18140	P	174	0	174	0.00001
ERR675541_1_kneaddata_paired	Thermotogota	33086	P	96	0	96	0.00001
ERR675541_1_kneaddata_paired	Firmicutes_C	17613	P	64	0	64	0.00000
ERR675541_1_kneaddata_paired	Elusimicrobiota	11888	P	12	0	12	0.00000
ERR675542_1_kneaddata_paired	Firmicutes_A	14608	P	15660842	65543	15726385	0.80735
ERR675542_1_kneaddata_paired	Bacteroidota	4587	P	3251807	58505	3310312	0.16994
ERR675542_1_kneaddata_paired	Firmicutes	12188	P	420944	3608	424552	0.02180
ERR675542_1_kneaddata_paired	Actinobacteriota	615	P	8921	10	8931	0.00046
ERR675542_1_kneaddata_paired	Cyanobacteria	9876	P	2572	41	2613	0.00013
ERR675542_1_kneaddata_paired	Desulfobacterota_A	11509	P	2262	249	2511	0.00013
ERR675542_1_kneaddata_paired	Firmicutes_B	17289	P	1550	42	1592	0.00008
ERR675542_1_kneaddata_paired	Proteobacteria	22518	P	629	3	632	0.00003
ERR675542_1_kneaddata_paired	Verrucomicrobiota	33333	P	385	15	400	0.00002
ERR675542_1_kneaddata_paired	Spirochaetota	32587	P	315	0	315	0.00002
ERR675542_1_kneaddata_paired	Campylobacterota	8700	P	257	0	257	0.00001
ERR675542_1_kneaddata_paired	Thermotogota	33086	P	191	0	191	0.00001
ERR675542_1_kneaddata_paired	Firmicutes_I	18140	P	142	0	142	0.00001
ERR675542_1_kneaddata_paired	Deferribacterota	10822	P	128	0	128	0.00001
ERR675542_1_kneaddata_paired	Firmicutes_C	17613	P	84	0	84	0.00000
ERR675542_1_kneaddata_paired	Elusimicrobiota	11888	P	8	0	8	0.00000
ERR675543_1_kneaddata_paired	Bacteroidota	4587	P	9147134	192620	9339754	0.50086
ERR675543_1_kneaddata_paired	Firmicutes_A	14608	P	7649494	36333	7685827	0.41217
ERR675543_1_kneaddata_paired	Firmicutes	12188	P	1567022	3478	1570500	0.08422
ERR675543_1_kneaddata_paired	Actinobacteriota	615	P	41455	40	41495	0.00223
ERR675543_1_kneaddata_paired	Cyanobacteria	9876	P	5625	192	5817	0.00031
ERR675543_1_kneaddata_paired	Desulfobacterota_A	11509	P	1022	98	1120	0.00006
ERR675543_1_kneaddata_paired	Firmicutes_B	17289	P	803	22	825	0.00004
ERR675543_1_kneaddata_paired	Proteobacteria	22518	P	507	2	509	0.00003
ERR675543_1_kneaddata_paired	Campylobacterota	8700	P	463	0	463	0.00002
ERR675543_1_kneaddata_paired	Spirochaetota	32587	P	333	0	333	0.00002
ERR675543_1_kneaddata_paired	Firmicutes_I	18140	P	218	0	218	0.00001
ERR675543_1_kneaddata_paired	Deferribacterota	10822	P	204	0	204	0.00001
ERR675543_1_kneaddata_paired	Verrucomicrobiota	33333	P	122	4	126	0.00001
ERR675543_1_kneaddata_paired	Firmicutes_C	17613	P	72	0	72	0.00000
ERR675543_1_kneaddata_paired	Thermotogota	33086	P	60	0	60	0.00000
ERR675543_1_kneaddata_paired	Elusimicrobiota	11888	P	10	0	10	0.00000
ERR675544_1_kneaddata_paired	Firmicutes_A	14608	P	9265771	35546	9301317	0.51398
ERR675544_1_kneaddata_paired	Bacteroidota	4587	P	7422735	138403	7561138	0.41782
ERR675544_1_kneaddata_paired	Firmicutes	12188	P	1182999	2077	1185076	0.06549
ERR675544_1_kneaddata_paired	Actinobacteriota	615	P	34840	35	34875	0.00193
ERR675544_1_kneaddata_paired	Cyanobacteria	9876	P	8330	308	8638	0.00048
ERR675544_1_kneaddata_paired	Firmicutes_B	17289	P	1557	41	1598	0.00009
ERR675544_1_kneaddata_paired	Desulfobacterota_A	11509	P	1335	124	1459	0.00008
ERR675544_1_kneaddata_paired	Proteobacteria	22518	P	641	2	643	0.00004
ERR675544_1_kneaddata_paired	Campylobacterota	8700	P	552	0	552	0.00003
ERR675544_1_kneaddata_paired	Spirochaetota	32587	P	417	0	417	0.00002
ERR675544_1_kneaddata_paired	Deferribacterota	10822	P	340	0	340	0.00002
ERR675544_1_kneaddata_paired	Firmicutes_I	18140	P	222	0	222	0.00001
ERR675544_1_kneaddata_paired	Verrucomicrobiota	33333	P	213	8	221	0.00001
ERR675544_1_kneaddata_paired	Firmicutes_C	17613	P	76	0	76	0.00000
ERR675544_1_kneaddata_paired	Thermotogota	33086	P	57	0	57	0.00000
ERR675544_1_kneaddata_paired	Elusimicrobiota	11888	P	6	0	6	0.00000
ERR675545_1_kneaddata_paired	Firmicutes_A	14608	P	5681021	20768	5701789	0.65481
ERR675545_1_kneaddata_paired	Bacteroidota	4587	P	2620777	36015	2656792	0.30511
ERR675545_1_kneaddata_paired	Firmicutes	12188	P	300099	1374	301473	0.03462
ERR675545_1_kneaddata_paired	Actinobacteriota	615	P	41702	34	41736	0.00479
ERR675545_1_kneaddata_paired	Cyanobacteria	9876	P	3270	71	3341	0.00038
ERR675545_1_kneaddata_paired	Desulfobacterota_A	11509	P	765	70	835	0.00010
ERR675545_1_kneaddata_paired	Firmicutes_B	17289	P	714	17	731	0.00008
ERR675545_1_kneaddata_paired	Proteobacteria	22518	P	246	1	247	0.00003
ERR675545_1_kneaddata_paired	Verrucomicrobiota	33333	P	176	6	182	0.00002
ERR675545_1_kneaddata_paired	Spirochaetota	32587	P	144	0	144	0.00002
ERR675545_1_kneaddata_paired	Campylobacterota	8700	P	97	0	97	0.00001
ERR675545_1_kneaddata_paired	Deferribacterota	10822	P	56	0	56	0.00001
ERR675545_1_kneaddata_paired	Firmicutes_I	18140	P	52	0	52	0.00001
ERR675545_1_kneaddata_paired	Firmicutes_C	17613	P	39	0	39	0.00000
ERR675545_1_kneaddata_paired	Thermotogota	33086	P	16	0	16	0.00000
ERR675545_1_kneaddata_paired	Elusimicrobiota	11888	P	4	0	4	0.00000
ERR675546_1_kneaddata_paired	Bacteroidota	4587	P	9325403	149857	9475260	0.51744
ERR675546_1_kneaddata_paired	Firmicutes_A	14608	P	8199793	33847	8233640	0.44963
ERR675546_1_kneaddata_paired	Firmicutes	12188	P	497224	1163	498387	0.02722
ERR675546_1_kneaddata_paired	Actinobacteriota	615	P	94637	76	94713	0.00517
ERR675546_1_kneaddata_paired	Cyanobacteria	9876	P	6679	224	6903	0.00038
ERR675546_1_kneaddata_paired	Desulfobacterota_A	11509	P	910	68	978	0.00005
ERR675546_1_kneaddata_paired	Firmicutes_B	17289	P	877	20	897	0.00005
ERR675546_1_kneaddata_paired	Proteobacteria	22518	P	461	2	463	0.00003
ERR675546_1_kneaddata_paired	Spirochaetota	32587	P	207	0	207	0.00001
ERR675546_1_kneaddata_paired	Verrucomicrobiota	33333	P	171	6	177	0.00001
ERR675546_1_kneaddata_paired	Campylobacterota	8700	P	115	0	115	0.00001
ERR675546_1_kneaddata_paired	Firmicutes_I	18140	P	83	0	83	0.00000
ERR675546_1_kneaddata_paired	Deferribacterota	10822	P	57	0	57	0.00000
ERR675546_1_kneaddata_paired	Firmicutes_C	17613	P	42	0	42	0.00000
ERR675546_1_kneaddata_paired	Thermotogota	33086	P	29	0	29	0.00000
ERR675546_1_kneaddata_paired	Elusimicrobiota	11888	P	7	0	7	0.00000
ERR675547_1_kneaddata_paired	Firmicutes_A	14608	P	9807005	34742	9841747	0.46467
ERR675547_1_kneaddata_paired	Bacteroidota	4587	P	9166544	145717	9312261	0.43967
ERR675547_1_kneaddata_paired	Firmicutes	12188	P	1853587	5627	1859214	0.08778
ERR675547_1_kneaddata_paired	Actinobacteriota	615	P	154817	111	154928	0.00731
ERR675547_1_kneaddata_paired	Cyanobacteria	9876	P	7122	263	7385	0.00035
ERR675547_1_kneaddata_paired	Firmicutes_B	17289	P	1419	34	1453	0.00007
ERR675547_1_kneaddata_paired	Desulfobacterota_A	11509	P	1308	106	1414	0.00007
ERR675547_1_kneaddata_paired	Proteobacteria	22518	P	602	2	604	0.00003
ERR675547_1_kneaddata_paired	Spirochaetota	32587	P	261	0	261	0.00001
ERR675547_1_kneaddata_paired	Campylobacterota	8700	P	224	0	224	0.00001
ERR675547_1_kneaddata_paired	Verrucomicrobiota	33333	P	191	6	197	0.00001
ERR675547_1_kneaddata_paired	Firmicutes_I	18140	P	165	0	165	0.00001
ERR675547_1_kneaddata_paired	Deferribacterota	10822	P	149	0	149	0.00001
ERR675547_1_kneaddata_paired	Firmicutes_C	17613	P	71	0	71	0.00000
ERR675547_1_kneaddata_paired	Thermotogota	33086	P	54	0	54	0.00000
ERR675547_1_kneaddata_paired	Elusimicrobiota	11888	P	13	0	13	0.00000
ERR675548_1_kneaddata_paired	Firmicutes_A	14608	P	12250973	51899	12302872	0.63939
ERR675548_1_kneaddata_paired	Bacteroidota	4587	P	5736398	97665	5834063	0.30320
ERR675548_1_kneaddata_paired	Firmicutes	12188	P	1015758	2369	1018127	0.05291
ERR675548_1_kneaddata_paired	Actinobacteriota	615	P	72580	69	72649	0.00378
ERR675548_1_kneaddata_paired	Cyanobacteria	9876	P	8825	348	9173	0.00048
ERR675548_1_kneaddata_paired	Desulfobacterota_A	11509	P	1708	175	1883	0.00010
ERR675548_1_kneaddata_paired	Firmicutes_B	17289	P	1118	30	1148	0.00006
ERR675548_1_kneaddata_paired	Proteobacteria	22518	P	589	3	592	0.00003
ERR675548_1_kneaddata_paired	Spirochaetota	32587	P	226	0	226	0.00001
ERR675548_1_kneaddata_paired	Campylobacterota	8700	P	201	0	201	0.00001
ERR675548_1_kneaddata_paired	Verrucomicrobiota	33333	P	174	6	180	0.00001
ERR675548_1_kneaddata_paired	Firmicutes_I	18140	P	173	0	173	0.00001
ERR675548_1_kneaddata_paired	Deferribacterota	10822	P	160	0	160	0.00001
ERR675548_1_kneaddata_paired	Firmicutes_C	17613	P	77	0	77	0.00000
ERR675548_1_kneaddata_paired	Thermotogota	33086	P	70	0	70	0.00000
ERR675548_1_kneaddata_paired	Elusimicrobiota	11888	P	12	0	12	0.00000
ERR675549_1_kneaddata_paired	Firmicutes_A	14608	P	7860159	36203	7896362	0.47793
ERR675549_1_kneaddata_paired	Bacteroidota	4587	P	7147641	98931	7246572	0.43860
ERR675549_1_kneaddata_paired	Firmicutes	12188	P	1338616	9962	1348578	0.08162
ERR675549_1_kneaddata_paired	Actinobacteriota	615	P	25268	31	25299	0.00153
ERR675549_1_kneaddata_paired	Cyanobacteria	9876	P	2225	44	2269	0.00014
ERR675549_1_kneaddata_paired	Desulfobacterota_A	11509	P	999	100	1099	0.00007
ERR675549_1_kneaddata_paired	Firmicutes_B	17289	P	743	20	763	0.00005
ERR675549_1_kneaddata_paired	Proteobacteria	22518	P	398	2	400	0.00002
ERR675549_1_kneaddata_paired	Verrucomicrobiota	33333	P	164	6	170	0.00001
ERR675549_1_kneaddata_paired	Spirochaetota	32587	P	106	0	106	0.00001
ERR675549_1_kneaddata_paired	Campylobacterota	8700	P	97	0	97	0.00001
ERR675549_1_kneaddata_paired	Deferribacterota	10822	P	86	0	86	0.00001
ERR675549_1_kneaddata_paired	Firmicutes_I	18140	P	77	0	77	0.00000
ERR675549_1_kneaddata_paired	Firmicutes_C	17613	P	52	0	52	0.00000
ERR675549_1_kneaddata_paired	Thermotogota	33086	P	45	0	45	0.00000
ERR675549_1_kneaddata_paired	Elusimicrobiota	11888	P	7	0	7	0.00000
ERR675550_1_kneaddata_paired	Bacteroidota	4587	P	11091273	146645	11237918	0.60959
ERR675550_1_kneaddata_paired	Firmicutes_A	14608	P	6137564	26556	6164120	0.33436
ERR675550_1_kneaddata_paired	Firmicutes	12188	P	972647	7447	980094	0.05316
ERR675550_1_kneaddata_paired	Actinobacteriota	615	P	47855	61	47916	0.00260
ERR675550_1_kneaddata_paired	Cyanobacteria	9876	P	2664	68	2732	0.00015
ERR675550_1_kneaddata_paired	Desulfobacterota_A	11509	P	684	71	755	0.00004
ERR675550_1_kneaddata_paired	Firmicutes_B	17289	P	678	19	697	0.00004
ERR675550_1_kneaddata_paired	Proteobacteria	22518	P	449	1	450	0.00002
ERR675550_1_kneaddata_paired	Deferribacterota	10822	P	153	0	153	0.00001
ERR675550_1_kneaddata_paired	Spirochaetota	32587	P	139	0	139	0.00001
ERR675550_1_kneaddata_paired	Campylobacterota	8700	P	104	0	104	0.00001
ERR675550_1_kneaddata_paired	Verrucomicrobiota	33333	P	86	3	89	0.00000
ERR675550_1_kneaddata_paired	Thermotogota	33086	P	77	0	77	0.00000
ERR675550_1_kneaddata_paired	Firmicutes_I	18140	P	49	0	49	0.00000
ERR675550_1_kneaddata_paired	Firmicutes_C	17613	P	26	0	26	0.00000
ERR675550_1_kneaddata_paired	Elusimicrobiota	11888	P	1	0	1	0.00000
ERR675551_1_kneaddata_paired	Firmicutes_A	14608	P	9374668	43667	9418335	0.54190
ERR675551_1_kneaddata_paired	Bacteroidota	4587	P	7673844	88050	7761894	0.44659
ERR675551_1_kneaddata_paired	Firmicutes	12188	P	147821	1784	149605	0.00861
ERR675551_1_kneaddata_paired	Actinobacteriota	615	P	38994	52	39046	0.00225
ERR675551_1_kneaddata_paired	Cyanobacteria	9876	P	7369	373	7742	0.00045
ERR675551_1_kneaddata_paired	Desulfobacterota_A	11509	P	1334	154	1488	0.00009
ERR675551_1_kneaddata_paired	Firmicutes_B	17289	P	1057	30	1087	0.00006
ERR675551_1_kneaddata_paired	Proteobacteria	22518	P	479	0	479	0.00003
ERR675551_1_kneaddata_paired	Verrucomicrobiota	33333	P	214	8	222	0.00001
ERR675551_1_kneaddata_paired	Deferribacterota	10822	P	112	0	112	0.00001
ERR675551_1_kneaddata_paired	Spirochaetota	32587	P	95	0	95	0.00001
ERR675551_1_kneaddata_paired	Thermotogota	33086	P	67	0	67	0.00000
ERR675551_1_kneaddata_paired	Firmicutes_I	18140	P	63	0	63	0.00000
ERR675551_1_kneaddata_paired	Campylobacterota	8700	P	55	0	55	0.00000
ERR675551_1_kneaddata_paired	Firmicutes_C	17613	P	45	0	45	0.00000
ERR675551_1_kneaddata_paired	Elusimicrobiota	11888	P	5	0	5	0.00000
ERR675552_1_kneaddata_paired	Bacteroidota	4587	P	11751863	122079	11873942	0.61717
ERR675552_1_kneaddata_paired	Firmicutes_A	14608	P	6533335	33669	6567004	0.34133
ERR675552_1_kneaddata_paired	Firmicutes	12188	P	736056	5262	741318	0.03853
ERR675552_1_kneaddata_paired	Actinobacteriota	615	P	51479	60	51539	0.00268
ERR675552_1_kneaddata_paired	Cyanobacteria	9876	P	2248	48	2296	0.00012
ERR675552_1_kneaddata_paired	Desulfobacterota_A	11509	P	985	95	1080	0.00006
ERR675552_1_kneaddata_paired	Firmicutes_B	17289	P	793	20	813	0.00004
ERR675552_1_kneaddata_paired	Proteobacteria	22518	P	537	2	539	0.00003
ERR675552_1_kneaddata_paired	Verrucomicrobiota	33333	P	156	6	162	0.00001
ERR675552_1_kneaddata_paired	Deferribacterota	10822	P	143	0	143	0.00001
ERR675552_1_kneaddata_paired	Spirochaetota	32587	P	129	0	129	0.00001
ERR675552_1_kneaddata_paired	Campylobacterota	8700	P	70	0	70	0.00000
ERR675552_1_kneaddata_paired	Thermotogota	33086	P	65	0	65	0.00000
ERR675552_1_kneaddata_paired	Firmicutes_I	18140	P	55	0	55	0.00000
ERR675552_1_kneaddata_paired	Firmicutes_C	17613	P	27	0	27	0.00000
ERR675552_1_kneaddata_paired	Elusimicrobiota	11888	P	3	0	3	0.00000
ERR675553_1_kneaddata_paired	Firmicutes_A	14608	P	11932708	52250	11984958	0.69644
ERR675553_1_kneaddata_paired	Bacteroidota	4587	P	4868736	60136	4928872	0.28641
ERR675553_1_kneaddata_paired	Firmicutes	12188	P	259595	3127	262722	0.01527
ERR675553_1_kneaddata_paired	Actinobacteriota	615	P	24850	31	24881	0.00145
ERR675553_1_kneaddata_paired	Desulfobacterota_A	11509	P	2380	276	2656	0.00015
ERR675553_1_kneaddata_paired	Cyanobacteria	9876	P	2083	35	2118	0.00012
ERR675553_1_kneaddata_paired	Firmicutes_B	17289	P	1049	29	1078	0.00006
ERR675553_1_kneaddata_paired	Proteobacteria	22518	P	512	1	513	0.00003
ERR675553_1_kneaddata_paired	Verrucomicrobiota	33333	P	298	11	309	0.00002
ERR675553_1_kneaddata_paired	Campylobacterota	8700	P	183	0	183	0.00001
ERR675553_1_kneaddata_paired	Thermotogota	33086	P	160	0	160	0.00001
ERR675553_1_kneaddata_paired	Spirochaetota	32587	P	154	0	154	0.00001
ERR675553_1_kneaddata_paired	Deferribacterota	10822	P	147	0	147	0.00001
ERR675553_1_kneaddata_paired	Firmicutes_I	18140	P	95	0	95	0.00001
ERR675553_1_kneaddata_paired	Firmicutes_C	17613	P	51	0	51	0.00000
ERR675553_1_kneaddata_paired	Elusimicrobiota	11888	P	6	0	6	0.00000
ERR675554_1_kneaddata_paired	Bacteroidota	4587	P	11260470	122555	11383025	0.61744
ERR675554_1_kneaddata_paired	Firmicutes_A	14608	P	6239252	29049	6268301	0.34001
ERR675554_1_kneaddata_paired	Firmicutes	12188	P	727128	5464	732592	0.03974
ERR675554_1_kneaddata_paired	Actinobacteriota	615	P	45526	50	45576	0.00247
ERR675554_1_kneaddata_paired	Cyanobacteria	9876	P	2988	55	3043	0.00017
ERR675554_1_kneaddata_paired	Desulfobacterota_A	11509	P	1068	106	1174	0.00006
ERR675554_1_kneaddata_paired	Firmicutes_B	17289	P	797	21	818	0.00004
ERR675554_1_kneaddata_paired	Proteobacteria	22518	P	342	0	342	0.00002
ERR675554_1_kneaddata_paired	Spirochaetota	32587	P	268	0	268	0.00001
ERR675554_1_kneaddata_paired	Deferribacterota	10822	P	216	0	216	0.00001
ERR675554_1_kneaddata_paired	Verrucomicrobiota	33333	P	190	6	196	0.00001
ERR675554_1_kneaddata_paired	Campylobacterota	8700	P	125	0	125	0.00001
ERR675554_1_kneaddata_paired	Thermotogota	33086	P	63	0	63	0.00000
ERR675554_1_kneaddata_paired	Firmicutes_I	18140	P	58	0	58	0.00000
ERR675554_1_kneaddata_paired	Firmicutes_C	17613	P	27	0	27	0.00000
ERR675554_1_kneaddata_paired	Elusimicrobiota	11888	P	5	0	5	0.00000
ERR675555_1_kneaddata_paired	Bacteroidota	4587	P	10485467	108786	10594253	0.60626
ERR675555_1_kneaddata_paired	Firmicutes_A	14608	P	6265674	29388	6295062	0.36024
ERR675555_1_kneaddata_paired	Firmicutes	12188	P	533956	3795	537751	0.03077
ERR675555_1_kneaddata_paired	Actinobacteriota	615	P	42115	48	42163	0.00241
ERR675555_1_kneaddata_paired	Cyanobacteria	9876	P	2324	36	2360	0.00014
ERR675555_1_kneaddata_paired	Desulfobacterota_A	11509	P	1091	101	1192	0.00007
ERR675555_1_kneaddata_paired	Firmicutes_B	17289	P	674	17	691	0.00004
ERR675555_1_kneaddata_paired	Proteobacteria	22518	P	413	0	413	0.00002
ERR675555_1_kneaddata_paired	Verrucomicrobiota	33333	P	287	11	298	0.00002
ERR675555_1_kneaddata_paired	Spirochaetota	32587	P	274	0	274	0.00002
ERR675555_1_kneaddata_paired	Deferribacterota	10822	P	119	0	119	0.00001
ERR675555_1_kneaddata_paired	Thermotogota	33086	P	100	0	100	0.00001
ERR675555_1_kneaddata_paired	Campylobacterota	8700	P	63	0	63	0.00000
ERR675555_1_kneaddata_paired	Firmicutes_I	18140	P	60	0	60	0.00000
ERR675555_1_kneaddata_paired	Firmicutes_C	17613	P	44	0	44	0.00000
ERR675555_1_kneaddata_paired	Elusimicrobiota	11888	P	9	0	9	0.00000
ERR675556_1_kneaddata_paired	Bacteroidota	4587	P	12579636	138032	12717668	0.60953
ERR675556_1_kneaddata_paired	Firmicutes_A	14608	P	7474877	36091	7510968	0.35999
ERR675556_1_kneaddata_paired	Firmicutes	12188	P	563080	4388	567468	0.02720
ERR675556_1_kneaddata_paired	Actinobacteriota	615	P	63026	77	63103	0.00302
ERR675556_1_kneaddata_paired	Cyanobacteria	9876	P	2220	49	2269	0.00011
ERR675556_1_kneaddata_paired	Desulfobacterota_A	11509	P	1123	122	1245	0.00006
ERR675556_1_kneaddata_paired	Firmicutes_B	17289	P	652	17	669	0.00003
ERR675556_1_kneaddata_paired	Proteobacteria	22518	P	473	1	474	0.00002
ERR675556_1_kneaddata_paired	Verrucomicrobiota	33333	P	181	7	188	0.00001
ERR675556_1_kneaddata_paired	Deferribacterota	10822	P	173	0	173	0.00001
ERR675556_1_kneaddata_paired	Spirochaetota	32587	P	114	0	114	0.00001
ERR675556_1_kneaddata_paired	Thermotogota	33086	P	72	0	72	0.00000
ERR675556_1_kneaddata_paired	Firmicutes_I	18140	P	66	0	66	0.00000
ERR675556_1_kneaddata_paired	Campylobacterota	8700	P	57	0	57	0.00000
ERR675556_1_kneaddata_paired	Firmicutes_C	17613	P	34	0	34	0.00000
ERR675556_1_kneaddata_paired	Elusimicrobiota	11888	P	7	0	7	0.00000
ERR675557_1_kneaddata_paired	Bacteroidota	4587	P	8921556	192357	9113913	0.50170
ERR675557_1_kneaddata_paired	Firmicutes_A	14608	P	7434141	29732	7463873	0.41087
ERR675557_1_kneaddata_paired	Firmicutes	12188	P	1540338	13739	1554077	0.08555
ERR675557_1_kneaddata_paired	Actinobacteriota	615	P	30010	56	30066	0.00166
ERR675557_1_kneaddata_paired	Cyanobacteria	9876	P	1700	21	1721	0.00009
ERR675557_1_kneaddata_paired	Desulfobacterota_A	11509	P	780	99	879	0.00005
ERR675557_1_kneaddata_paired	Proteobacteria	22518	P	653	8	661	0.00004
ERR675557_1_kneaddata_paired	Firmicutes_B	17289	P	234	7	241	0.00001
ERR675557_1_kneaddata_paired	Campylobacterota	8700	P	171	0	171	0.00001
ERR675557_1_kneaddata_paired	Spirochaetota	32587	P	162	0	162	0.00001
ERR675557_1_kneaddata_paired	Verrucomicrobiota	33333	P	130	6	136	0.00001
ERR675557_1_kneaddata_paired	Firmicutes_C	17613	P	100	0	100	0.00001
ERR675557_1_kneaddata_paired	Deferribacterota	10822	P	91	0	91	0.00001
ERR675557_1_kneaddata_paired	Firmicutes_I	18140	P	85	0	85	0.00000
ERR675557_1_kneaddata_paired	Thermotogota	33086	P	18	0	18	0.00000
ERR675557_1_kneaddata_paired	Elusimicrobiota	11888	P	3	0	3	0.00000
ERR675558_1_kneaddata_paired	Firmicutes_A	14608	P	9577929	39840	9617769	0.63536
ERR675558_1_kneaddata_paired	Bacteroidota	4587	P	4641291	79905	4721196	0.31189
ERR675558_1_kneaddata_paired	Firmicutes	12188	P	766874	6614	773488	0.05110
ERR675558_1_kneaddata_paired	Actinobacteriota	615	P	20056	37	20093	0.00133
ERR675558_1_kneaddata_paired	Cyanobacteria	9876	P	1375	33	1408	0.00009
ERR675558_1_kneaddata_paired	Desulfobacterota_A	11509	P	1228	153	1381	0.00009
ERR675558_1_kneaddata_paired	Proteobacteria	22518	P	563	4	567	0.00004
ERR675558_1_kneaddata_paired	Firmicutes_B	17289	P	532	16	548	0.00004
ERR675558_1_kneaddata_paired	Verrucomicrobiota	33333	P	322	16	338	0.00002
ERR675558_1_kneaddata_paired	Spirochaetota	32587	P	243	0	243	0.00002
ERR675558_1_kneaddata_paired	Campylobacterota	8700	P	165	0	165	0.00001
ERR675558_1_kneaddata_paired	Firmicutes_I	18140	P	116	0	116	0.00001
ERR675558_1_kneaddata_paired	Deferribacterota	10822	P	112	0	112	0.00001
ERR675558_1_kneaddata_paired	Firmicutes_C	17613	P	40	0	40	0.00000
ERR675558_1_kneaddata_paired	Thermotogota	33086	P	13	0	13	0.00000
ERR675558_1_kneaddata_paired	Elusimicrobiota	11888	P	10	0	10	0.00000
ERR675559_1_kneaddata_paired	Firmicutes_A	14608	P	15345748	75469	15421217	0.74856
ERR675559_1_kneaddata_paired	Bacteroidota	4587	P	4798392	55870	4854262	0.23563
ERR675559_1_kneaddata_paired	Firmicutes	12188	P	225905	6699	232604	0.01129
ERR675559_1_kneaddata_paired	Cyanobacteria	9876	P	50941	3632	54573	0.00265
ERR675559_1_kneaddata_paired	Actinobacteriota	615	P	36326	69	36395	0.00177
ERR675559_1_kneaddata_paired	Proteobacteria	22518	P	596	3	599	0.00003
ERR675559_1_kneaddata_paired	Desulfobacterota_A	11509	P	562	72	634	0.00003
ERR675559_1_kneaddata_paired	Firmicutes_B	17289	P	302	10	312	0.00002
ERR675559_1_kneaddata_paired	Firmicutes_I	18140	P	156	0	156	0.00001
ERR675559_1_kneaddata_paired	Spirochaetota	32587	P	146	0	146	0.00001
ERR675559_1_kneaddata_paired	Verrucomicrobiota	33333	P	105	5	110	0.00001
ERR675559_1_kneaddata_paired	Firmicutes_C	17613	P	94	0	94	0.00000
ERR675559_1_kneaddata_paired	Campylobacterota	8700	P	52	0	52	0.00000
ERR675559_1_kneaddata_paired	Deferribacterota	10822	P	30	0	30	0.00000
ERR675559_1_kneaddata_paired	Thermotogota	33086	P	11	0	11	0.00000
ERR675560_1_kneaddata_paired	Bacteroidota	4587	P	8324269	144880	8469149	0.48442
ERR675560_1_kneaddata_paired	Firmicutes_A	14608	P	7482126	36234	7518360	0.43004
ERR675560_1_kneaddata_paired	Firmicutes	12188	P	1446807	12531	1459338	0.08347
ERR675560_1_kneaddata_paired	Actinobacteriota	615	P	28850	57	28907	0.00165
ERR675560_1_kneaddata_paired	Cyanobacteria	9876	P	4352	208	4560	0.00026
ERR675560_1_kneaddata_paired	Desulfobacterota_A	11509	P	869	113	982	0.00006
ERR675560_1_kneaddata_paired	Proteobacteria	22518	P	534	3	537	0.00003
ERR675560_1_kneaddata_paired	Firmicutes_B	17289	P	419	14	433	0.00002
ERR675560_1_kneaddata_paired	Spirochaetota	32587	P	171	0	171	0.00001
ERR675560_1_kneaddata_paired	Verrucomicrobiota	33333	P	158	7	165	0.00001
ERR675560_1_kneaddata_paired	Firmicutes_I	18140	P	155	0	155	0.00001
ERR675560_1_kneaddata_paired	Campylobacterota	8700	P	133	0	133	0.00001
ERR675560_1_kneaddata_paired	Deferribacterota	10822	P	71	0	71	0.00000
ERR675560_1_kneaddata_paired	Firmicutes_C	17613	P	28	0	28	0.00000
ERR675560_1_kneaddata_paired	Thermotogota	33086	P	20	0	20	0.00000
ERR675560_1_kneaddata_paired	Elusimicrobiota	11888	P	9	0	9	0.00000
ERR675561_1_kneaddata_paired	Bacteroidota	4587	P	8683192	213011	8896203	0.49299
ERR675561_1_kneaddata_paired	Firmicutes_A	14608	P	7737765	30726	7768491	0.43050
ERR675561_1_kneaddata_paired	Firmicutes	12188	P	1340535	10767	1351302	0.07488
ERR675561_1_kneaddata_paired	Actinobacteriota	615	P	24872	46	24918	0.00138
ERR675561_1_kneaddata_paired	Cyanobacteria	9876	P	1324	17	1341	0.00007
ERR675561_1_kneaddata_paired	Proteobacteria	22518	P	882	14	896	0.00005
ERR675561_1_kneaddata_paired	Desulfobacterota_A	11509	P	751	90	841	0.00005
ERR675561_1_kneaddata_paired	Firmicutes_B	17289	P	412	13	425	0.00002
ERR675561_1_kneaddata_paired	Spirochaetota	32587	P	267	0	267	0.00001
ERR675561_1_kneaddata_paired	Campylobacterota	8700	P	210	0	210	0.00001
ERR675561_1_kneaddata_paired	Deferribacterota	10822	P	159	0	159	0.00001
ERR675561_1_kneaddata_paired	Verrucomicrobiota	33333	P	110	5	115	0.00001
ERR675561_1_kneaddata_paired	Firmicutes_I	18140	P	50	0	50	0.00000
ERR675561_1_kneaddata_paired	Firmicutes_C	17613	P	32	0	32	0.00000
ERR675561_1_kneaddata_paired	Thermotogota	33086	P	13	0	13	0.00000
ERR675561_1_kneaddata_paired	Elusimicrobiota	11888	P	6	0	6	0.00000
ERR675562_1_kneaddata_paired	Firmicutes_A	14608	P	9248815	29966	9278781	0.56740
ERR675562_1_kneaddata_paired	Bacteroidota	4587	P	5014184	99780	5113964	0.31272
ERR675562_1_kneaddata_paired	Firmicutes	12188	P	1907504	16928	1924432	0.11768
ERR675562_1_kneaddata_paired	Actinobacteriota	615	P	31346	61	31407	0.00192
ERR675562_1_kneaddata_paired	Cyanobacteria	9876	P	1679	67	1746	0.00011
ERR675562_1_kneaddata_paired	Desulfobacterota_A	11509	P	914	123	1037	0.00006
ERR675562_1_kneaddata_paired	Proteobacteria	22518	P	729	9	738	0.00005
ERR675562_1_kneaddata_paired	Firmicutes_B	17289	P	250	8	258	0.00002
ERR675562_1_kneaddata_paired	Spirochaetota	32587	P	238	0	238	0.00001
ERR675562_1_kneaddata_paired	Verrucomicrobiota	33333	P	136	6	142	0.00001
ERR675562_1_kneaddata_paired	Campylobacterota	8700	P	101	0	101	0.00001
ERR675562_1_kneaddata_paired	Deferribacterota	10822	P	57	0	57	0.00000
ERR675562_1_kneaddata_paired	Firmicutes_I	18140	P	51	0	51	0.00000
ERR675562_1_kneaddata_paired	Firmicutes_C	17613	P	27	0	27	0.00000
ERR675562_1_kneaddata_paired	Thermotogota	33086	P	20	0	20	0.00000
ERR675562_1_kneaddata_paired	Elusimicrobiota	11888	P	8	0	8	0.00000
ERR675563_1_kneaddata_paired	Firmicutes_A	14608	P	12947945	49589	12997534	0.60172
ERR675563_1_kneaddata_paired	Bacteroidota	4587	P	6651702	175469	6827171	0.31606
ERR675563_1_kneaddata_paired	Firmicutes	12188	P	1670940	14420	1685360	0.07802
ERR675563_1_kneaddata_paired	Actinobacteriota	615	P	84528	152	84680	0.00392
ERR675563_1_kneaddata_paired	Proteobacteria	22518	P	1543	22	1565	0.00007
ERR675563_1_kneaddata_paired	Desulfobacterota_A	11509	P	1512	190	1702	0.00008
ERR675563_1_kneaddata_paired	Cyanobacteria	9876	P	1172	22	1194	0.00006
ERR675563_1_kneaddata_paired	Firmicutes_B	17289	P	640	20	660	0.00003
ERR675563_1_kneaddata_paired	Spirochaetota	32587	P	288	0	288	0.00001
ERR675563_1_kneaddata_paired	Verrucomicrobiota	33333	P	201	9	210	0.00001
ERR675563_1_kneaddata_paired	Campylobacterota	8700	P	122	0	122	0.00001
ERR675563_1_kneaddata_paired	Firmicutes_I	18140	P	65	0	65	0.00000
ERR675563_1_kneaddata_paired	Deferribacterota	10822	P	63	0	63	0.00000
ERR675563_1_kneaddata_paired	Firmicutes_C	17613	P	35	0	35	0.00000
ERR675563_1_kneaddata_paired	Thermotogota	33086	P	21	0	21	0.00000
ERR675563_1_kneaddata_paired	Elusimicrobiota	11888	P	19	0	19	0.00000
ERR675564_1_kneaddata_paired	Firmicutes_A	14608	P	11756201	47837	11804038	0.58755
ERR675564_1_kneaddata_paired	Bacteroidota	4587	P	4569678	77186	4646864	0.23130
ERR675564_1_kneaddata_paired	Firmicutes	12188	P	3558049	30402	3588451	0.17862
ERR675564_1_kneaddata_paired	Actinobacteriota	615	P	42649	82	42731	0.00213
ERR675564_1_kneaddata_paired	Cyanobacteria	9876	P	4239	69	4308	0.00021
ERR675564_1_kneaddata_paired	Desulfobacterota_A	11509	P	1276	160	1436	0.00007
ERR675564_1_kneaddata_paired	Proteobacteria	22518	P	738	5	743	0.00004
ERR675564_1_kneaddata_paired	Spirochaetota	32587	P	411	1	412	0.00002
ERR675564_1_kneaddata_paired	Firmicutes_B	17289	P	356	12	368	0.00002
ERR675564_1_kneaddata_paired	Campylobacterota	8700	P	252	0	252	0.00001
ERR675564_1_kneaddata_paired	Deferribacterota	10822	P	198	0	198	0.00001
ERR675564_1_kneaddata_paired	Verrucomicrobiota	33333	P	196	10	206	0.00001
ERR675564_1_kneaddata_paired	Firmicutes_I	18140	P	62	0	62	0.00000
ERR675564_1_kneaddata_paired	Thermotogota	33086	P	48	0	48	0.00000
ERR675564_1_kneaddata_paired	Firmicutes_C	17613	P	21	0	21	0.00000
ERR675564_1_kneaddata_paired	Elusimicrobiota	11888	P	15	0	15	0.00000
ERR675565_1_kneaddata_paired	Firmicutes_A	14608	P	8928026	29783	8957809	0.55150
ERR675565_1_kneaddata_paired	Bacteroidota	4587	P	5534909	137926	5672835	0.34926
ERR675565_1_kneaddata_paired	Firmicutes	12188	P	1588493	13689	1602182	0.09864
ERR675565_1_kneaddata_paired	Actinobacteriota	615	P	5198	7	5205	0.00032
ERR675565_1_kneaddata_paired	Firmicutes_B	17289	P	1281	44	1325	0.00008
ERR675565_1_kneaddata_paired	Desulfobacterota_A	11509	P	926	122	1048	0.00006
ERR675565_1_kneaddata_paired	Cyanobacteria	9876	P	923	28	951	0.00006
ERR675565_1_kneaddata_paired	Proteobacteria	22518	P	500	2	502	0.00003
ERR675565_1_kneaddata_paired	Spirochaetota	32587	P	179	0	179	0.00001
ERR675565_1_kneaddata_paired	Verrucomicrobiota	33333	P	175	8	183	0.00001
ERR675565_1_kneaddata_paired	Campylobacterota	8700	P	101	0	101	0.00001
ERR675565_1_kneaddata_paired	Deferribacterota	10822	P	90	0	90	0.00001
ERR675565_1_kneaddata_paired	Firmicutes_I	18140	P	60	0	60	0.00000
ERR675565_1_kneaddata_paired	Firmicutes_C	17613	P	25	0	25	0.00000
ERR675565_1_kneaddata_paired	Thermotogota	33086	P	24	0	24	0.00000
ERR675565_1_kneaddata_paired	Elusimicrobiota	11888	P	3	0	3	0.00000
ERR675566_1_kneaddata_paired	Firmicutes_A	14608	P	10850789	40301	10891090	0.54647
ERR675566_1_kneaddata_paired	Bacteroidota	4587	P	8190385	170657	8361042	0.41952
ERR675566_1_kneaddata_paired	Firmicutes	12188	P	646887	5278	652165	0.03272
ERR675566_1_kneaddata_paired	Actinobacteriota	615	P	16408	28	16436	0.00082
ERR675566_1_kneaddata_paired	Firmicutes_B	17289	P	4561	149	4710	0.00024
ERR675566_1_kneaddata_paired	Cyanobacteria	9876	P	1495	19	1514	0.00008
ERR675566_1_kneaddata_paired	Desulfobacterota_A	11509	P	1335	165	1500	0.00008
ERR675566_1_kneaddata_paired	Proteobacteria	22518	P	652	3	655	0.00003
ERR675566_1_kneaddata_paired	Verrucomicrobiota	33333	P	229	11	240	0.00001
ERR675566_1_kneaddata_paired	Spirochaetota	32587	P	204	0	204	0.00001
ERR675566_1_kneaddata_paired	Campylobacterota	8700	P	111	0	111	0.00001
ERR675566_1_kneaddata_paired	Firmicutes_I	18140	P	75	0	75	0.00000
ERR675566_1_kneaddata_paired	Deferribacterota	10822	P	61	0	61	0.00000
ERR675566_1_kneaddata_paired	Firmicutes_C	17613	P	60	0	60	0.00000
ERR675566_1_kneaddata_paired	Thermotogota	33086	P	20	0	20	0.00000
ERR675566_1_kneaddata_paired	Elusimicrobiota	11888	P	7	0	7	0.00000
ERR675567_1_kneaddata_paired	Firmicutes_A	14608	P	9809171	34914	9844085	0.54467
ERR675567_1_kneaddata_paired	Bacteroidota	4587	P	7594782	146835	7741617	0.42834
ERR675567_1_kneaddata_paired	Firmicutes	12188	P	454397	3670	458067	0.02534
ERR675567_1_kneaddata_paired	Actinobacteriota	615	P	23062	35	23097	0.00128
ERR675567_1_kneaddata_paired	Cyanobacteria	9876	P	2597	28	2625	0.00015
ERR675567_1_kneaddata_paired	Desulfobacterota_A	11509	P	1397	162	1559	0.00009
ERR675567_1_kneaddata_paired	Firmicutes_B	17289	P	980	30	1010	0.00006
ERR675567_1_kneaddata_paired	Proteobacteria	22518	P	578	4	582	0.00003
ERR675567_1_kneaddata_paired	Verrucomicrobiota	33333	P	244	10	254	0.00001
ERR675567_1_kneaddata_paired	Spirochaetota	32587	P	214	0	214	0.00001
ERR675567_1_kneaddata_paired	Campylobacterota	8700	P	128	0	128	0.00001
ERR675567_1_kneaddata_paired	Deferribacterota	10822	P	66	0	66	0.00000
ERR675567_1_kneaddata_paired	Firmicutes_I	18140	P	64	0	64	0.00000
ERR675567_1_kneaddata_paired	Firmicutes_C	17613	P	60	0	60	0.00000
ERR675567_1_kneaddata_paired	Thermotogota	33086	P	40	0	40	0.00000
ERR675567_1_kneaddata_paired	Elusimicrobiota	11888	P	13	0	13	0.00000
ERR675568_1_kneaddata_paired	Firmicutes_A	14608	P	11744517	39104	11783621	0.53636
ERR675568_1_kneaddata_paired	Bacteroidota	4587	P	8591872	157758	8749630	0.39826
ERR675568_1_kneaddata_paired	Firmicutes	12188	P	1389460	10536	1399996	0.06372
ERR675568_1_kneaddata_paired	Actinobacteriota	615	P	26324	38	26362	0.00120
ERR675568_1_kneaddata_paired	Firmicutes_B	17289	P	3137	94	3231	0.00015
ERR675568_1_kneaddata_paired	Cyanobacteria	9876	P	3085	64	3149	0.00014
ERR675568_1_kneaddata_paired	Desulfobacterota_A	11509	P	1522	164	1686	0.00008
ERR675568_1_kneaddata_paired	Proteobacteria	22518	P	766	3	769	0.00004
ERR675568_1_kneaddata_paired	Verrucomicrobiota	33333	P	290	13	303	0.00001
ERR675568_1_kneaddata_paired	Spirochaetota	32587	P	257	0	257	0.00001
ERR675568_1_kneaddata_paired	Campylobacterota	8700	P	171	0	171	0.00001
ERR675568_1_kneaddata_paired	Deferribacterota	10822	P	156	0	156	0.00001
ERR675568_1_kneaddata_paired	Firmicutes_I	18140	P	92	0	92	0.00000
ERR675568_1_kneaddata_paired	Firmicutes_C	17613	P	62	0	62	0.00000
ERR675568_1_kneaddata_paired	Thermotogota	33086	P	19	0	19	0.00000
ERR675568_1_kneaddata_paired	Elusimicrobiota	11888	P	14	0	14	0.00000
ERR675569_1_kneaddata_paired	Firmicutes_A	14608	P	13184702	45924	13230626	0.77489
ERR675569_1_kneaddata_paired	Bacteroidota	4587	P	3660010	56911	3716921	0.21769
ERR675569_1_kneaddata_paired	Firmicutes	12188	P	113761	1861	115622	0.00677
ERR675569_1_kneaddata_paired	Actinobacteriota	615	P	3764	7	3771	0.00022
ERR675569_1_kneaddata_paired	Desulfobacterota_A	11509	P	1891	218	2109	0.00012
ERR675569_1_kneaddata_paired	Firmicutes_B	17289	P	1831	55	1886	0.00011
ERR675569_1_kneaddata_paired	Cyanobacteria	9876	P	1668	20	1688	0.00010
ERR675569_1_kneaddata_paired	Proteobacteria	22518	P	540	1	541	0.00003
ERR675569_1_kneaddata_paired	Verrucomicrobiota	33333	P	441	19	460	0.00003
ERR675569_1_kneaddata_paired	Spirochaetota	32587	P	190	0	190	0.00001
ERR675569_1_kneaddata_paired	Firmicutes_I	18140	P	112	0	112	0.00001
ERR675569_1_kneaddata_paired	Thermotogota	33086	P	99	0	99	0.00001
ERR675569_1_kneaddata_paired	Campylobacterota	8700	P	79	0	79	0.00000
ERR675569_1_kneaddata_paired	Deferribacterota	10822	P	78	0	78	0.00000
ERR675569_1_kneaddata_paired	Firmicutes_C	17613	P	70	0	70	0.00000
ERR675569_1_kneaddata_paired	Elusimicrobiota	11888	P	7	0	7	0.00000
ERR675570_1_kneaddata_paired	Firmicutes_A	14608	P	12372038	49509	12421547	0.72796
ERR675570_1_kneaddata_paired	Bacteroidota	4587	P	3956812	53970	4010782	0.23505
ERR675570_1_kneaddata_paired	Firmicutes	12188	P	609058	5630	614688	0.03602
ERR675570_1_kneaddata_paired	Actinobacteriota	615	P	8504	9	8513	0.00050
ERR675570_1_kneaddata_paired	Desulfobacterota_A	11509	P	2309	241	2550	0.00015
ERR675570_1_kneaddata_paired	Cyanobacteria	9876	P	1952	20	1972	0.00012
ERR675570_1_kneaddata_paired	Firmicutes_B	17289	P	1772	45	1817	0.00011
ERR675570_1_kneaddata_paired	Proteobacteria	22518	P	528	1	529	0.00003
ERR675570_1_kneaddata_paired	Verrucomicrobiota	33333	P	438	17	455	0.00003
ERR675570_1_kneaddata_paired	Thermotogota	33086	P	176	0	176	0.00001
ERR675570_1_kneaddata_paired	Spirochaetota	32587	P	158	0	158	0.00001
ERR675570_1_kneaddata_paired	Campylobacterota	8700	P	124	0	124	0.00001
ERR675570_1_kneaddata_paired	Firmicutes_C	17613	P	85	0	85	0.00000
ERR675570_1_kneaddata_paired	Deferribacterota	10822	P	82	0	82	0.00000
ERR675570_1_kneaddata_paired	Firmicutes_I	18140	P	70	0	70	0.00000
ERR675570_1_kneaddata_paired	Elusimicrobiota	11888	P	19	0	19	0.00000
ERR675571_1_kneaddata_paired	Firmicutes_A	14608	P	15085817	48169	15133986	0.83105
ERR675571_1_kneaddata_paired	Bacteroidota	4587	P	2734216	37706	2771922	0.15221
ERR675571_1_kneaddata_paired	Firmicutes	12188	P	287751	3604	291355	0.01600
ERR675571_1_kneaddata_paired	Actinobacteriota	615	P	4812	8	4820	0.00026
ERR675571_1_kneaddata_paired	Desulfobacterota_A	11509	P	2404	292	2696	0.00015
ERR675571_1_kneaddata_paired	Cyanobacteria	9876	P	2252	21	2273	0.00012
ERR675571_1_kneaddata_paired	Firmicutes_B	17289	P	1523	46	1569	0.00009
ERR675571_1_kneaddata_paired	Proteobacteria	22518	P	690	2	692	0.00004
ERR675571_1_kneaddata_paired	Verrucomicrobiota	33333	P	536	24	560	0.00003
ERR675571_1_kneaddata_paired	Spirochaetota	32587	P	262	0	262	0.00001
ERR675571_1_kneaddata_paired	Campylobacterota	8700	P	170	0	170	0.00001
ERR675571_1_kneaddata_paired	Deferribacterota	10822	P	117	0	117	0.00001
ERR675571_1_kneaddata_paired	Firmicutes_I	18140	P	99	0	99	0.00001
ERR675571_1_kneaddata_paired	Thermotogota	33086	P	84	0	84	0.00000
ERR675571_1_kneaddata_paired	Firmicutes_C	17613	P	83	0	83	0.00000
ERR675571_1_kneaddata_paired	Elusimicrobiota	11888	P	7	0	7	0.00000
ERR675572_1_kneaddata_paired	Firmicutes_A	14608	P	19766473	94753	19861226	0.88283
ERR675572_1_kneaddata_paired	Bacteroidota	4587	P	2449972	38265	2488237	0.11060
ERR675572_1_kneaddata_paired	Firmicutes	12188	P	126230	3508	129738	0.00577
ERR675572_1_kneaddata_paired	Actinobacteriota	615	P	5610	11	5621	0.00025
ERR675572_1_kneaddata_paired	Firmicutes_B	17289	P	4582	148	4730	0.00021
ERR675572_1_kneaddata_paired	Desulfobacterota_A	11509	P	2841	363	3204	0.00014
ERR675572_1_kneaddata_paired	Cyanobacteria	9876	P	1756	19	1775	0.00008
ERR675572_1_kneaddata_paired	Verrucomicrobiota	33333	P	847	42	889	0.00004
ERR675572_1_kneaddata_paired	Proteobacteria	22518	P	805	3	808	0.00004
ERR675572_1_kneaddata_paired	Spirochaetota	32587	P	299	0	299	0.00001
ERR675572_1_kneaddata_paired	Thermotogota	33086	P	223	0	223	0.00001
ERR675572_1_kneaddata_paired	Firmicutes_C	17613	P	142	0	142	0.00001
ERR675572_1_kneaddata_paired	Firmicutes_I	18140	P	136	0	136	0.00001
ERR675572_1_kneaddata_paired	Campylobacterota	8700	P	118	0	118	0.00001
ERR675572_1_kneaddata_paired	Deferribacterota	10822	P	108	0	108	0.00000
ERR675572_1_kneaddata_paired	Elusimicrobiota	11888	P	5	0	5	0.00000
ERR675573_1_kneaddata_paired	Firmicutes_A	14608	P	9321249	41564	9362813	0.52094
ERR675573_1_kneaddata_paired	Bacteroidota	4587	P	7241707	201737	7443444	0.41415
ERR675573_1_kneaddata_paired	Firmicutes	12188	P	1146167	11958	1158125	0.06444
ERR675573_1_kneaddata_paired	Cyanobacteria	9876	P	2738	74	2812	0.00016
ERR675573_1_kneaddata_paired	Desulfobacterota_A	11509	P	1456	190	1646	0.00009
ERR675573_1_kneaddata_paired	Actinobacteriota	615	P	1053	4	1057	0.00006
ERR675573_1_kneaddata_paired	Firmicutes_B	17289	P	837	28	865	0.00005
ERR675573_1_kneaddata_paired	Proteobacteria	22518	P	548	2	550	0.00003
ERR675573_1_kneaddata_paired	Spirochaetota	32587	P	449	1	450	0.00003
ERR675573_1_kneaddata_paired	Campylobacterota	8700	P	341	0	341	0.00002
ERR675573_1_kneaddata_paired	Deferribacterota	10822	P	322	0	322	0.00002
ERR675573_1_kneaddata_paired	Verrucomicrobiota	33333	P	238	11	249	0.00001
ERR675573_1_kneaddata_paired	Firmicutes_I	18140	P	135	0	135	0.00001
ERR675573_1_kneaddata_paired	Firmicutes_C	17613	P	83	0	83	0.00000
ERR675573_1_kneaddata_paired	Thermotogota	33086	P	35	0	35	0.00000
ERR675573_1_kneaddata_paired	Elusimicrobiota	11888	P	4	0	4	0.00000
ERR675574_1_kneaddata_paired	Bacteroidota	4587	P	10607709	276434	10884143	0.50195
ERR675574_1_kneaddata_paired	Firmicutes_A	14608	P	8934818	38534	8973352	0.41383
ERR675574_1_kneaddata_paired	Firmicutes	12188	P	1798791	16855	1815646	0.08373
ERR675574_1_kneaddata_paired	Cyanobacteria	9876	P	4231	124	4355	0.00020
ERR675574_1_kneaddata_paired	Actinobacteriota	615	P	2480	12	2492	0.00011
ERR675574_1_kneaddata_paired	Desulfobacterota_A	11509	P	1053	127	1180	0.00005
ERR675574_1_kneaddata_paired	Proteobacteria	22518	P	656	2	658	0.00003
ERR675574_1_kneaddata_paired	Firmicutes_B	17289	P	529	17	546	0.00003
ERR675574_1_kneaddata_paired	Spirochaetota	32587	P	413	1	414	0.00002
ERR675574_1_kneaddata_paired	Campylobacterota	8700	P	340	0	340	0.00002
ERR675574_1_kneaddata_paired	Deferribacterota	10822	P	286	0	286	0.00001
ERR675574_1_kneaddata_paired	Verrucomicrobiota	33333	P	171	8	179	0.00001
ERR675574_1_kneaddata_paired	Firmicutes_I	18140	P	149	0	149	0.00001
ERR675574_1_kneaddata_paired	Firmicutes_C	17613	P	29	0	29	0.00000
ERR675574_1_kneaddata_paired	Elusimicrobiota	11888	P	16	0	16	0.00000
ERR675574_1_kneaddata_paired	Thermotogota	33086	P	15	0	15	0.00000
ERR675575_1_kneaddata_paired	Firmicutes_A	14608	P	13756714	53913	13810627	0.73546
ERR675575_1_kneaddata_paired	Bacteroidota	4587	P	3909518	109742	4019260	0.21404
ERR675575_1_kneaddata_paired	Firmicutes	12188	P	926627	11116	937743	0.04994
ERR675575_1_kneaddata_paired	Actinobacteriota	615	P	2322	12	2334	0.00012
ERR675575_1_kneaddata_paired	Cyanobacteria	9876	P	2130	66	2196	0.00012
ERR675575_1_kneaddata_paired	Desulfobacterota_A	11509	P	2033	302	2335	0.00012
ERR675575_1_kneaddata_paired	Firmicutes_B	17289	P	1182	43	1225	0.00007
ERR675575_1_kneaddata_paired	Proteobacteria	22518	P	775	5	780	0.00004
ERR675575_1_kneaddata_paired	Spirochaetota	32587	P	454	1	455	0.00002
ERR675575_1_kneaddata_paired	Verrucomicrobiota	33333	P	310	16	326	0.00002
ERR675575_1_kneaddata_paired	Deferribacterota	10822	P	254	0	254	0.00001
ERR675575_1_kneaddata_paired	Campylobacterota	8700	P	247	0	247	0.00001
ERR675575_1_kneaddata_paired	Firmicutes_C	17613	P	154	0	154	0.00001
ERR675575_1_kneaddata_paired	Firmicutes_I	18140	P	133	0	133	0.00001
ERR675575_1_kneaddata_paired	Thermotogota	33086	P	18	0	18	0.00000
ERR675575_1_kneaddata_paired	Elusimicrobiota	11888	P	13	0	13	0.00000
ERR675576_1_kneaddata_paired	Firmicutes_A	14608	P	12951224	48138	12999362	0.64602
ERR675576_1_kneaddata_paired	Bacteroidota	4587	P	6421034	187101	6608135	0.32840
ERR675576_1_kneaddata_paired	Firmicutes	12188	P	499893	7086	506979	0.02520
ERR675576_1_kneaddata_paired	Cyanobacteria	9876	P	2202	78	2280	0.00011
ERR675576_1_kneaddata_paired	Desulfobacterota_A	11509	P	1165	152	1317	0.00007
ERR675576_1_kneaddata_paired	Actinobacteriota	615	P	1127	6	1133	0.00006
ERR675576_1_kneaddata_paired	Firmicutes_B	17289	P	1053	36	1089	0.00005
ERR675576_1_kneaddata_paired	Proteobacteria	22518	P	569	2	571	0.00003
ERR675576_1_kneaddata_paired	Verrucomicrobiota	33333	P	382	20	402	0.00002
ERR675576_1_kneaddata_paired	Spirochaetota	32587	P	298	0	298	0.00001
ERR675576_1_kneaddata_paired	Deferribacterota	10822	P	192	0	192	0.00001
ERR675576_1_kneaddata_paired	Campylobacterota	8700	P	178	0	178	0.00001
ERR675576_1_kneaddata_paired	Firmicutes_I	18140	P	130	0	130	0.00001
ERR675576_1_kneaddata_paired	Firmicutes_C	17613	P	60	0	60	0.00000
ERR675576_1_kneaddata_paired	Elusimicrobiota	11888	P	16	0	16	0.00000
ERR675576_1_kneaddata_paired	Thermotogota	33086	P	15	0	15	0.00000
ERR675577_1_kneaddata_paired	Firmicutes_A	14608	P	13241100	55286	13296386	0.74033
ERR675577_1_kneaddata_paired	Bacteroidota	4587	P	3186875	105468	3292343	0.18332
ERR675577_1_kneaddata_paired	Firmicutes	12188	P	1345878	16990	1362868	0.07588
ERR675577_1_kneaddata_paired	Cyanobacteria	9876	P	1861	59	1920	0.00011
ERR675577_1_kneaddata_paired	Actinobacteriota	615	P	1831	9	1840	0.00010
ERR675577_1_kneaddata_paired	Desulfobacterota_A	11509	P	1730	284	2014	0.00011
ERR675577_1_kneaddata_paired	Firmicutes_B	17289	P	803	33	836	0.00005
ERR675577_1_kneaddata_paired	Proteobacteria	22518	P	690	6	696	0.00004
ERR675577_1_kneaddata_paired	Verrucomicrobiota	33333	P	380	23	403	0.00002
ERR675577_1_kneaddata_paired	Spirochaetota	32587	P	205	0	205	0.00001
ERR675577_1_kneaddata_paired	Campylobacterota	8700	P	199	0	199	0.00001
ERR675577_1_kneaddata_paired	Firmicutes_I	18140	P	115	0	115	0.00001
ERR675577_1_kneaddata_paired	Deferribacterota	10822	P	101	0	101	0.00001
ERR675577_1_kneaddata_paired	Firmicutes_C	17613	P	56	0	56	0.00000
ERR675577_1_kneaddata_paired	Elusimicrobiota	11888	P	21	0	21	0.00000
ERR675577_1_kneaddata_paired	Thermotogota	33086	P	8	0	8	0.00000
ERR675578_1_kneaddata_paired	Firmicutes_A	14608	P	13688669	68199	13756868	0.65479
ERR675578_1_kneaddata_paired	Bacteroidota	4587	P	4850946	120317	4971263	0.23662
ERR675578_1_kneaddata_paired	Firmicutes	12188	P	2251493	21114	2272607	0.10817
ERR675578_1_kneaddata_paired	Cyanobacteria	9876	P	2996	58	3054	0.00015
ERR675578_1_kneaddata_paired	Desulfobacterota_A	11509	P	2052	261	2313	0.00011
ERR675578_1_kneaddata_paired	Firmicutes_B	17289	P	1178	38	1216	0.00006
ERR675578_1_kneaddata_paired	Proteobacteria	22518	P	695	3	698	0.00003
ERR675578_1_kneaddata_paired	Actinobacteriota	615	P	565	2	567	0.00003
ERR675578_1_kneaddata_paired	Verrucomicrobiota	33333	P	310	14	324	0.00002
ERR675578_1_kneaddata_paired	Spirochaetota	32587	P	223	0	223	0.00001
ERR675578_1_kneaddata_paired	Deferribacterota	10822	P	190	0	190	0.00001
ERR675578_1_kneaddata_paired	Campylobacterota	8700	P	149	0	149	0.00001
ERR675578_1_kneaddata_paired	Firmicutes_I	18140	P	106	0	106	0.00001
ERR675578_1_kneaddata_paired	Firmicutes_C	17613	P	60	0	60	0.00000
ERR675578_1_kneaddata_paired	Thermotogota	33086	P	31	0	31	0.00000
ERR675578_1_kneaddata_paired	Elusimicrobiota	11888	P	12	0	12	0.00000
ERR675579_1_kneaddata_paired	Firmicutes_A	14608	P	11146618	52523	11199141	0.67306
ERR675579_1_kneaddata_paired	Bacteroidota	4587	P	4461691	142201	4603892	0.27669
ERR675579_1_kneaddata_paired	Firmicutes	12188	P	810062	12257	822319	0.04942
ERR675579_1_kneaddata_paired	Cyanobacteria	9876	P	6866	90	6956	0.00042
ERR675579_1_kneaddata_paired	Desulfobacterota_A	11509	P	1541	243	1784	0.00011
ERR675579_1_kneaddata_paired	Actinobacteriota	615	P	1312	8	1320	0.00008
ERR675579_1_kneaddata_paired	Firmicutes_B	17289	P	975	38	1013	0.00006
ERR675579_1_kneaddata_paired	Proteobacteria	22518	P	854	8	862	0.00005
ERR675579_1_kneaddata_paired	Spirochaetota	32587	P	531	1	532	0.00003
ERR675579_1_kneaddata_paired	Deferribacterota	10822	P	408	0	408	0.00002
ERR675579_1_kneaddata_paired	Verrucomicrobiota	33333	P	331	19	350	0.00002
ERR675579_1_kneaddata_paired	Campylobacterota	8700	P	298	0	298	0.00002
ERR675579_1_kneaddata_paired	Firmicutes_I	18140	P	142	0	142	0.00001
ERR675579_1_kneaddata_paired	Firmicutes_C	17613	P	69	0	69	0.00000
ERR675579_1_kneaddata_paired	Thermotogota	33086	P	23	0	23	0.00000
ERR675579_1_kneaddata_paired	Elusimicrobiota	11888	P	8	0	8	0.00000
ERR675580_1_kneaddata_paired	Firmicutes_A	14608	P	7392507	30794	7423301	0.43593
ERR675580_1_kneaddata_paired	Bacteroidota	4587	P	6765485	179617	6945102	0.40785
ERR675580_1_kneaddata_paired	Firmicutes	12188	P	2627142	24653	2651795	0.15572
ERR675580_1_kneaddata_paired	Actinobacteriota	615	P	2470	11	2481	0.00015
ERR675580_1_kneaddata_paired	Cyanobacteria	9876	P	2317	24	2341	0.00014
ERR675580_1_kneaddata_paired	Desulfobacterota_A	11509	P	910	112	1022	0.00006
ERR675580_1_kneaddata_paired	Proteobacteria	22518	P	704	3	707	0.00004
ERR675580_1_kneaddata_paired	Firmicutes_B	17289	P	542	18	560	0.00003
ERR675580_1_kneaddata_paired	Spirochaetota	32587	P	392	1	393	0.00002
ERR675580_1_kneaddata_paired	Campylobacterota	8700	P	303	0	303	0.00002
ERR675580_1_kneaddata_paired	Deferribacterota	10822	P	245	0	245	0.00001
ERR675580_1_kneaddata_paired	Verrucomicrobiota	33333	P	233	11	244	0.00001
ERR675580_1_kneaddata_paired	Firmicutes_I	18140	P	133	0	133	0.00001
ERR675580_1_kneaddata_paired	Firmicutes_C	17613	P	64	0	64	0.00000
ERR675580_1_kneaddata_paired	Elusimicrobiota	11888	P	19	0	19	0.00000
ERR675580_1_kneaddata_paired	Thermotogota	33086	P	15	0	15	0.00000
ERR675581_1_kneaddata_paired	Firmicutes_A	14608	P	7756074	24672	7780746	0.47169
ERR675581_1_kneaddata_paired	Bacteroidota	4587	P	7383940	131247	7515187	0.45559
ERR675581_1_kneaddata_paired	Firmicutes	12188	P	616176	5640	621816	0.03770
ERR675581_1_kneaddata_paired	Verrucomicrobiota	33333	P	491867	20300	512167	0.03105
ERR675581_1_kneaddata_paired	Actinobacteriota	615	P	61307	45	61352	0.00372
ERR675581_1_kneaddata_paired	Cyanobacteria	9876	P	1666	51	1717	0.00010
ERR675581_1_kneaddata_paired	Desulfobacterota_A	11509	P	755	75	830	0.00005
ERR675581_1_kneaddata_paired	Proteobacteria	22518	P	396	1	397	0.00002
ERR675581_1_kneaddata_paired	Firmicutes_B	17289	P	393	10	403	0.00002
ERR675581_1_kneaddata_paired	Campylobacterota	8700	P	328	0	328	0.00002
ERR675581_1_kneaddata_paired	Spirochaetota	32587	P	153	0	153	0.00001
ERR675581_1_kneaddata_paired	Firmicutes_I	18140	P	138	0	138	0.00001
ERR675581_1_kneaddata_paired	Deferribacterota	10822	P	80	0	80	0.00000
ERR675581_1_kneaddata_paired	Firmicutes_C	17613	P	47	0	47	0.00000
ERR675581_1_kneaddata_paired	Thermotogota	33086	P	20	0	20	0.00000
ERR675581_1_kneaddata_paired	Elusimicrobiota	11888	P	14	0	14	0.00000
ERR675582_1_kneaddata_paired	Firmicutes_A	14608	P	11766636	38800	11805436	0.57046
ERR675582_1_kneaddata_paired	Bacteroidota	4587	P	7369295	118563	7487858	0.36183
ERR675582_1_kneaddata_paired	Firmicutes	12188	P	1028038	9104	1037142	0.05012
ERR675582_1_kneaddata_paired	Verrucomicrobiota	33333	P	252279	10678	262957	0.01271
ERR675582_1_kneaddata_paired	Actinobacteriota	615	P	95455	80	95535	0.00462
ERR675582_1_kneaddata_paired	Cyanobacteria	9876	P	2107	48	2155	0.00010
ERR675582_1_kneaddata_paired	Desulfobacterota_A	11509	P	1025	100	1125	0.00005
ERR675582_1_kneaddata_paired	Proteobacteria	22518	P	635	3	638	0.00003
ERR675582_1_kneaddata_paired	Firmicutes_B	17289	P	627	17	644	0.00003
ERR675582_1_kneaddata_paired	Spirochaetota	32587	P	314	0	314	0.00002
ERR675582_1_kneaddata_paired	Campylobacterota	8700	P	269	0	269	0.00001
ERR675582_1_kneaddata_paired	Deferribacterota	10822	P	159	0	159	0.00001
ERR675582_1_kneaddata_paired	Firmicutes_I	18140	P	83	0	83	0.00000
ERR675582_1_kneaddata_paired	Firmicutes_C	17613	P	66	0	66	0.00000
ERR675582_1_kneaddata_paired	Thermotogota	33086	P	58	0	58	0.00000
ERR675582_1_kneaddata_paired	Elusimicrobiota	11888	P	10	0	10	0.00000
ERR675583_1_kneaddata_paired	Bacteroidota	4587	P	9299436	147580	9447016	0.47121
ERR675583_1_kneaddata_paired	Firmicutes_A	14608	P	7922817	22110	7944927	0.39629
ERR675583_1_kneaddata_paired	Firmicutes	12188	P	1543228	11396	1554624	0.07754
ERR675583_1_kneaddata_paired	Verrucomicrobiota	33333	P	1013357	37030	1050387	0.05239
ERR675583_1_kneaddata_paired	Actinobacteriota	615	P	46216	27	46243	0.00231
ERR675583_1_kneaddata_paired	Cyanobacteria	9876	P	2497	65	2562	0.00013
ERR675583_1_kneaddata_paired	Desulfobacterota_A	11509	P	585	49	634	0.00003
ERR675583_1_kneaddata_paired	Campylobacterota	8700	P	543	0	543	0.00003
ERR675583_1_kneaddata_paired	Proteobacteria	22518	P	416	1	417	0.00002
ERR675583_1_kneaddata_paired	Firmicutes_B	17289	P	415	9	424	0.00002
ERR675583_1_kneaddata_paired	Spirochaetota	32587	P	288	0	288	0.00001
ERR675583_1_kneaddata_paired	Firmicutes_I	18140	P	169	0	169	0.00001
ERR675583_1_kneaddata_paired	Deferribacterota	10822	P	139	0	139	0.00001
ERR675583_1_kneaddata_paired	Thermotogota	33086	P	48	0	48	0.00000
ERR675583_1_kneaddata_paired	Firmicutes_C	17613	P	42	0	42	0.00000
ERR675583_1_kneaddata_paired	Elusimicrobiota	11888	P	10	0	10	0.00000
ERR675584_1_kneaddata_paired	Firmicutes_A	14608	P	13240468	36039	13276507	0.69767
ERR675584_1_kneaddata_paired	Bacteroidota	4587	P	3710464	41752	3752216	0.19718
ERR675584_1_kneaddata_paired	Firmicutes	12188	P	1776926	13788	1790714	0.09410
ERR675584_1_kneaddata_paired	Verrucomicrobiota	33333	P	128104	4782	132886	0.00698
ERR675584_1_kneaddata_paired	Actinobacteriota	615	P	72032	47	72079	0.00379
ERR675584_1_kneaddata_paired	Cyanobacteria	9876	P	1759	32	1791	0.00009
ERR675584_1_kneaddata_paired	Desulfobacterota_A	11509	P	1234	112	1346	0.00007
ERR675584_1_kneaddata_paired	Proteobacteria	22518	P	614	3	617	0.00003
ERR675584_1_kneaddata_paired	Firmicutes_B	17289	P	586	13	599	0.00003
ERR675584_1_kneaddata_paired	Campylobacterota	8700	P	390	0	390	0.00002
ERR675584_1_kneaddata_paired	Spirochaetota	32587	P	259	0	259	0.00001
ERR675584_1_kneaddata_paired	Firmicutes_I	18140	P	142	0	142	0.00001
ERR675584_1_kneaddata_paired	Deferribacterota	10822	P	102	0	102	0.00001
ERR675584_1_kneaddata_paired	Firmicutes_C	17613	P	78	0	78	0.00000
ERR675584_1_kneaddata_paired	Thermotogota	33086	P	27	0	27	0.00000
ERR675584_1_kneaddata_paired	Elusimicrobiota	11888	P	11	0	11	0.00000
ERR675585_1_kneaddata_paired	Firmicutes_A	14608	P	15198522	58289	15256811	0.88280
ERR675585_1_kneaddata_paired	Bacteroidota	4587	P	1405338	19069	1424407	0.08242
ERR675585_1_kneaddata_paired	Firmicutes	12188	P	557969	7271	565240	0.03271
ERR675585_1_kneaddata_paired	Actinobacteriota	615	P	26498	13	26511	0.00153
ERR675585_1_kneaddata_paired	Desulfobacterota_A	11509	P	2409	285	2694	0.00016
ERR675585_1_kneaddata_paired	Cyanobacteria	9876	P	2020	35	2055	0.00012
ERR675585_1_kneaddata_paired	Firmicutes_B	17289	P	1631	48	1679	0.00010
ERR675585_1_kneaddata_paired	Verrucomicrobiota	33333	P	1088	36	1124	0.00007
ERR675585_1_kneaddata_paired	Proteobacteria	22518	P	731	4	735	0.00004
ERR675585_1_kneaddata_paired	Spirochaetota	32587	P	296	0	296	0.00002
ERR675585_1_kneaddata_paired	Campylobacterota	8700	P	219	0	219	0.00001
ERR675585_1_kneaddata_paired	Firmicutes_C	17613	P	169	0	169	0.00001
ERR675585_1_kneaddata_paired	Deferribacterota	10822	P	119	0	119	0.00001
ERR675585_1_kneaddata_paired	Firmicutes_I	18140	P	117	0	117	0.00001
ERR675585_1_kneaddata_paired	Thermotogota	33086	P	21	0	21	0.00000
ERR675585_1_kneaddata_paired	Elusimicrobiota	11888	P	18	0	18	0.00000
ERR675586_1_kneaddata_paired	Firmicutes_A	14608	P	12634319	46426	12680745	0.64879
ERR675586_1_kneaddata_paired	Bacteroidota	4587	P	5437262	119630	5556892	0.28431
ERR675586_1_kneaddata_paired	Firmicutes	12188	P	1239198	12372	1251570	0.06403
ERR675586_1_kneaddata_paired	Actinobacteriota	615	P	48709	23	48732	0.00249
ERR675586_1_kneaddata_paired	Cyanobacteria	9876	P	2106	65	2171	0.00011
ERR675586_1_kneaddata_paired	Verrucomicrobiota	33333	P	1513	22	1535	0.00008
ERR675586_1_kneaddata_paired	Desulfobacterota_A	11509	P	1192	130	1322	0.00007
ERR675586_1_kneaddata_paired	Firmicutes_B	17289	P	735	21	756	0.00004
ERR675586_1_kneaddata_paired	Proteobacteria	22518	P	559	2	561	0.00003
ERR675586_1_kneaddata_paired	Campylobacterota	8700	P	419	0	419	0.00002
ERR675586_1_kneaddata_paired	Spirochaetota	32587	P	204	0	204	0.00001
ERR675586_1_kneaddata_paired	Firmicutes_I	18140	P	176	0	176	0.00001
ERR675586_1_kneaddata_paired	Deferribacterota	10822	P	92	0	92	0.00000
ERR675586_1_kneaddata_paired	Firmicutes_C	17613	P	92	0	92	0.00000
ERR675586_1_kneaddata_paired	Thermotogota	33086	P	61	0	61	0.00000
ERR675586_1_kneaddata_paired	Elusimicrobiota	11888	P	11	0	11	0.00000
ERR675587_1_kneaddata_paired	Firmicutes_A	14608	P	12720444	44206	12764650	0.59098
ERR675587_1_kneaddata_paired	Bacteroidota	4587	P	7589559	174162	7763721	0.35945
ERR675587_1_kneaddata_paired	Firmicutes	12188	P	1011378	11174	1022552	0.04734
ERR675587_1_kneaddata_paired	Actinobacteriota	615	P	40765	21	40786	0.00189
ERR675587_1_kneaddata_paired	Cyanobacteria	9876	P	2610	89	2699	0.00012
ERR675587_1_kneaddata_paired	Verrucomicrobiota	33333	P	1408	14	1422	0.00007
ERR675587_1_kneaddata_paired	Desulfobacterota_A	11509	P	949	107	1056	0.00005
ERR675587_1_kneaddata_paired	Firmicutes_B	17289	P	648	19	667	0.00003
ERR675587_1_kneaddata_paired	Proteobacteria	22518	P	492	4	496	0.00002
ERR675587_1_kneaddata_paired	Campylobacterota	8700	P	331	0	331	0.00002
ERR675587_1_kneaddata_paired	Spirochaetota	32587	P	231	0	231	0.00001
ERR675587_1_kneaddata_paired	Firmicutes_I	18140	P	145	0	145	0.00001
ERR675587_1_kneaddata_paired	Deferribacterota	10822	P	133	0	133	0.00001
ERR675587_1_kneaddata_paired	Thermotogota	33086	P	67	0	67	0.00000
ERR675587_1_kneaddata_paired	Firmicutes_C	17613	P	59	0	59	0.00000
ERR675587_1_kneaddata_paired	Elusimicrobiota	11888	P	21	0	21	0.00000
ERR675588_1_kneaddata_paired	Firmicutes_A	14608	P	17595822	62596	17658418	0.78762
ERR675588_1_kneaddata_paired	Bacteroidota	4587	P	2896963	55201	2952164	0.13167
ERR675588_1_kneaddata_paired	Firmicutes	12188	P	1756599	18308	1774907	0.07917
ERR675588_1_kneaddata_paired	Actinobacteriota	615	P	24799	10	24809	0.00111
ERR675588_1_kneaddata_paired	Desulfobacterota_A	11509	P	2357	268	2625	0.00012
ERR675588_1_kneaddata_paired	Verrucomicrobiota	33333	P	2314	39	2353	0.00010
ERR675588_1_kneaddata_paired	Cyanobacteria	9876	P	1576	33	1609	0.00007
ERR675588_1_kneaddata_paired	Firmicutes_B	17289	P	1406	41	1447	0.00006
ERR675588_1_kneaddata_paired	Proteobacteria	22518	P	854	4	858	0.00004
ERR675588_1_kneaddata_paired	Spirochaetota	32587	P	229	0	229	0.00001
ERR675588_1_kneaddata_paired	Thermotogota	33086	P	153	0	153	0.00001
ERR675588_1_kneaddata_paired	Campylobacterota	8700	P	148	0	148	0.00001
ERR675588_1_kneaddata_paired	Firmicutes_I	18140	P	135	0	135	0.00001
ERR675588_1_kneaddata_paired	Deferribacterota	10822	P	112	0	112	0.00001
ERR675588_1_kneaddata_paired	Firmicutes_C	17613	P	107	0	107	0.00000
ERR675588_1_kneaddata_paired	Elusimicrobiota	11888	P	25	0	25	0.00000
ERR675589_1_kneaddata_paired	Firmicutes_A	14608	P	14328042	45370	14373412	0.80632
ERR675589_1_kneaddata_paired	Bacteroidota	4587	P	1778550	44898	1823448	0.10229
ERR675589_1_kneaddata_paired	Firmicutes	12188	P	1605827	15577	1621404	0.09096
ERR675589_1_kneaddata_paired	Actinobacteriota	615	P	2214	3	2217	0.00012
ERR675589_1_kneaddata_paired	Desulfobacterota_A	11509	P	1640	207	1847	0.00010
ERR675589_1_kneaddata_paired	Cyanobacteria	9876	P	1127	24	1151	0.00006
ERR675589_1_kneaddata_paired	Firmicutes_B	17289	P	774	25	799	0.00004
ERR675589_1_kneaddata_paired	Proteobacteria	22518	P	578	3	581	0.00003
ERR675589_1_kneaddata_paired	Verrucomicrobiota	33333	P	505	23	528	0.00003
ERR675589_1_kneaddata_paired	Spirochaetota	32587	P	191	0	191	0.00001
ERR675589_1_kneaddata_paired	Campylobacterota	8700	P	129	0	129	0.00001
ERR675589_1_kneaddata_paired	Firmicutes_C	17613	P	126	0	126	0.00001
ERR675589_1_kneaddata_paired	Firmicutes_I	18140	P	120	0	120	0.00001
ERR675589_1_kneaddata_paired	Deferribacterota	10822	P	55	0	55	0.00000
ERR675589_1_kneaddata_paired	Elusimicrobiota	11888	P	17	0	17	0.00000
ERR675589_1_kneaddata_paired	Thermotogota	33086	P	15	0	15	0.00000
ERR675590_1_kneaddata_paired	Firmicutes_A	14608	P	12958514	36589	12995103	0.68019
ERR675590_1_kneaddata_paired	Bacteroidota	4587	P	3538995	78227	3617222	0.18933
ERR675590_1_kneaddata_paired	Firmicutes	12188	P	2454578	23688	2478266	0.12972
ERR675590_1_kneaddata_paired	Actinobacteriota	615	P	6236	3	6239	0.00033
ERR675590_1_kneaddata_paired	Cyanobacteria	9876	P	2916	88	3004	0.00016
ERR675590_1_kneaddata_paired	Firmicutes_B	17289	P	1442	44	1486	0.00008
ERR675590_1_kneaddata_paired	Desulfobacterota_A	11509	P	1311	144	1455	0.00008
ERR675590_1_kneaddata_paired	Proteobacteria	22518	P	693	3	696	0.00004
ERR675590_1_kneaddata_paired	Verrucomicrobiota	33333	P	403	16	419	0.00002
ERR675590_1_kneaddata_paired	Spirochaetota	32587	P	400	1	401	0.00002
ERR675590_1_kneaddata_paired	Deferribacterota	10822	P	291	0	291	0.00002
ERR675590_1_kneaddata_paired	Campylobacterota	8700	P	289	0	289	0.00002
ERR675590_1_kneaddata_paired	Firmicutes_C	17613	P	149	0	149	0.00001
ERR675590_1_kneaddata_paired	Firmicutes_I	18140	P	128	0	128	0.00001
ERR675590_1_kneaddata_paired	Thermotogota	33086	P	33	0	33	0.00000
ERR675590_1_kneaddata_paired	Elusimicrobiota	11888	P	16	0	16	0.00000
ERR675591_1_kneaddata_paired	Firmicutes_A	14608	P	12153118	35344	12188462	0.65945
ERR675591_1_kneaddata_paired	Bacteroidota	4587	P	4607439	107629	4715068	0.25511
ERR675591_1_kneaddata_paired	Firmicutes	12188	P	1544478	14171	1558649	0.08433
ERR675591_1_kneaddata_paired	Actinobacteriota	615	P	12371	4	12375	0.00067
ERR675591_1_kneaddata_paired	Cyanobacteria	9876	P	2075	57	2132	0.00012
ERR675591_1_kneaddata_paired	Proteobacteria	22518	P	1736	3	1739	0.00009
ERR675591_1_kneaddata_paired	Desulfobacterota_A	11509	P	1147	134	1281	0.00007
ERR675591_1_kneaddata_paired	Firmicutes_B	17289	P	951	30	981	0.00005
ERR675591_1_kneaddata_paired	Verrucomicrobiota	33333	P	749	12	761	0.00004
ERR675591_1_kneaddata_paired	Campylobacterota	8700	P	532	0	532	0.00003
ERR675591_1_kneaddata_paired	Spirochaetota	32587	P	279	0	279	0.00002
ERR675591_1_kneaddata_paired	Firmicutes_I	18140	P	191	0	191	0.00001
ERR675591_1_kneaddata_paired	Deferribacterota	10822	P	184	0	184	0.00001
ERR675591_1_kneaddata_paired	Firmicutes_C	17613	P	101	0	101	0.00001
ERR675591_1_kneaddata_paired	Thermotogota	33086	P	40	0	40	0.00000
ERR675591_1_kneaddata_paired	Elusimicrobiota	11888	P	6	0	6	0.00000
ERR675592_1_kneaddata_paired	Firmicutes_A	14608	P	8723961	28461	8752422	0.49132
ERR675592_1_kneaddata_paired	Bacteroidota	4587	P	6178003	128491	6306494	0.35401
ERR675592_1_kneaddata_paired	Firmicutes	12188	P	2706177	19599	2725776	0.15301
ERR675592_1_kneaddata_paired	Actinobacteriota	615	P	14199	3	14202	0.00080
ERR675592_1_kneaddata_paired	Proteobacteria	22518	P	7602	10	7612	0.00043
ERR675592_1_kneaddata_paired	Cyanobacteria	9876	P	3364	77	3441	0.00019
ERR675592_1_kneaddata_paired	Desulfobacterota_A	11509	P	1001	104	1105	0.00006
ERR675592_1_kneaddata_paired	Verrucomicrobiota	33333	P	791	11	802	0.00005
ERR675592_1_kneaddata_paired	Firmicutes_B	17289	P	759	21	780	0.00004
ERR675592_1_kneaddata_paired	Campylobacterota	8700	P	479	0	479	0.00003
ERR675592_1_kneaddata_paired	Deferribacterota	10822	P	451	0	451	0.00003
ERR675592_1_kneaddata_paired	Spirochaetota	32587	P	406	0	406	0.00002
ERR675592_1_kneaddata_paired	Firmicutes_I	18140	P	126	0	126	0.00001
ERR675592_1_kneaddata_paired	Firmicutes_C	17613	P	78	0	78	0.00000
ERR675592_1_kneaddata_paired	Thermotogota	33086	P	47	0	47	0.00000
ERR675592_1_kneaddata_paired	Elusimicrobiota	11888	P	14	0	14	0.00000
ERR675593_1_kneaddata_paired	Firmicutes_A	14608	P	12225268	33830	12259098	0.71734
ERR675593_1_kneaddata_paired	Bacteroidota	4587	P	3619677	105080	3724757	0.21795
ERR675593_1_kneaddata_paired	Firmicutes	12188	P	1068920	9920	1078840	0.06313
ERR675593_1_kneaddata_paired	Actinobacteriota	615	P	19180	25	19205	0.00112
ERR675593_1_kneaddata_paired	Cyanobacteria	9876	P	2714	76	2790	0.00016
ERR675593_1_kneaddata_paired	Firmicutes_B	17289	P	1015	34	1049	0.00006
ERR675593_1_kneaddata_paired	Desulfobacterota_A	11509	P	889	100	989	0.00006
ERR675593_1_kneaddata_paired	Verrucomicrobiota	33333	P	785	21	806	0.00005
ERR675593_1_kneaddata_paired	Proteobacteria	22518	P	678	3	681	0.00004
ERR675593_1_kneaddata_paired	Spirochaetota	32587	P	428	1	429	0.00003
ERR675593_1_kneaddata_paired	Campylobacterota	8700	P	382	0	382	0.00002
ERR675593_1_kneaddata_paired	Deferribacterota	10822	P	239	0	239	0.00001
ERR675593_1_kneaddata_paired	Firmicutes_I	18140	P	191	0	191	0.00001
ERR675593_1_kneaddata_paired	Firmicutes_C	17613	P	128	0	128	0.00001
ERR675593_1_kneaddata_paired	Thermotogota	33086	P	22	0	22	0.00000
ERR675593_1_kneaddata_paired	Elusimicrobiota	11888	P	7	0	7	0.00000
ERR675594_1_kneaddata_paired	Bacteroidota	4587	P	8912731	246293	9159024	0.45918
ERR675594_1_kneaddata_paired	Firmicutes_A	14608	P	7878067	25761	7903828	0.39625
ERR675594_1_kneaddata_paired	Firmicutes	12188	P	2818817	22447	2841264	0.14244
ERR675594_1_kneaddata_paired	Actinobacteriota	615	P	29452	33	29485	0.00148
ERR675594_1_kneaddata_paired	Proteobacteria	22518	P	4542	8	4550	0.00023
ERR675594_1_kneaddata_paired	Cyanobacteria	9876	P	3901	102	4003	0.00020
ERR675594_1_kneaddata_paired	Firmicutes_B	17289	P	907	28	935	0.00005
ERR675594_1_kneaddata_paired	Desulfobacterota_A	11509	P	745	64	809	0.00004
ERR675594_1_kneaddata_paired	Spirochaetota	32587	P	658	1	659	0.00003
ERR675594_1_kneaddata_paired	Deferribacterota	10822	P	646	1	647	0.00003
ERR675594_1_kneaddata_paired	Verrucomicrobiota	33333	P	567	10	577	0.00003
ERR675594_1_kneaddata_paired	Campylobacterota	8700	P	418	0	418	0.00002
ERR675594_1_kneaddata_paired	Firmicutes_I	18140	P	241	0	241	0.00001
ERR675594_1_kneaddata_paired	Firmicutes_C	17613	P	90	0	90	0.00000
ERR675594_1_kneaddata_paired	Thermotogota	33086	P	71	0	71	0.00000
ERR675594_1_kneaddata_paired	Elusimicrobiota	11888	P	17	0	17	0.00000
ERR675595_1_kneaddata_paired	Bacteroidota	4587	P	9491102	257451	9748553	0.45924
ERR675595_1_kneaddata_paired	Firmicutes_A	14608	P	8320218	34480	8354698	0.39358
ERR675595_1_kneaddata_paired	Firmicutes	12188	P	3061220	25518	3086738	0.14541
ERR675595_1_kneaddata_paired	Actinobacteriota	615	P	28668	31	28699	0.00135
ERR675595_1_kneaddata_paired	Cyanobacteria	9876	P	3587	109	3696	0.00017
ERR675595_1_kneaddata_paired	Proteobacteria	22518	P	1743	3	1746	0.00008
ERR675595_1_kneaddata_paired	Desulfobacterota_A	11509	P	921	100	1021	0.00005
ERR675595_1_kneaddata_paired	Firmicutes_B	17289	P	654	20	674	0.00003
ERR675595_1_kneaddata_paired	Spirochaetota	32587	P	418	1	419	0.00002
ERR675595_1_kneaddata_paired	Campylobacterota	8700	P	412	0	412	0.00002
ERR675595_1_kneaddata_paired	Deferribacterota	10822	P	385	0	385	0.00002
ERR675595_1_kneaddata_paired	Verrucomicrobiota	33333	P	310	13	323	0.00002
ERR675595_1_kneaddata_paired	Firmicutes_I	18140	P	123	0	123	0.00001
ERR675595_1_kneaddata_paired	Thermotogota	33086	P	58	0	58	0.00000
ERR675595_1_kneaddata_paired	Firmicutes_C	17613	P	57	0	57	0.00000
ERR675595_1_kneaddata_paired	Elusimicrobiota	11888	P	14	0	14	0.00000
ERR675596_1_kneaddata_paired	Firmicutes_A	14608	P	8100255	26219	8126474	0.49651
ERR675596_1_kneaddata_paired	Bacteroidota	4587	P	5637520	157500	5795020	0.35406
ERR675596_1_kneaddata_paired	Firmicutes	12188	P	2363001	19626	2382627	0.14557
ERR675596_1_kneaddata_paired	Proteobacteria	22518	P	36169	49	36218	0.00221
ERR675596_1_kneaddata_paired	Actinobacteriota	615	P	19676	22	19698	0.00120
ERR675596_1_kneaddata_paired	Cyanobacteria	9876	P	3129	80	3209	0.00020
ERR675596_1_kneaddata_paired	Firmicutes_B	17289	P	1026	33	1059	0.00006
ERR675596_1_kneaddata_paired	Desulfobacterota_A	11509	P	917	96	1013	0.00006
ERR675596_1_kneaddata_paired	Spirochaetota	32587	P	587	1	588	0.00004
ERR675596_1_kneaddata_paired	Campylobacterota	8700	P	427	0	427	0.00003
ERR675596_1_kneaddata_paired	Deferribacterota	10822	P	339	0	339	0.00002
ERR675596_1_kneaddata_paired	Verrucomicrobiota	33333	P	238	10	248	0.00002
ERR675596_1_kneaddata_paired	Firmicutes_I	18140	P	153	0	153	0.00001
ERR675596_1_kneaddata_paired	Firmicutes_C	17613	P	58	0	58	0.00000
ERR675596_1_kneaddata_paired	Thermotogota	33086	P	26	0	26	0.00000
ERR675596_1_kneaddata_paired	Elusimicrobiota	11888	P	8	0	8	0.00000
ERR675597_1_kneaddata_paired	Firmicutes_A	14608	P	4891482	18643	4910125	0.54493
ERR675597_1_kneaddata_paired	Bacteroidota	4587	P	2794378	3017	2797395	0.31046
ERR675597_1_kneaddata_paired	Firmicutes	12188	P	964618	40570	1005188	0.11156
ERR675597_1_kneaddata_paired	Desulfobacterota_A	11509	P	136884	348	137232	0.01523
ERR675597_1_kneaddata_paired	Deferribacterota	10822	P	74688	143	74831	0.00830
ERR675597_1_kneaddata_paired	Firmicutes_B	17289	P	61029	1158	62187	0.00690
ERR675597_1_kneaddata_paired	Proteobacteria	22518	P	9356	10	9366	0.00104
ERR675597_1_kneaddata_paired	Actinobacteriota	615	P	8940	9	8949	0.00099
ERR675597_1_kneaddata_paired	Spirochaetota	32587	P	2332	4	2336	0.00026
ERR675597_1_kneaddata_paired	Verrucomicrobiota	33333	P	2076	64	2140	0.00024
ERR675597_1_kneaddata_paired	Cyanobacteria	9876	P	637	3	640	0.00007
ERR675597_1_kneaddata_paired	Campylobacterota	8700	P	75	0	75	0.00001
ERR675597_1_kneaddata_paired	Firmicutes_I	18140	P	49	0	49	0.00001
ERR675597_1_kneaddata_paired	Firmicutes_C	17613	P	48	0	48	0.00001
ERR675597_1_kneaddata_paired	Thermotogota	33086	P	23	0	23	0.00000
ERR675597_1_kneaddata_paired	Elusimicrobiota	11888	P	3	0	3	0.00000
ERR675598_1_kneaddata_paired	Firmicutes_A	14608	P	5437520	39712	5477232	0.41493
ERR675598_1_kneaddata_paired	Bacteroidota	4587	P	5094405	9625	5104030	0.38665
ERR675598_1_kneaddata_paired	Firmicutes	12188	P	1803459	41900	1845359	0.13979
ERR675598_1_kneaddata_paired	Deferribacterota	10822	P	571303	1259	572562	0.04337
ERR675598_1_kneaddata_paired	Desulfobacterota_A	11509	P	98370	338	98708	0.00748
ERR675598_1_kneaddata_paired	Firmicutes_B	17289	P	55563	1206	56769	0.00430
ERR675598_1_kneaddata_paired	Actinobacteriota	615	P	18443	25	18468	0.00140
ERR675598_1_kneaddata_paired	Proteobacteria	22518	P	14672	36	14708	0.00111
ERR675598_1_kneaddata_paired	Spirochaetota	32587	P	6271	16	6287	0.00048
ERR675598_1_kneaddata_paired	Cyanobacteria	9876	P	4270	35	4305	0.00033
ERR675598_1_kneaddata_paired	Verrucomicrobiota	33333	P	1454	51	1505	0.00011
ERR675598_1_kneaddata_paired	Campylobacterota	8700	P	336	0	336	0.00003
ERR675598_1_kneaddata_paired	Firmicutes_I	18140	P	100	0	100	0.00001
ERR675598_1_kneaddata_paired	Thermotogota	33086	P	86	0	86	0.00001
ERR675598_1_kneaddata_paired	Firmicutes_C	17613	P	57	0	57	0.00000
ERR675598_1_kneaddata_paired	Elusimicrobiota	11888	P	4	0	4	0.00000
ERR675599_1_kneaddata_paired	Bacteroidota	4587	P	9466354	55478	9521832	0.78351
ERR675599_1_kneaddata_paired	Firmicutes_A	14608	P	1940870	14239	1955109	0.16088
ERR675599_1_kneaddata_paired	Firmicutes	12188	P	421292	2939	424231	0.03491
ERR675599_1_kneaddata_paired	Firmicutes_B	17289	P	134406	5164	139570	0.01148
ERR675599_1_kneaddata_paired	Deferribacterota	10822	P	66885	259	67144	0.00553
ERR675599_1_kneaddata_paired	Desulfobacterota_A	11509	P	37124	231	37355	0.00307
ERR675599_1_kneaddata_paired	Cyanobacteria	9876	P	2375	37	2412	0.00020
ERR675599_1_kneaddata_paired	Spirochaetota	32587	P	2325	10	2335	0.00019
ERR675599_1_kneaddata_paired	Actinobacteriota	615	P	1310	1	1311	0.00011
ERR675599_1_kneaddata_paired	Proteobacteria	22518	P	1204	5	1209	0.00010
ERR675599_1_kneaddata_paired	Verrucomicrobiota	33333	P	97	5	102	0.00001
ERR675599_1_kneaddata_paired	Campylobacterota	8700	P	82	0	82	0.00001
ERR675599_1_kneaddata_paired	Firmicutes_C	17613	P	35	0	35	0.00000
ERR675599_1_kneaddata_paired	Thermotogota	33086	P	23	0	23	0.00000
ERR675599_1_kneaddata_paired	Firmicutes_I	18140	P	18	0	18	0.00000
ERR675599_1_kneaddata_paired	Elusimicrobiota	11888	P	1	0	1	0.00000
ERR675600_1_kneaddata_paired	Firmicutes_A	14608	P	2827275	15737	2843012	0.43069
ERR675600_1_kneaddata_paired	Bacteroidota	4587	P	2520242	4450	2524692	0.38246
ERR675600_1_kneaddata_paired	Firmicutes	12188	P	984036	41891	1025927	0.15542
ERR675600_1_kneaddata_paired	Deferribacterota	10822	P	134181	278	134459	0.02037
ERR675600_1_kneaddata_paired	Desulfobacterota_A	11509	P	40105	142	40247	0.00610
ERR675600_1_kneaddata_paired	Firmicutes_B	17289	P	23182	476	23658	0.00358
ERR675600_1_kneaddata_paired	Proteobacteria	22518	P	3075	11	3086	0.00047
ERR675600_1_kneaddata_paired	Spirochaetota	32587	P	2380	5	2385	0.00036
ERR675600_1_kneaddata_paired	Actinobacteriota	615	P	1856	1	1857	0.00028
ERR675600_1_kneaddata_paired	Verrucomicrobiota	33333	P	1027	34	1061	0.00016
ERR675600_1_kneaddata_paired	Cyanobacteria	9876	P	580	4	584	0.00009
ERR675600_1_kneaddata_paired	Campylobacterota	8700	P	85	0	85	0.00001
ERR675600_1_kneaddata_paired	Thermotogota	33086	P	48	0	48	0.00001
ERR675600_1_kneaddata_paired	Firmicutes_C	17613	P	18	0	18	0.00000
ERR675600_1_kneaddata_paired	Firmicutes_I	18140	P	15	0	15	0.00000
ERR675601_1_kneaddata_paired	Firmicutes_A	14608	P	13060023	67518	13127541	0.68896
ERR675601_1_kneaddata_paired	Bacteroidota	4587	P	4045281	4450	4049731	0.21254
ERR675601_1_kneaddata_paired	Firmicutes	12188	P	1358164	46404	1404568	0.07371
ERR675601_1_kneaddata_paired	Firmicutes_B	17289	P	231200	4474	235674	0.01237
ERR675601_1_kneaddata_paired	Desulfobacterota_A	11509	P	130725	656	131381	0.00690
ERR675601_1_kneaddata_paired	Deferribacterota	10822	P	55983	109	56092	0.00294
ERR675601_1_kneaddata_paired	Actinobacteriota	615	P	20593	23	20616	0.00108
ERR675601_1_kneaddata_paired	Proteobacteria	22518	P	15517	41	15558	0.00082
ERR675601_1_kneaddata_paired	Verrucomicrobiota	33333	P	6364	201	6565	0.00034
ERR675601_1_kneaddata_paired	Spirochaetota	32587	P	3278	7	3285	0.00017
ERR675601_1_kneaddata_paired	Cyanobacteria	9876	P	2468	15	2483	0.00013
ERR675601_1_kneaddata_paired	Campylobacterota	8700	P	169	0	169	0.00001
ERR675601_1_kneaddata_paired	Thermotogota	33086	P	158	0	158	0.00001
ERR675601_1_kneaddata_paired	Firmicutes_C	17613	P	144	0	144	0.00001
ERR675601_1_kneaddata_paired	Firmicutes_I	18140	P	141	0	141	0.00001
ERR675601_1_kneaddata_paired	Elusimicrobiota	11888	P	16	0	16	0.00000
ERR675602_1_kneaddata_paired	Firmicutes_A	14608	P	3233106	36331	3269437	0.44312
ERR675602_1_kneaddata_paired	Bacteroidota	4587	P	2344815	14621	2359436	0.31978
ERR675602_1_kneaddata_paired	Deferribacterota	10822	P	1015567	4975	1020542	0.13832
ERR675602_1_kneaddata_paired	Firmicutes	12188	P	656000	7607	663607	0.08994
ERR675602_1_kneaddata_paired	Desulfobacterota_A	11509	P	35205	335	35540	0.00482
ERR675602_1_kneaddata_paired	Firmicutes_B	17289	P	21498	1041	22539	0.00305
ERR675602_1_kneaddata_paired	Spirochaetota	32587	P	2852	15	2867	0.00039
ERR675602_1_kneaddata_paired	Actinobacteriota	615	P	1533	3	1536	0.00021
ERR675602_1_kneaddata_paired	Proteobacteria	22518	P	1262	6	1268	0.00017
ERR675602_1_kneaddata_paired	Cyanobacteria	9876	P	911	14	925	0.00013
ERR675602_1_kneaddata_paired	Campylobacterota	8700	P	284	0	284	0.00004
ERR675602_1_kneaddata_paired	Verrucomicrobiota	33333	P	155	12	167	0.00002
ERR675602_1_kneaddata_paired	Firmicutes_C	17613	P	34	0	34	0.00000
ERR675602_1_kneaddata_paired	Firmicutes_I	18140	P	17	0	17	0.00000
ERR675602_1_kneaddata_paired	Thermotogota	33086	P	15	0	15	0.00000
ERR675603_1_kneaddata_paired	Bacteroidota	4587	P	3514428	19298	3533726	0.48343
ERR675603_1_kneaddata_paired	Firmicutes_A	14608	P	1817940	34210	1852150	0.25338
ERR675603_1_kneaddata_paired	Firmicutes	12188	P	1514321	23997	1538318	0.21045
ERR675603_1_kneaddata_paired	Deferribacterota	10822	P	314032	1743	315775	0.04320
ERR675603_1_kneaddata_paired	Desulfobacterota_A	11509	P	41492	379	41871	0.00573
ERR675603_1_kneaddata_paired	Firmicutes_B	17289	P	14717	810	15527	0.00212
ERR675603_1_kneaddata_paired	Spirochaetota	32587	P	5486	38	5524	0.00076
ERR675603_1_kneaddata_paired	Proteobacteria	22518	P	4160	27	4187	0.00057
ERR675603_1_kneaddata_paired	Cyanobacteria	9876	P	1063	20	1083	0.00015
ERR675603_1_kneaddata_paired	Actinobacteriota	615	P	1039	7	1046	0.00014
ERR675603_1_kneaddata_paired	Verrucomicrobiota	33333	P	207	18	225	0.00003
ERR675603_1_kneaddata_paired	Campylobacterota	8700	P	205	0	205	0.00003
ERR675603_1_kneaddata_paired	Thermotogota	33086	P	46	0	46	0.00001
ERR675603_1_kneaddata_paired	Firmicutes_C	17613	P	38	0	38	0.00001
ERR675603_1_kneaddata_paired	Firmicutes_I	18140	P	36	0	36	0.00000
ERR675603_1_kneaddata_paired	Elusimicrobiota	11888	P	1	0	1	0.00000
ERR675604_1_kneaddata_paired	Verrucomicrobiota	33333	P	2710727	19482	2730209	0.30885
ERR675604_1_kneaddata_paired	Firmicutes	12188	P	2704677	41494	2746171	0.31065
ERR675604_1_kneaddata_paired	Bacteroidota	4587	P	1726829	767	1727596	0.19543
ERR675604_1_kneaddata_paired	Firmicutes_A	14608	P	986567	1072	987639	0.11172
ERR675604_1_kneaddata_paired	Actinobacteriota	615	P	552151	2104	554255	0.06270
ERR675604_1_kneaddata_paired	Desulfobacterota_A	11509	P	41834	740	42574	0.00482
ERR675604_1_kneaddata_paired	Proteobacteria	22518	P	41061	7	41068	0.00465
ERR675604_1_kneaddata_paired	Deferribacterota	10822	P	9867	4	9871	0.00112
ERR675604_1_kneaddata_paired	Cyanobacteria	9876	P	310	0	310	0.00004
ERR675604_1_kneaddata_paired	Campylobacterota	8700	P	101	0	101	0.00001
ERR675604_1_kneaddata_paired	Spirochaetota	32587	P	91	0	91	0.00001
ERR675604_1_kneaddata_paired	Firmicutes_B	17289	P	83	0	83	0.00001
ERR675604_1_kneaddata_paired	Firmicutes_I	18140	P	65	0	65	0.00001
ERR675604_1_kneaddata_paired	Firmicutes_C	17613	P	16	0	16	0.00000
ERR675604_1_kneaddata_paired	Elusimicrobiota	11888	P	2	0	2	0.00000
ERR675604_1_kneaddata_paired	Thermotogota	33086	P	1	0	1	0.00000
ERR675605_1_kneaddata_paired	Verrucomicrobiota	33333	P	3815652	32012	3847664	0.31523
ERR675605_1_kneaddata_paired	Bacteroidota	4587	P	2985227	1861	2987088	0.24472
ERR675605_1_kneaddata_paired	Firmicutes	12188	P	2553151	39113	2592264	0.21238
ERR675605_1_kneaddata_paired	Firmicutes_A	14608	P	1356213	1900	1358113	0.11127
ERR675605_1_kneaddata_paired	Actinobacteriota	615	P	1227643	5602	1233245	0.10104
ERR675605_1_kneaddata_paired	Proteobacteria	22518	P	91655	17	91672	0.00751
ERR675605_1_kneaddata_paired	Desulfobacterota_A	11509	P	84503	1839	86342	0.00707
ERR675605_1_kneaddata_paired	Deferribacterota	10822	P	7989	4	7993	0.00065
ERR675605_1_kneaddata_paired	Cyanobacteria	9876	P	718	1	719	0.00006
ERR675605_1_kneaddata_paired	Firmicutes_B	17289	P	386	2	388	0.00003
ERR675605_1_kneaddata_paired	Campylobacterota	8700	P	232	0	232	0.00002
ERR675605_1_kneaddata_paired	Firmicutes_I	18140	P	155	0	155	0.00001
ERR675605_1_kneaddata_paired	Spirochaetota	32587	P	121	0	121	0.00001
ERR675605_1_kneaddata_paired	Firmicutes_C	17613	P	28	0	28	0.00000
ERR675605_1_kneaddata_paired	Elusimicrobiota	11888	P	8	0	8	0.00000
ERR675605_1_kneaddata_paired	Thermotogota	33086	P	3	0	3	0.00000
ERR675606_1_kneaddata_paired	Verrucomicrobiota	33333	P	3322024	30609	3352633	0.41589
ERR675606_1_kneaddata_paired	Bacteroidota	4587	P	1869642	1652	1871294	0.23213
ERR675606_1_kneaddata_paired	Firmicutes_A	14608	P	1459835	3313	1463148	0.18150
ERR675606_1_kneaddata_paired	Firmicutes	12188	P	1137751	14909	1152660	0.14299
ERR675606_1_kneaddata_paired	Desulfobacterota_A	11509	P	159545	3864	163409	0.02027
ERR675606_1_kneaddata_paired	Proteobacteria	22518	P	33290	7	33297	0.00413
ERR675606_1_kneaddata_paired	Actinobacteriota	615	P	16485	11	16496	0.00205
ERR675606_1_kneaddata_paired	Deferribacterota	10822	P	7162	4	7166	0.00089
ERR675606_1_kneaddata_paired	Cyanobacteria	9876	P	711	1	712	0.00009
ERR675606_1_kneaddata_paired	Spirochaetota	32587	P	210	0	210	0.00003
ERR675606_1_kneaddata_paired	Firmicutes_B	17289	P	165	0	165	0.00002
ERR675606_1_kneaddata_paired	Campylobacterota	8700	P	105	0	105	0.00001
ERR675606_1_kneaddata_paired	Firmicutes_I	18140	P	45	0	45	0.00001
ERR675606_1_kneaddata_paired	Firmicutes_C	17613	P	18	0	18	0.00000
ERR675606_1_kneaddata_paired	Elusimicrobiota	11888	P	2	0	2	0.00000
ERR675606_1_kneaddata_paired	Thermotogota	33086	P	2	0	2	0.00000
ERR675607_1_kneaddata_paired	Firmicutes	12188	P	4411141	69155	4480296	0.60762
ERR675607_1_kneaddata_paired	Verrucomicrobiota	33333	P	1424900	10146	1435046	0.19462
ERR675607_1_kneaddata_paired	Firmicutes_A	14608	P	681705	823	682528	0.09257
ERR675607_1_kneaddata_paired	Bacteroidota	4587	P	678962	345	679307	0.09213
ERR675607_1_kneaddata_paired	Proteobacteria	22518	P	32460	13	32473	0.00440
ERR675607_1_kneaddata_paired	Actinobacteriota	615	P	31618	21	31639	0.00429
ERR675607_1_kneaddata_paired	Desulfobacterota_A	11509	P	29215	525	29740	0.00403
ERR675607_1_kneaddata_paired	Deferribacterota	10822	P	1929	0	1929	0.00026
ERR675607_1_kneaddata_paired	Cyanobacteria	9876	P	206	0	206	0.00003
ERR675607_1_kneaddata_paired	Campylobacterota	8700	P	107	0	107	0.00001
ERR675607_1_kneaddata_paired	Firmicutes_I	18140	P	96	0	96	0.00001
ERR675607_1_kneaddata_paired	Spirochaetota	32587	P	73	0	73	0.00001
ERR675607_1_kneaddata_paired	Firmicutes_B	17289	P	33	0	33	0.00000
ERR675607_1_kneaddata_paired	Firmicutes_C	17613	P	15	0	15	0.00000
ERR675607_1_kneaddata_paired	Thermotogota	33086	P	3	0	3	0.00000
ERR675608_1_kneaddata_paired	Firmicutes	12188	P	3319697	56726	3376423	0.42923
ERR675608_1_kneaddata_paired	Bacteroidota	4587	P	3126187	32252	3158439	0.40152
ERR675608_1_kneaddata_paired	Firmicutes_A	14608	P	1186322	21630	1207952	0.15356
ERR675608_1_kneaddata_paired	Deferribacterota	10822	P	74274	751	75025	0.00954
ERR675608_1_kneaddata_paired	Spirochaetota	32587	P	18196	261	18457	0.00235
ERR675608_1_kneaddata_paired	Firmicutes_B	17289	P	13256	1329	14585	0.00185
ERR675608_1_kneaddata_paired	Desulfobacterota_A	11509	P	10158	225	10383	0.00132
ERR675608_1_kneaddata_paired	Actinobacteriota	615	P	2107	8	2115	0.00027
ERR675608_1_kneaddata_paired	Proteobacteria	22518	P	1950	6	1956	0.00025
ERR675608_1_kneaddata_paired	Cyanobacteria	9876	P	640	22	662	0.00008
ERR675608_1_kneaddata_paired	Campylobacterota	8700	P	94	0	94	0.00001
ERR675608_1_kneaddata_paired	Verrucomicrobiota	33333	P	51	7	58	0.00001
ERR675608_1_kneaddata_paired	Firmicutes_I	18140	P	17	0	17	0.00000
ERR675608_1_kneaddata_paired	Firmicutes_C	17613	P	16	0	16	0.00000
ERR675608_1_kneaddata_paired	Thermotogota	33086	P	5	0	5	0.00000
ERR675609_1_kneaddata_paired	Firmicutes_A	14608	P	4683097	68889	4751986	0.58722
ERR675609_1_kneaddata_paired	Firmicutes	12188	P	2578838	9917	2588755	0.31990
ERR675609_1_kneaddata_paired	Bacteroidota	4587	P	549648	1859	551507	0.06815
ERR675609_1_kneaddata_paired	Deferribacterota	10822	P	122404	307	122711	0.01516
ERR675609_1_kneaddata_paired	Desulfobacterota_A	11509	P	47551	181	47732	0.00590
ERR675609_1_kneaddata_paired	Proteobacteria	22518	P	12807	8	12815	0.00158
ERR675609_1_kneaddata_paired	Actinobacteriota	615	P	12410	21	12431	0.00154
ERR675609_1_kneaddata_paired	Spirochaetota	32587	P	1704	3	1707	0.00021
ERR675609_1_kneaddata_paired	Verrucomicrobiota	33333	P	921	37	958	0.00012
ERR675609_1_kneaddata_paired	Cyanobacteria	9876	P	839	4	843	0.00010
ERR675609_1_kneaddata_paired	Campylobacterota	8700	P	502	0	502	0.00006
ERR675609_1_kneaddata_paired	Firmicutes_B	17289	P	215	5	220	0.00003
ERR675609_1_kneaddata_paired	Firmicutes_I	18140	P	95	0	95	0.00001
ERR675609_1_kneaddata_paired	Thermotogota	33086	P	80	0	80	0.00001
ERR675609_1_kneaddata_paired	Firmicutes_C	17613	P	47	0	47	0.00001
ERR675609_1_kneaddata_paired	Elusimicrobiota	11888	P	9	0	9	0.00000
ERR675611_1_kneaddata_paired	Firmicutes_A	14608	P	6667023	72778	6739801	0.51651
ERR675611_1_kneaddata_paired	Firmicutes	12188	P	3284955	35779	3320734	0.25449
ERR675611_1_kneaddata_paired	Bacteroidota	4587	P	2629100	11782	2640882	0.20239
ERR675611_1_kneaddata_paired	Deferribacterota	10822	P	143621	880	144501	0.01107
ERR675611_1_kneaddata_paired	Desulfobacterota_A	11509	P	94880	934	95814	0.00734
ERR675611_1_kneaddata_paired	Firmicutes_B	17289	P	58968	3565	62533	0.00479
ERR675611_1_kneaddata_paired	Spirochaetota	32587	P	21025	175	21200	0.00162
ERR675611_1_kneaddata_paired	Actinobacteriota	615	P	16809	51	16860	0.00129
ERR675611_1_kneaddata_paired	Proteobacteria	22518	P	3079	16	3095	0.00024
ERR675611_1_kneaddata_paired	Cyanobacteria	9876	P	2213	47	2260	0.00017
ERR675611_1_kneaddata_paired	Verrucomicrobiota	33333	P	619	59	678	0.00005
ERR675611_1_kneaddata_paired	Campylobacterota	8700	P	196	0	196	0.00002
ERR675611_1_kneaddata_paired	Firmicutes_C	17613	P	66	0	66	0.00001
ERR675611_1_kneaddata_paired	Firmicutes_I	18140	P	57	0	57	0.00000
ERR675611_1_kneaddata_paired	Thermotogota	33086	P	14	0	14	0.00000
ERR675611_1_kneaddata_paired	Elusimicrobiota	11888	P	4	0	4	0.00000
ERR675613_1_kneaddata_paired	Firmicutes	12188	P	5461657	51932	5513589	0.49909
ERR675613_1_kneaddata_paired	Firmicutes_A	14608	P	4742172	99215	4841387	0.43824
ERR675613_1_kneaddata_paired	Bacteroidota	4587	P	344044	2974	347018	0.03141
ERR675613_1_kneaddata_paired	Deferribacterota	10822	P	128610	716	129326	0.01171
ERR675613_1_kneaddata_paired	Desulfobacterota_A	11509	P	106530	1003	107533	0.00973
ERR675613_1_kneaddata_paired	Actinobacteriota	615	P	43780	170	43950	0.00398
ERR675613_1_kneaddata_paired	Firmicutes_B	17289	P	34611	1899	36510	0.00330
ERR675613_1_kneaddata_paired	Proteobacteria	22518	P	17959	27	17986	0.00163
ERR675613_1_kneaddata_paired	Spirochaetota	32587	P	3354	17	3371	0.00031
ERR675613_1_kneaddata_paired	Cyanobacteria	9876	P	2817	30	2847	0.00026
ERR675613_1_kneaddata_paired	Campylobacterota	8700	P	1826	3	1829	0.00017
ERR675613_1_kneaddata_paired	Verrucomicrobiota	33333	P	1405	124	1529	0.00014
ERR675613_1_kneaddata_paired	Firmicutes_I	18140	P	136	0	136	0.00001
ERR675613_1_kneaddata_paired	Firmicutes_C	17613	P	135	0	135	0.00001
ERR675613_1_kneaddata_paired	Thermotogota	33086	P	91	0	91	0.00001
ERR675613_1_kneaddata_paired	Elusimicrobiota	11888	P	5	0	5	0.00000
ERR675615_1_kneaddata_paired	Bacteroidota	4587	P	4427187	17124	4444311	0.46621
ERR675615_1_kneaddata_paired	Firmicutes_A	14608	P	3786861	31059	3817920	0.40050
ERR675615_1_kneaddata_paired	Firmicutes	12188	P	1041451	9509	1050960	0.11025
ERR675615_1_kneaddata_paired	Desulfobacterota_A	11509	P	66657	421	67078	0.00704
ERR675615_1_kneaddata_paired	Firmicutes_B	17289	P	57585	2638	60223	0.00632
ERR675615_1_kneaddata_paired	Actinobacteriota	615	P	34363	107	34470	0.00362
ERR675615_1_kneaddata_paired	Deferribacterota	10822	P	33206	154	33360	0.00350
ERR675615_1_kneaddata_paired	Proteobacteria	22518	P	16891	31	16922	0.00178
ERR675615_1_kneaddata_paired	Spirochaetota	32587	P	5421	32	5453	0.00057
ERR675615_1_kneaddata_paired	Cyanobacteria	9876	P	997	17	1014	0.00011
ERR675615_1_kneaddata_paired	Verrucomicrobiota	33333	P	568	40	608	0.00006
ERR675615_1_kneaddata_paired	Campylobacterota	8700	P	249	0	249	0.00003
ERR675615_1_kneaddata_paired	Firmicutes_I	18140	P	138	0	138	0.00001
ERR675615_1_kneaddata_paired	Firmicutes_C	17613	P	63	0	63	0.00001
ERR675615_1_kneaddata_paired	Thermotogota	33086	P	25	0	25	0.00000
ERR675615_1_kneaddata_paired	Elusimicrobiota	11888	P	8	0	8	0.00000
ERR675617_1_kneaddata_paired	Firmicutes_A	14608	P	6388649	39099	6427748	0.72094
ERR675617_1_kneaddata_paired	Firmicutes	12188	P	978297	3044	981341	0.11007
ERR675617_1_kneaddata_paired	Bacteroidota	4587	P	478810	1739	480549	0.05390
ERR675617_1_kneaddata_paired	Desulfobacterota_A	11509	P	437636	1186	438822	0.04922
ERR675617_1_kneaddata_paired	Verrucomicrobiota	33333	P	251965	9189	261154	0.02929
ERR675617_1_kneaddata_paired	Deferribacterota	10822	P	126747	289	127036	0.01425
ERR675617_1_kneaddata_paired	Actinobacteriota	615	P	80676	145	80821	0.00906
ERR675617_1_kneaddata_paired	Firmicutes_B	17289	P	76236	1717	77953	0.00874
ERR675617_1_kneaddata_paired	Proteobacteria	22518	P	32420	23	32443	0.00364
ERR675617_1_kneaddata_paired	Spirochaetota	32587	P	4256	3	4259	0.00048
ERR675617_1_kneaddata_paired	Cyanobacteria	9876	P	2745	22	2767	0.00031
ERR675617_1_kneaddata_paired	Campylobacterota	8700	P	484	0	484	0.00005
ERR675617_1_kneaddata_paired	Firmicutes_I	18140	P	246	0	246	0.00003
ERR675617_1_kneaddata_paired	Firmicutes_C	17613	P	132	0	132	0.00001
ERR675617_1_kneaddata_paired	Thermotogota	33086	P	52	0	52	0.00001
ERR675617_1_kneaddata_paired	Elusimicrobiota	11888	P	8	0	8	0.00000
ERR675618_1_kneaddata_paired	Bacteroidota	4587	P	4920265	10184	4930449	0.45234
ERR675618_1_kneaddata_paired	Firmicutes_A	14608	P	3386968	11467	3398435	0.31179
ERR675618_1_kneaddata_paired	Verrucomicrobiota	33333	P	1834246	24044	1858290	0.17049
ERR675618_1_kneaddata_paired	Firmicutes	12188	P	464506	497	465003	0.04266
ERR675618_1_kneaddata_paired	Desulfobacterota_A	11509	P	153420	5317	158737	0.01456
ERR675618_1_kneaddata_paired	Proteobacteria	22518	P	33937	11	33948	0.00311
ERR675618_1_kneaddata_paired	Firmicutes_B	17289	P	22767	185	22952	0.00211
ERR675618_1_kneaddata_paired	Deferribacterota	10822	P	11527	9	11536	0.00106
ERR675618_1_kneaddata_paired	Actinobacteriota	615	P	10827	9	10836	0.00099
ERR675618_1_kneaddata_paired	Cyanobacteria	9876	P	9225	12	9237	0.00085
ERR675618_1_kneaddata_paired	Spirochaetota	32587	P	228	0	228	0.00002
ERR675618_1_kneaddata_paired	Campylobacterota	8700	P	133	0	133	0.00001
ERR675618_1_kneaddata_paired	Firmicutes_I	18140	P	57	0	57	0.00001
ERR675618_1_kneaddata_paired	Firmicutes_C	17613	P	31	0	31	0.00000
ERR675618_1_kneaddata_paired	Thermotogota	33086	P	10	0	10	0.00000
ERR675618_1_kneaddata_paired	Elusimicrobiota	11888	P	2	0	2	0.00000
ERR675619_1_kneaddata_paired	Firmicutes_A	14608	P	4496815	6507	4503322	0.47472
ERR675619_1_kneaddata_paired	Firmicutes	12188	P	1544236	12680	1556916	0.16412
ERR675619_1_kneaddata_paired	Verrucomicrobiota	33333	P	1250164	16732	1266896	0.13355
ERR675619_1_kneaddata_paired	Bacteroidota	4587	P	942549	1525	944074	0.09952
ERR675619_1_kneaddata_paired	Desulfobacterota_A	11509	P	886221	31437	917658	0.09674
ERR675619_1_kneaddata_paired	Deferribacterota	10822	P	159181	133	159314	0.01679
ERR675619_1_kneaddata_paired	Actinobacteriota	615	P	73869	60	73929	0.00779
ERR675619_1_kneaddata_paired	Proteobacteria	22518	P	58892	27	58919	0.00621
ERR675619_1_kneaddata_paired	Firmicutes_B	17289	P	1941	16	1957	0.00021
ERR675619_1_kneaddata_paired	Cyanobacteria	9876	P	1722	9	1731	0.00018
ERR675619_1_kneaddata_paired	Spirochaetota	32587	P	775	0	775	0.00008
ERR675619_1_kneaddata_paired	Campylobacterota	8700	P	370	0	370	0.00004
ERR675619_1_kneaddata_paired	Firmicutes_I	18140	P	198	0	198	0.00002
ERR675619_1_kneaddata_paired	Firmicutes_C	17613	P	104	0	104	0.00001
ERR675619_1_kneaddata_paired	Elusimicrobiota	11888	P	6	0	6	0.00000
ERR675619_1_kneaddata_paired	Thermotogota	33086	P	1	0	1	0.00000
ERR675621_1_kneaddata_paired	Bacteroidota	4587	P	1738756	1934	1740690	0.36361
ERR675621_1_kneaddata_paired	Firmicutes_A	14608	P	1253923	2882	1256805	0.26253
ERR675621_1_kneaddata_paired	Firmicutes	12188	P	895538	19315	914853	0.19110
ERR675621_1_kneaddata_paired	Verrucomicrobiota	33333	P	727442	9552	736994	0.15395
ERR675621_1_kneaddata_paired	Desulfobacterota_A	11509	P	62703	2241	64944	0.01357
ERR675621_1_kneaddata_paired	Proteobacteria	22518	P	27865	11	27876	0.00582
ERR675621_1_kneaddata_paired	Actinobacteriota	615	P	24374	27	24401	0.00510
ERR675621_1_kneaddata_paired	Deferribacterota	10822	P	14649	11	14660	0.00306
ERR675621_1_kneaddata_paired	Cyanobacteria	9876	P	4575	28	4603	0.00096
ERR675621_1_kneaddata_paired	Spirochaetota	32587	P	709	0	709	0.00015
ERR675621_1_kneaddata_paired	Firmicutes_B	17289	P	280	2	282	0.00006
ERR675621_1_kneaddata_paired	Campylobacterota	8700	P	273	0	273	0.00006
ERR675621_1_kneaddata_paired	Firmicutes_I	18140	P	111	0	111	0.00002
ERR675621_1_kneaddata_paired	Firmicutes_C	17613	P	12	0	12	0.00000
ERR675621_1_kneaddata_paired	Elusimicrobiota	11888	P	3	0	3	0.00000
ERR675621_1_kneaddata_paired	Thermotogota	33086	P	1	0	1	0.00000
ERR675622_1_kneaddata_paired	Firmicutes_A	14608	P	4645487	7581	4653068	0.53161
ERR675622_1_kneaddata_paired	Desulfobacterota_A	11509	P	1213461	42231	1255692	0.14346
ERR675622_1_kneaddata_paired	Firmicutes	12188	P	986359	2752	989111	0.11301
ERR675622_1_kneaddata_paired	Verrucomicrobiota	33333	P	811617	10017	821634	0.09387
ERR675622_1_kneaddata_paired	Bacteroidota	4587	P	729531	2692	732223	0.08366
ERR675622_1_kneaddata_paired	Deferribacterota	10822	P	262773	203	262976	0.03005
ERR675622_1_kneaddata_paired	Proteobacteria	22518	P	23254	5	23259	0.00266
ERR675622_1_kneaddata_paired	Actinobacteriota	615	P	11897	12	11909	0.00136
ERR675622_1_kneaddata_paired	Cyanobacteria	9876	P	1088	6	1094	0.00013
ERR675622_1_kneaddata_paired	Firmicutes_B	17289	P	809	6	815	0.00009
ERR675622_1_kneaddata_paired	Spirochaetota	32587	P	463	0	463	0.00005
ERR675622_1_kneaddata_paired	Campylobacterota	8700	P	283	0	283	0.00003
ERR675622_1_kneaddata_paired	Firmicutes_I	18140	P	142	0	142	0.00002
ERR675622_1_kneaddata_paired	Firmicutes_C	17613	P	42	0	42	0.00000
ERR675622_1_kneaddata_paired	Elusimicrobiota	11888	P	4	0	4	0.00000
ERR675622_1_kneaddata_paired	Thermotogota	33086	P	3	0	3	0.00000
ERR675623_1_kneaddata_paired	Firmicutes_A	14608	P	4386650	46665	4433315	0.46062
ERR675623_1_kneaddata_paired	Bacteroidota	4587	P	2730779	26164	2756943	0.28645
ERR675623_1_kneaddata_paired	Firmicutes	12188	P	2065274	25408	2090682	0.21722
ERR675623_1_kneaddata_paired	Deferribacterota	10822	P	240955	1653	242608	0.02521
ERR675623_1_kneaddata_paired	Firmicutes_B	17289	P	45054	3068	48122	0.00500
ERR675623_1_kneaddata_paired	Desulfobacterota_A	11509	P	34479	514	34993	0.00364
ERR675623_1_kneaddata_paired	Spirochaetota	32587	P	12375	117	12492	0.00130
ERR675623_1_kneaddata_paired	Proteobacteria	22518	P	2082	20	2102	0.00022
ERR675623_1_kneaddata_paired	Actinobacteriota	615	P	1955	5	1960	0.00020
ERR675623_1_kneaddata_paired	Cyanobacteria	9876	P	1067	27	1094	0.00011
ERR675623_1_kneaddata_paired	Campylobacterota	8700	P	144	0	144	0.00001
ERR675623_1_kneaddata_paired	Verrucomicrobiota	33333	P	85	9	94	0.00001
ERR675623_1_kneaddata_paired	Firmicutes_C	17613	P	25	0	25	0.00000
ERR675623_1_kneaddata_paired	Firmicutes_I	18140	P	18	0	18	0.00000
ERR675623_1_kneaddata_paired	Thermotogota	33086	P	16	0	16	0.00000
ERR675623_1_kneaddata_paired	Elusimicrobiota	11888	P	2	0	2	0.00000
ERR675625_1_kneaddata_paired	Bacteroidota	4587	P	1223346	1785	1225131	0.43656
ERR675625_1_kneaddata_paired	Verrucomicrobiota	33333	P	708493	8850	717343	0.25561
ERR675625_1_kneaddata_paired	Firmicutes_A	14608	P	555287	1678	556965	0.19847
ERR675625_1_kneaddata_paired	Firmicutes	12188	P	244201	277	244478	0.08712
ERR675625_1_kneaddata_paired	Desulfobacterota_A	11509	P	28660	907	29567	0.01054
ERR675625_1_kneaddata_paired	Proteobacteria	22518	P	20609	5	20614	0.00735
ERR675625_1_kneaddata_paired	Actinobacteriota	615	P	8122	4	8126	0.00290
ERR675625_1_kneaddata_paired	Deferribacterota	10822	P	2804	2	2806	0.00100
ERR675625_1_kneaddata_paired	Cyanobacteria	9876	P	885	2	887	0.00032
ERR675625_1_kneaddata_paired	Firmicutes_B	17289	P	169	1	170	0.00006
ERR675625_1_kneaddata_paired	Spirochaetota	32587	P	164	0	164	0.00006
ERR675625_1_kneaddata_paired	Campylobacterota	8700	P	54	0	54	0.00002
ERR675625_1_kneaddata_paired	Firmicutes_I	18140	P	32	0	32	0.00001
ERR675625_1_kneaddata_paired	Firmicutes_C	17613	P	12	0	12	0.00000
ERR675625_1_kneaddata_paired	Thermotogota	33086	P	4	0	4	0.00000
ERR675625_1_kneaddata_paired	Elusimicrobiota	11888	P	3	0	3	0.00000
ERR675626_1_kneaddata_paired	Bacteroidota	4587	P	3349669	6658	3356327	0.42344
ERR675626_1_kneaddata_paired	Firmicutes_A	14608	P	2595819	6877	2602696	0.32836
ERR675626_1_kneaddata_paired	Verrucomicrobiota	33333	P	1553083	26599	1579682	0.19930
ERR675626_1_kneaddata_paired	Firmicutes	12188	P	320728	393	321121	0.04051
ERR675626_1_kneaddata_paired	Proteobacteria	22518	P	22521	9	22530	0.00284
ERR675626_1_kneaddata_paired	Desulfobacterota_A	11509	P	17961	746	18707	0.00236
ERR675626_1_kneaddata_paired	Actinobacteriota	615	P	15376	11	15387	0.00194
ERR675626_1_kneaddata_paired	Deferribacterota	10822	P	7256	7	7263	0.00092
ERR675626_1_kneaddata_paired	Cyanobacteria	9876	P	2100	7	2107	0.00027
ERR675626_1_kneaddata_paired	Campylobacterota	8700	P	170	0	170	0.00002
ERR675626_1_kneaddata_paired	Firmicutes_B	17289	P	145	1	146	0.00002
ERR675626_1_kneaddata_paired	Spirochaetota	32587	P	92	0	92	0.00001
ERR675626_1_kneaddata_paired	Firmicutes_I	18140	P	42	0	42	0.00001
ERR675626_1_kneaddata_paired	Firmicutes_C	17613	P	37	0	37	0.00000
ERR675626_1_kneaddata_paired	Thermotogota	33086	P	10	0	10	0.00000
ERR675626_1_kneaddata_paired	Elusimicrobiota	11888	P	6	0	6	0.00000
ERR675627_1_kneaddata_paired	Bacteroidota	4587	P	16066069	10467	16076536	0.58566
ERR675627_1_kneaddata_paired	Firmicutes_A	14608	P	3720972	5915	3726887	0.13577
ERR675627_1_kneaddata_paired	Verrucomicrobiota	33333	P	3387094	31505	3418599	0.12454
ERR675627_1_kneaddata_paired	Firmicutes	12188	P	3005395	64081	3069476	0.11182
ERR675627_1_kneaddata_paired	Desulfobacterota_A	11509	P	453779	10401	464180	0.01691
ERR675627_1_kneaddata_paired	Actinobacteriota	615	P	357626	1743	359369	0.01309
ERR675627_1_kneaddata_paired	Proteobacteria	22518	P	293260	275	293535	0.01069
ERR675627_1_kneaddata_paired	Deferribacterota	10822	P	38431	22	38453	0.00140
ERR675627_1_kneaddata_paired	Cyanobacteria	9876	P	2453	16	2469	0.00009
ERR675627_1_kneaddata_paired	Spirochaetota	32587	P	338	0	338	0.00001
ERR675627_1_kneaddata_paired	Campylobacterota	8700	P	149	0	149	0.00001
ERR675627_1_kneaddata_paired	Firmicutes_B	17289	P	148	0	148	0.00001
ERR675627_1_kneaddata_paired	Firmicutes_I	18140	P	48	0	48	0.00000
ERR675627_1_kneaddata_paired	Firmicutes_C	17613	P	40	0	40	0.00000
ERR675627_1_kneaddata_paired	Elusimicrobiota	11888	P	5	0	5	0.00000
ERR675627_1_kneaddata_paired	Thermotogota	33086	P	5	0	5	0.00000
ERR675628_1_kneaddata_paired	Bacteroidota	4587	P	21229281	20804	21250085	0.67262
ERR675628_1_kneaddata_paired	Firmicutes_A	14608	P	3129372	5045	3134417	0.09921
ERR675628_1_kneaddata_paired	Verrucomicrobiota	33333	P	2994415	33730	3028145	0.09585
ERR675628_1_kneaddata_paired	Firmicutes	12188	P	2555821	65932	2621753	0.08298
ERR675628_1_kneaddata_paired	Desulfobacterota_A	11509	P	607981	17706	625687	0.01980
ERR675628_1_kneaddata_paired	Proteobacteria	22518	P	477871	548	478419	0.01514
ERR675628_1_kneaddata_paired	Actinobacteriota	615	P	431733	2438	434171	0.01374
ERR675628_1_kneaddata_paired	Deferribacterota	10822	P	17635	12	17647	0.00056
ERR675628_1_kneaddata_paired	Cyanobacteria	9876	P	1754	12	1766	0.00006
ERR675628_1_kneaddata_paired	Firmicutes_B	17289	P	507	3	510	0.00002
ERR675628_1_kneaddata_paired	Campylobacterota	8700	P	202	0	202	0.00001
ERR675628_1_kneaddata_paired	Spirochaetota	32587	P	189	0	189	0.00001
ERR675628_1_kneaddata_paired	Firmicutes_I	18140	P	43	0	43	0.00000
ERR675628_1_kneaddata_paired	Firmicutes_C	17613	P	42	0	42	0.00000
ERR675628_1_kneaddata_paired	Elusimicrobiota	11888	P	17	0	17	0.00000
ERR675628_1_kneaddata_paired	Thermotogota	33086	P	6	0	6	0.00000
ERR675629_1_kneaddata_paired	Bacteroidota	4587	P	12322896	9551	12332447	0.48657
ERR675629_1_kneaddata_paired	Firmicutes_A	14608	P	4457052	5024	4462076	0.17605
ERR675629_1_kneaddata_paired	Firmicutes	12188	P	3724691	92274	3816965	0.15060
ERR675629_1_kneaddata_paired	Verrucomicrobiota	33333	P	3511886	37806	3549692	0.14005
ERR675629_1_kneaddata_paired	Desulfobacterota_A	11509	P	483082	13190	496272	0.01958
ERR675629_1_kneaddata_paired	Actinobacteriota	615	P	424115	2232	426347	0.01682
ERR675629_1_kneaddata_paired	Proteobacteria	22518	P	176564	185	176749	0.00697
ERR675629_1_kneaddata_paired	Deferribacterota	10822	P	82383	55	82438	0.00325
ERR675629_1_kneaddata_paired	Cyanobacteria	9876	P	1482	10	1492	0.00006
ERR675629_1_kneaddata_paired	Firmicutes_B	17289	P	470	3	473	0.00002
ERR675629_1_kneaddata_paired	Spirochaetota	32587	P	238	0	238	0.00001
ERR675629_1_kneaddata_paired	Campylobacterota	8700	P	137	0	137	0.00001
ERR675629_1_kneaddata_paired	Firmicutes_C	17613	P	89	0	89	0.00000
ERR675629_1_kneaddata_paired	Firmicutes_I	18140	P	58	0	58	0.00000
ERR675629_1_kneaddata_paired	Elusimicrobiota	11888	P	9	0	9	0.00000
ERR675629_1_kneaddata_paired	Thermotogota	33086	P	2	0	2	0.00000
ERR675630_1_kneaddata_paired	Bacteroidota	4587	P	14255190	14363	14269553	0.63031
ERR675630_1_kneaddata_paired	Verrucomicrobiota	33333	P	3336420	34773	3371193	0.14891
ERR675630_1_kneaddata_paired	Firmicutes	12188	P	2267823	54209	2322032	0.10257
ERR675630_1_kneaddata_paired	Firmicutes_A	14608	P	1839367	2579	1841946	0.08136
ERR675630_1_kneaddata_paired	Desulfobacterota_A	11509	P	302286	8322	310608	0.01372
ERR675630_1_kneaddata_paired	Actinobacteriota	615	P	221360	1192	222552	0.00983
ERR675630_1_kneaddata_paired	Proteobacteria	22518	P	166604	158	166762	0.00737
ERR675630_1_kneaddata_paired	Deferribacterota	10822	P	126094	82	126176	0.00557
ERR675630_1_kneaddata_paired	Cyanobacteria	9876	P	7603	39	7642	0.00034
ERR675630_1_kneaddata_paired	Spirochaetota	32587	P	171	0	171	0.00001
ERR675630_1_kneaddata_paired	Firmicutes_B	17289	P	144	0	144	0.00001
ERR675630_1_kneaddata_paired	Campylobacterota	8700	P	115	0	115	0.00001
ERR675630_1_kneaddata_paired	Firmicutes_C	17613	P	53	0	53	0.00000
ERR675630_1_kneaddata_paired	Firmicutes_I	18140	P	35	0	35	0.00000
ERR675630_1_kneaddata_paired	Elusimicrobiota	11888	P	10	0	10	0.00000
ERR675630_1_kneaddata_paired	Thermotogota	33086	P	2	0	2	0.00000
ERR675631_1_kneaddata_paired	Bacteroidota	4587	P	17263446	24638	17288084	0.66405
ERR675631_1_kneaddata_paired	Verrucomicrobiota	33333	P	3258185	37473	3295658	0.12659
ERR675631_1_kneaddata_paired	Firmicutes_A	14608	P	2405460	3761	2409221	0.09254
ERR675631_1_kneaddata_paired	Firmicutes	12188	P	1961721	51145	2012866	0.07732
ERR675631_1_kneaddata_paired	Desulfobacterota_A	11509	P	639991	17231	657222	0.02524
ERR675631_1_kneaddata_paired	Proteobacteria	22518	P	199140	163	199303	0.00766
ERR675631_1_kneaddata_paired	Actinobacteriota	615	P	93157	463	93620	0.00360
ERR675631_1_kneaddata_paired	Deferribacterota	10822	P	44967	32	44999	0.00173
ERR675631_1_kneaddata_paired	Cyanobacteria	9876	P	32620	187	32807	0.00126
ERR675631_1_kneaddata_paired	Spirochaetota	32587	P	223	0	223	0.00001
ERR675631_1_kneaddata_paired	Campylobacterota	8700	P	192	0	192	0.00001
ERR675631_1_kneaddata_paired	Firmicutes_B	17289	P	145	1	146	0.00001
ERR675631_1_kneaddata_paired	Firmicutes_C	17613	P	68	0	68	0.00000
ERR675631_1_kneaddata_paired	Firmicutes_I	18140	P	55	0	55	0.00000
ERR675631_1_kneaddata_paired	Elusimicrobiota	11888	P	12	0	12	0.00000
ERR675631_1_kneaddata_paired	Thermotogota	33086	P	9	0	9	0.00000
ERR675632_1_kneaddata_paired	Bacteroidota	4587	P	17687227	24986	17712213	0.70274
ERR675632_1_kneaddata_paired	Firmicutes_A	14608	P	4037884	7452	4045336	0.16050
ERR675632_1_kneaddata_paired	Verrucomicrobiota	33333	P	2133503	35118	2168621	0.08604
ERR675632_1_kneaddata_paired	Firmicutes	12188	P	581684	20460	602144	0.02389
ERR675632_1_kneaddata_paired	Desulfobacterota_A	11509	P	437275	18978	456253	0.01810
ERR675632_1_kneaddata_paired	Deferribacterota	10822	P	119132	122	119254	0.00473
ERR675632_1_kneaddata_paired	Proteobacteria	22518	P	56892	58	56950	0.00226
ERR675632_1_kneaddata_paired	Actinobacteriota	615	P	31981	180	32161	0.00128
ERR675632_1_kneaddata_paired	Cyanobacteria	9876	P	9678	139	9817	0.00039
ERR675632_1_kneaddata_paired	Firmicutes_B	17289	P	1039	10	1049	0.00004
ERR675632_1_kneaddata_paired	Spirochaetota	32587	P	273	0	273	0.00001
ERR675632_1_kneaddata_paired	Campylobacterota	8700	P	173	0	173	0.00001
ERR675632_1_kneaddata_paired	Firmicutes_C	17613	P	79	0	79	0.00000
ERR675632_1_kneaddata_paired	Firmicutes_I	18140	P	70	0	70	0.00000
ERR675632_1_kneaddata_paired	Elusimicrobiota	11888	P	17	0	17	0.00000
ERR675632_1_kneaddata_paired	Thermotogota	33086	P	2	0	2	0.00000
ERR675633_1_kneaddata_paired	Bacteroidota	4587	P	23112648	22230	23134878	0.62786
ERR675633_1_kneaddata_paired	Firmicutes_A	14608	P	5395622	9056	5404678	0.14668
ERR675633_1_kneaddata_paired	Firmicutes	12188	P	5182321	124550	5306871	0.14402
ERR675633_1_kneaddata_paired	Verrucomicrobiota	33333	P	1674512	17547	1692059	0.04592
ERR675633_1_kneaddata_paired	Desulfobacterota_A	11509	P	708661	19356	728017	0.01976
ERR675633_1_kneaddata_paired	Proteobacteria	22518	P	255510	221	255731	0.00694
ERR675633_1_kneaddata_paired	Actinobacteriota	615	P	214344	999	215343	0.00584
ERR675633_1_kneaddata_paired	Deferribacterota	10822	P	82701	54	82755	0.00225
ERR675633_1_kneaddata_paired	Cyanobacteria	9876	P	25450	237	25687	0.00070
ERR675633_1_kneaddata_paired	Firmicutes_B	17289	P	616	3	619	0.00002
ERR675633_1_kneaddata_paired	Spirochaetota	32587	P	242	0	242	0.00001
ERR675633_1_kneaddata_paired	Campylobacterota	8700	P	224	0	224	0.00001
ERR675633_1_kneaddata_paired	Firmicutes_I	18140	P	80	0	80	0.00000
ERR675633_1_kneaddata_paired	Firmicutes_C	17613	P	56	0	56	0.00000
ERR675633_1_kneaddata_paired	Elusimicrobiota	11888	P	4	0	4	0.00000
ERR675633_1_kneaddata_paired	Thermotogota	33086	P	3	0	3	0.00000
ERR675634_1_kneaddata_paired	Bacteroidota	4587	P	15311707	25778	15337485	0.52736
ERR675634_1_kneaddata_paired	Firmicutes_A	14608	P	8219723	15659	8235382	0.28316
ERR675634_1_kneaddata_paired	Firmicutes	12188	P	2874159	83007	2957166	0.10168
ERR675634_1_kneaddata_paired	Verrucomicrobiota	33333	P	1078338	13643	1091981	0.03755
ERR675634_1_kneaddata_paired	Desulfobacterota_A	11509	P	952086	29048	981134	0.03374
ERR675634_1_kneaddata_paired	Actinobacteriota	615	P	175219	983	176202	0.00606
ERR675634_1_kneaddata_paired	Deferribacterota	10822	P	143589	113	143702	0.00494
ERR675634_1_kneaddata_paired	Proteobacteria	22518	P	131744	119	131863	0.00453
ERR675634_1_kneaddata_paired	Cyanobacteria	9876	P	26559	127	26686	0.00092
ERR675634_1_kneaddata_paired	Spirochaetota	32587	P	767	0	767	0.00003
ERR675634_1_kneaddata_paired	Firmicutes_B	17289	P	713	5	718	0.00002
ERR675634_1_kneaddata_paired	Campylobacterota	8700	P	193	0	193	0.00001
ERR675634_1_kneaddata_paired	Firmicutes_C	17613	P	106	0	106	0.00000
ERR675634_1_kneaddata_paired	Firmicutes_I	18140	P	94	0	94	0.00000
ERR675634_1_kneaddata_paired	Thermotogota	33086	P	17	0	17	0.00000
ERR675634_1_kneaddata_paired	Elusimicrobiota	11888	P	4	0	4	0.00000
ERR675635_1_kneaddata_paired	Bacteroidota	4587	P	13836114	23697	13859811	0.65301
ERR675635_1_kneaddata_paired	Firmicutes_A	14608	P	2854987	4929	2859916	0.13475
ERR675635_1_kneaddata_paired	Firmicutes	12188	P	2039095	53049	2092144	0.09857
ERR675635_1_kneaddata_paired	Verrucomicrobiota	33333	P	1571247	18379	1589626	0.07490
ERR675635_1_kneaddata_paired	Desulfobacterota_A	11509	P	473874	14891	488765	0.02303
ERR675635_1_kneaddata_paired	Proteobacteria	22518	P	171982	129	172111	0.00811
ERR675635_1_kneaddata_paired	Actinobacteriota	615	P	107322	566	107888	0.00508
ERR675635_1_kneaddata_paired	Deferribacterota	10822	P	41383	30	41413	0.00195
ERR675635_1_kneaddata_paired	Cyanobacteria	9876	P	12152	120	12272	0.00058
ERR675635_1_kneaddata_paired	Campylobacterota	8700	P	197	0	197	0.00001
ERR675635_1_kneaddata_paired	Firmicutes_B	17289	P	154	1	155	0.00001
ERR675635_1_kneaddata_paired	Spirochaetota	32587	P	127	0	127	0.00001
ERR675635_1_kneaddata_paired	Firmicutes_C	17613	P	35	0	35	0.00000
ERR675635_1_kneaddata_paired	Firmicutes_I	18140	P	31	0	31	0.00000
ERR675635_1_kneaddata_paired	Elusimicrobiota	11888	P	6	0	6	0.00000
ERR675635_1_kneaddata_paired	Thermotogota	33086	P	4	0	4	0.00000
ERR675636_1_kneaddata_paired	Bacteroidota	4587	P	18180163	13597	18193760	0.65379
ERR675636_1_kneaddata_paired	Verrucomicrobiota	33333	P	2954269	31235	2985504	0.10728
ERR675636_1_kneaddata_paired	Firmicutes_A	14608	P	2759138	4150	2763288	0.09930
ERR675636_1_kneaddata_paired	Firmicutes	12188	P	2681660	64829	2746489	0.09869
ERR675636_1_kneaddata_paired	Desulfobacterota_A	11509	P	477090	13543	490633	0.01763
ERR675636_1_kneaddata_paired	Actinobacteriota	615	P	307735	1700	309435	0.01112
ERR675636_1_kneaddata_paired	Proteobacteria	22518	P	247301	252	247553	0.00890
ERR675636_1_kneaddata_paired	Deferribacterota	10822	P	88527	58	88585	0.00318
ERR675636_1_kneaddata_paired	Cyanobacteria	9876	P	2194	15	2209	0.00008
ERR675636_1_kneaddata_paired	Firmicutes_B	17289	P	176	1	177	0.00001
ERR675636_1_kneaddata_paired	Campylobacterota	8700	P	164	0	164	0.00001
ERR675636_1_kneaddata_paired	Spirochaetota	32587	P	159	0	159	0.00001
ERR675636_1_kneaddata_paired	Firmicutes_C	17613	P	41	0	41	0.00000
ERR675636_1_kneaddata_paired	Firmicutes_I	18140	P	41	0	41	0.00000
ERR675636_1_kneaddata_paired	Elusimicrobiota	11888	P	8	0	8	0.00000
ERR675636_1_kneaddata_paired	Thermotogota	33086	P	6	0	6	0.00000
ERR675637_1_kneaddata_paired	Bacteroidota	4587	P	18094086	65830	18159916	0.70123
ERR675637_1_kneaddata_paired	Firmicutes_A	14608	P	6867102	19280	6886382	0.26591
ERR675637_1_kneaddata_paired	Firmicutes	12188	P	649152	2904	652056	0.02518
ERR675637_1_kneaddata_paired	Firmicutes_B	17289	P	102125	2173	104298	0.00403
ERR675637_1_kneaddata_paired	Actinobacteriota	615	P	42270	60	42330	0.00163
ERR675637_1_kneaddata_paired	Proteobacteria	22518	P	28074	272	28346	0.00109
ERR675637_1_kneaddata_paired	Deferribacterota	10822	P	9737	20	9757	0.00038
ERR675637_1_kneaddata_paired	Cyanobacteria	9876	P	8827	170	8997	0.00035
ERR675637_1_kneaddata_paired	Verrucomicrobiota	33333	P	2353	18	2371	0.00009
ERR675637_1_kneaddata_paired	Desulfobacterota_A	11509	P	1742	92	1834	0.00007
ERR675637_1_kneaddata_paired	Campylobacterota	8700	P	457	0	457	0.00002
ERR675637_1_kneaddata_paired	Spirochaetota	32587	P	309	0	309	0.00001
ERR675637_1_kneaddata_paired	Firmicutes_I	18140	P	150	0	150	0.00001
ERR675637_1_kneaddata_paired	Firmicutes_C	17613	P	77	0	77	0.00000
ERR675637_1_kneaddata_paired	Elusimicrobiota	11888	P	36	0	36	0.00000
ERR675637_1_kneaddata_paired	Thermotogota	33086	P	22	0	22	0.00000
ERR675638_1_kneaddata_paired	Bacteroidota	4587	P	24884162	84032	24968194	0.75609
ERR675638_1_kneaddata_paired	Firmicutes_A	14608	P	7418664	22044	7440708	0.22532
ERR675638_1_kneaddata_paired	Firmicutes	12188	P	424946	1925	426871	0.01293
ERR675638_1_kneaddata_paired	Firmicutes_B	17289	P	90374	1812	92186	0.00279
ERR675638_1_kneaddata_paired	Proteobacteria	22518	P	40491	367	40858	0.00124
ERR675638_1_kneaddata_paired	Actinobacteriota	615	P	28689	36	28725	0.00087
ERR675638_1_kneaddata_paired	Cyanobacteria	9876	P	9477	183	9660	0.00029
ERR675638_1_kneaddata_paired	Deferribacterota	10822	P	9218	18	9236	0.00028
ERR675638_1_kneaddata_paired	Verrucomicrobiota	33333	P	4167	15	4182	0.00013
ERR675638_1_kneaddata_paired	Desulfobacterota_A	11509	P	1315	68	1383	0.00004
ERR675638_1_kneaddata_paired	Campylobacterota	8700	P	397	0	397	0.00001
ERR675638_1_kneaddata_paired	Spirochaetota	32587	P	267	0	267	0.00001
ERR675638_1_kneaddata_paired	Firmicutes_I	18140	P	144	0	144	0.00000
ERR675638_1_kneaddata_paired	Firmicutes_C	17613	P	79	0	79	0.00000
ERR675638_1_kneaddata_paired	Elusimicrobiota	11888	P	49	0	49	0.00000
ERR675638_1_kneaddata_paired	Thermotogota	33086	P	23	0	23	0.00000
ERR675639_1_kneaddata_paired	Bacteroidota	4587	P	18418671	76402	18495073	0.69098
ERR675639_1_kneaddata_paired	Firmicutes_A	14608	P	7200979	21761	7222740	0.26984
ERR675639_1_kneaddata_paired	Firmicutes	12188	P	815916	3699	819615	0.03062
ERR675639_1_kneaddata_paired	Firmicutes_B	17289	P	135254	3209	138463	0.00517
ERR675639_1_kneaddata_paired	Actinobacteriota	615	P	41374	74	41448	0.00155
ERR675639_1_kneaddata_paired	Proteobacteria	22518	P	22586	240	22826	0.00085
ERR675639_1_kneaddata_paired	Deferribacterota	10822	P	12560	29	12589	0.00047
ERR675639_1_kneaddata_paired	Cyanobacteria	9876	P	9176	184	9360	0.00035
ERR675639_1_kneaddata_paired	Desulfobacterota_A	11509	P	1842	108	1950	0.00007
ERR675639_1_kneaddata_paired	Verrucomicrobiota	33333	P	957	26	983	0.00004
ERR675639_1_kneaddata_paired	Campylobacterota	8700	P	715	0	715	0.00003
ERR675639_1_kneaddata_paired	Spirochaetota	32587	P	378	0	378	0.00001
ERR675639_1_kneaddata_paired	Firmicutes_I	18140	P	198	0	198	0.00001
ERR675639_1_kneaddata_paired	Firmicutes_C	17613	P	71	0	71	0.00000
ERR675639_1_kneaddata_paired	Elusimicrobiota	11888	P	45	0	45	0.00000
ERR675639_1_kneaddata_paired	Thermotogota	33086	P	29	0	29	0.00000
ERR675640_1_kneaddata_paired	Bacteroidota	4587	P	24209112	87696	24296808	0.78072
ERR675640_1_kneaddata_paired	Firmicutes_A	14608	P	6456781	21177	6477958	0.20815
ERR675640_1_kneaddata_paired	Firmicutes	12188	P	226724	1160	227884	0.00732
ERR675640_1_kneaddata_paired	Proteobacteria	22518	P	52146	476	52622	0.00169
ERR675640_1_kneaddata_paired	Actinobacteriota	615	P	36039	43	36082	0.00116
ERR675640_1_kneaddata_paired	Deferribacterota	10822	P	8800	17	8817	0.00028
ERR675640_1_kneaddata_paired	Cyanobacteria	9876	P	8228	182	8410	0.00027
ERR675640_1_kneaddata_paired	Verrucomicrobiota	33333	P	7214	15	7229	0.00023
ERR675640_1_kneaddata_paired	Firmicutes_B	17289	P	3450	67	3517	0.00011
ERR675640_1_kneaddata_paired	Desulfobacterota_A	11509	P	1116	74	1190	0.00004
ERR675640_1_kneaddata_paired	Campylobacterota	8700	P	213	0	213	0.00001
ERR675640_1_kneaddata_paired	Spirochaetota	32587	P	132	0	132	0.00000
ERR675640_1_kneaddata_paired	Firmicutes_I	18140	P	49	0	49	0.00000
ERR675640_1_kneaddata_paired	Elusimicrobiota	11888	P	47	0	47	0.00000
ERR675640_1_kneaddata_paired	Firmicutes_C	17613	P	47	0	47	0.00000
ERR675640_1_kneaddata_paired	Thermotogota	33086	P	4	0	4	0.00000
ERR675641_1_kneaddata_paired	Firmicutes_A	14608	P	13571199	53099	13624298	0.49201
ERR675641_1_kneaddata_paired	Bacteroidota	4587	P	13534921	67721	13602642	0.49123
ERR675641_1_kneaddata_paired	Firmicutes	12188	P	296017	2889	298906	0.01079
ERR675641_1_kneaddata_paired	Firmicutes_B	17289	P	58652	1739	60391	0.00218
ERR675641_1_kneaddata_paired	Deferribacterota	10822	P	53632	161	53793	0.00194
ERR675641_1_kneaddata_paired	Actinobacteriota	615	P	20759	44	20803	0.00075
ERR675641_1_kneaddata_paired	Proteobacteria	22518	P	11166	145	11311	0.00041
ERR675641_1_kneaddata_paired	Verrucomicrobiota	33333	P	9026	90	9116	0.00033
ERR675641_1_kneaddata_paired	Cyanobacteria	9876	P	5121	147	5268	0.00019
ERR675641_1_kneaddata_paired	Desulfobacterota_A	11509	P	3294	248	3542	0.00013
ERR675641_1_kneaddata_paired	Campylobacterota	8700	P	300	0	300	0.00001
ERR675641_1_kneaddata_paired	Spirochaetota	32587	P	221	0	221	0.00001
ERR675641_1_kneaddata_paired	Firmicutes_C	17613	P	149	0	149	0.00001
ERR675641_1_kneaddata_paired	Firmicutes_I	18140	P	131	0	131	0.00000
ERR675641_1_kneaddata_paired	Thermotogota	33086	P	67	0	67	0.00000
ERR675641_1_kneaddata_paired	Elusimicrobiota	11888	P	28	0	28	0.00000
ERR675642_1_kneaddata_paired	Bacteroidota	4587	P	19209534	71575	19281109	0.69082
ERR675642_1_kneaddata_paired	Firmicutes_A	14608	P	8020274	30507	8050781	0.28845
ERR675642_1_kneaddata_paired	Firmicutes	12188	P	401240	3216	404456	0.01449
ERR675642_1_kneaddata_paired	Actinobacteriota	615	P	65888	82	65970	0.00236
ERR675642_1_kneaddata_paired	Firmicutes_B	17289	P	34555	745	35300	0.00126
ERR675642_1_kneaddata_paired	Proteobacteria	22518	P	27035	270	27305	0.00098
ERR675642_1_kneaddata_paired	Verrucomicrobiota	33333	P	17885	20	17905	0.00064
ERR675642_1_kneaddata_paired	Deferribacterota	10822	P	16026	34	16060	0.00058
ERR675642_1_kneaddata_paired	Cyanobacteria	9876	P	8998	143	9141	0.00033
ERR675642_1_kneaddata_paired	Desulfobacterota_A	11509	P	1491	110	1601	0.00006
ERR675642_1_kneaddata_paired	Campylobacterota	8700	P	349	0	349	0.00001
ERR675642_1_kneaddata_paired	Spirochaetota	32587	P	231	0	231	0.00001
ERR675642_1_kneaddata_paired	Firmicutes_I	18140	P	83	0	83	0.00000
ERR675642_1_kneaddata_paired	Firmicutes_C	17613	P	77	0	77	0.00000
ERR675642_1_kneaddata_paired	Elusimicrobiota	11888	P	21	0	21	0.00000
ERR675642_1_kneaddata_paired	Thermotogota	33086	P	7	0	7	0.00000
ERR675643_1_kneaddata_paired	Bacteroidota	4587	P	15955755	62171	16017926	0.57056
ERR675643_1_kneaddata_paired	Firmicutes_A	14608	P	11496657	42451	11539108	0.41103
ERR675643_1_kneaddata_paired	Firmicutes	12188	P	321881	1829	323710	0.01153
ERR675643_1_kneaddata_paired	Verrucomicrobiota	33333	P	48360	88	48448	0.00173
ERR675643_1_kneaddata_paired	Actinobacteriota	615	P	46042	78	46120	0.00164
ERR675643_1_kneaddata_paired	Deferribacterota	10822	P	39109	95	39204	0.00140
ERR675643_1_kneaddata_paired	Firmicutes_B	17289	P	35146	847	35993	0.00128
ERR675643_1_kneaddata_paired	Proteobacteria	22518	P	10443	106	10549	0.00038
ERR675643_1_kneaddata_paired	Cyanobacteria	9876	P	10181	176	10357	0.00037
ERR675643_1_kneaddata_paired	Desulfobacterota_A	11509	P	1436	91	1527	0.00005
ERR675643_1_kneaddata_paired	Campylobacterota	8700	P	327	0	327	0.00001
ERR675643_1_kneaddata_paired	Spirochaetota	32587	P	179	0	179	0.00001
ERR675643_1_kneaddata_paired	Firmicutes_I	18140	P	174	0	174	0.00001
ERR675643_1_kneaddata_paired	Firmicutes_C	17613	P	128	0	128	0.00000
ERR675643_1_kneaddata_paired	Elusimicrobiota	11888	P	51	0	51	0.00000
ERR675643_1_kneaddata_paired	Thermotogota	33086	P	25	0	25	0.00000
ERR675644_1_kneaddata_paired	Bacteroidota	4587	P	18699658	73763	18773421	0.65825
ERR675644_1_kneaddata_paired	Firmicutes_A	14608	P	9009320	33060	9042380	0.31705
ERR675644_1_kneaddata_paired	Firmicutes	12188	P	492807	3395	496202	0.01740
ERR675644_1_kneaddata_paired	Firmicutes_B	17289	P	107182	3065	110247	0.00387
ERR675644_1_kneaddata_paired	Actinobacteriota	615	P	52080	93	52173	0.00183
ERR675644_1_kneaddata_paired	Proteobacteria	22518	P	15800	188	15988	0.00056
ERR675644_1_kneaddata_paired	Cyanobacteria	9876	P	12391	193	12584	0.00044
ERR675644_1_kneaddata_paired	Deferribacterota	10822	P	10586	30	10616	0.00037
ERR675644_1_kneaddata_paired	Verrucomicrobiota	33333	P	3510	66	3576	0.00013
ERR675644_1_kneaddata_paired	Desulfobacterota_A	11509	P	1886	167	2053	0.00007
ERR675644_1_kneaddata_paired	Campylobacterota	8700	P	467	0	467	0.00002
ERR675644_1_kneaddata_paired	Spirochaetota	32587	P	244	0	244	0.00001
ERR675644_1_kneaddata_paired	Firmicutes_I	18140	P	162	0	162	0.00001
ERR675644_1_kneaddata_paired	Firmicutes_C	17613	P	106	0	106	0.00000
ERR675644_1_kneaddata_paired	Thermotogota	33086	P	51	0	51	0.00000
ERR675644_1_kneaddata_paired	Elusimicrobiota	11888	P	28	0	28	0.00000
ERR675645_1_kneaddata_paired	Bacteroidota	4587	P	18340193	91887	18432080	0.66797
ERR675645_1_kneaddata_paired	Firmicutes_A	14608	P	8382045	19403	8401448	0.30446
ERR675645_1_kneaddata_paired	Firmicutes	12188	P	530338	1968	532306	0.01929
ERR675645_1_kneaddata_paired	Firmicutes_B	17289	P	80524	1577	82101	0.00298
ERR675645_1_kneaddata_paired	Actinobacteriota	615	P	72633	106	72739	0.00264
ERR675645_1_kneaddata_paired	Deferribacterota	10822	P	28385	56	28441	0.00103
ERR675645_1_kneaddata_paired	Verrucomicrobiota	33333	P	17075	83	17158	0.00062
ERR675645_1_kneaddata_paired	Proteobacteria	22518	P	13798	112	13910	0.00050
ERR675645_1_kneaddata_paired	Cyanobacteria	9876	P	8494	113	8607	0.00031
ERR675645_1_kneaddata_paired	Desulfobacterota_A	11509	P	3961	215	4176	0.00015
ERR675645_1_kneaddata_paired	Campylobacterota	8700	P	496	0	496	0.00002
ERR675645_1_kneaddata_paired	Spirochaetota	32587	P	456	0	456	0.00002
ERR675645_1_kneaddata_paired	Firmicutes_I	18140	P	174	0	174	0.00001
ERR675645_1_kneaddata_paired	Firmicutes_C	17613	P	120	0	120	0.00000
ERR675645_1_kneaddata_paired	Elusimicrobiota	11888	P	47	0	47	0.00000
ERR675645_1_kneaddata_paired	Thermotogota	33086	P	20	0	20	0.00000
ERR675646_1_kneaddata_paired	Bacteroidota	4587	P	23431372	130271	23561643	0.70641
ERR675646_1_kneaddata_paired	Firmicutes_A	14608	P	8742372	32137	8774509	0.26307
ERR675646_1_kneaddata_paired	Firmicutes	12188	P	760361	3576	763937	0.02290
ERR675646_1_kneaddata_paired	Firmicutes_B	17289	P	111836	2706	114542	0.00343
ERR675646_1_kneaddata_paired	Actinobacteriota	615	P	73855	111	73966	0.00222
ERR675646_1_kneaddata_paired	Cyanobacteria	9876	P	25735	342	26077	0.00078
ERR675646_1_kneaddata_paired	Deferribacterota	10822	P	17532	42	17574	0.00053
ERR675646_1_kneaddata_paired	Proteobacteria	22518	P	15346	152	15498	0.00046
ERR675646_1_kneaddata_paired	Verrucomicrobiota	33333	P	2710	61	2771	0.00008
ERR675646_1_kneaddata_paired	Desulfobacterota_A	11509	P	1851	138	1989	0.00006
ERR675646_1_kneaddata_paired	Campylobacterota	8700	P	689	0	689	0.00002
ERR675646_1_kneaddata_paired	Spirochaetota	32587	P	454	1	455	0.00001
ERR675646_1_kneaddata_paired	Firmicutes_I	18140	P	154	0	154	0.00000
ERR675646_1_kneaddata_paired	Firmicutes_C	17613	P	104	0	104	0.00000
ERR675646_1_kneaddata_paired	Elusimicrobiota	11888	P	80	0	80	0.00000
ERR675646_1_kneaddata_paired	Thermotogota	33086	P	14	0	14	0.00000
ERR675647_1_kneaddata_paired	Firmicutes_A	14608	P	20495305	94835	20590140	0.53616
ERR675647_1_kneaddata_paired	Bacteroidota	4587	P	16870190	117520	16987710	0.44235
ERR675647_1_kneaddata_paired	Firmicutes	12188	P	447950	4208	452158	0.01177
ERR675647_1_kneaddata_paired	Deferribacterota	10822	P	181969	606	182575	0.00475
ERR675647_1_kneaddata_paired	Firmicutes_B	17289	P	72386	2380	74766	0.00195
ERR675647_1_kneaddata_paired	Actinobacteriota	615	P	67943	161	68104	0.00177
ERR675647_1_kneaddata_paired	Proteobacteria	22518	P	14866	198	15064	0.00039
ERR675647_1_kneaddata_paired	Verrucomicrobiota	33333	P	13515	299	13814	0.00036
ERR675647_1_kneaddata_paired	Cyanobacteria	9876	P	8624	190	8814	0.00023
ERR675647_1_kneaddata_paired	Desulfobacterota_A	11509	P	7452	831	8283	0.00022
ERR675647_1_kneaddata_paired	Campylobacterota	8700	P	604	0	604	0.00002
ERR675647_1_kneaddata_paired	Spirochaetota	32587	P	539	1	540	0.00001
ERR675647_1_kneaddata_paired	Firmicutes_C	17613	P	273	0	273	0.00001
ERR675647_1_kneaddata_paired	Firmicutes_I	18140	P	227	0	227	0.00001
ERR675647_1_kneaddata_paired	Elusimicrobiota	11888	P	48	0	48	0.00000
ERR675647_1_kneaddata_paired	Thermotogota	33086	P	16	0	16	0.00000
ERR675648_1_kneaddata_paired	Firmicutes_A	14608	P	16474516	87290	16561806	0.69485
ERR675648_1_kneaddata_paired	Bacteroidota	4587	P	6706558	45190	6751748	0.28327
ERR675648_1_kneaddata_paired	Firmicutes	12188	P	287567	2455	290022	0.01217
ERR675648_1_kneaddata_paired	Deferribacterota	10822	P	128775	415	129190	0.00542
ERR675648_1_kneaddata_paired	Actinobacteriota	615	P	37972	82	38054	0.00160
ERR675648_1_kneaddata_paired	Firmicutes_B	17289	P	37788	1198	38986	0.00164
ERR675648_1_kneaddata_paired	Cyanobacteria	9876	P	7672	163	7835	0.00033
ERR675648_1_kneaddata_paired	Proteobacteria	22518	P	7568	85	7653	0.00032
ERR675648_1_kneaddata_paired	Verrucomicrobiota	33333	P	4085	171	4256	0.00018
ERR675648_1_kneaddata_paired	Desulfobacterota_A	11509	P	3941	450	4391	0.00018
ERR675648_1_kneaddata_paired	Campylobacterota	8700	P	316	0	316	0.00001
ERR675648_1_kneaddata_paired	Spirochaetota	32587	P	266	0	266	0.00001
ERR675648_1_kneaddata_paired	Firmicutes_I	18140	P	221	0	221	0.00001
ERR675648_1_kneaddata_paired	Firmicutes_C	17613	P	166	0	166	0.00001
ERR675648_1_kneaddata_paired	Elusimicrobiota	11888	P	40	0	40	0.00000
ERR675648_1_kneaddata_paired	Thermotogota	33086	P	11	0	11	0.00000
ERR675649_1_kneaddata_paired	Bacteroidota	4587	P	12816883	69965	12886848	0.56220
ERR675649_1_kneaddata_paired	Firmicutes_A	14608	P	9000094	32270	9032364	0.39404
ERR675649_1_kneaddata_paired	Firmicutes	12188	P	810926	4569	815495	0.03558
ERR675649_1_kneaddata_paired	Firmicutes_B	17289	P	79466	2044	81510	0.00356
ERR675649_1_kneaddata_paired	Actinobacteriota	615	P	49438	72	49510	0.00216
ERR675649_1_kneaddata_paired	Deferribacterota	10822	P	29405	76	29481	0.00129
ERR675649_1_kneaddata_paired	Proteobacteria	22518	P	11131	118	11249	0.00049
ERR675649_1_kneaddata_paired	Cyanobacteria	9876	P	9676	174	9850	0.00043
ERR675649_1_kneaddata_paired	Desulfobacterota_A	11509	P	2510	245	2755	0.00012
ERR675649_1_kneaddata_paired	Verrucomicrobiota	33333	P	1948	14	1962	0.00009
ERR675649_1_kneaddata_paired	Campylobacterota	8700	P	441	0	441	0.00002
ERR675649_1_kneaddata_paired	Spirochaetota	32587	P	401	1	402	0.00002
ERR675649_1_kneaddata_paired	Firmicutes_I	18140	P	164	0	164	0.00001
ERR675649_1_kneaddata_paired	Firmicutes_C	17613	P	104	0	104	0.00000
ERR675649_1_kneaddata_paired	Elusimicrobiota	11888	P	46	0	46	0.00000
ERR675649_1_kneaddata_paired	Thermotogota	33086	P	22	0	22	0.00000
ERR675650_1_kneaddata_paired	Firmicutes_A	14608	P	14512277	66989	14579266	0.74269
ERR675650_1_kneaddata_paired	Bacteroidota	4587	P	4633415	32906	4666321	0.23771
ERR675650_1_kneaddata_paired	Deferribacterota	10822	P	166663	613	167276	0.00852
ERR675650_1_kneaddata_paired	Firmicutes	12188	P	157194	1584	158778	0.00809
ERR675650_1_kneaddata_paired	Actinobacteriota	615	P	31164	63	31227	0.00159
ERR675650_1_kneaddata_paired	Proteobacteria	22518	P	8899	174	9073	0.00046
ERR675650_1_kneaddata_paired	Firmicutes_B	17289	P	6888	249	7137	0.00036
ERR675650_1_kneaddata_paired	Cyanobacteria	9876	P	5335	155	5490	0.00028
ERR675650_1_kneaddata_paired	Verrucomicrobiota	33333	P	2605	92	2697	0.00014
ERR675650_1_kneaddata_paired	Desulfobacterota_A	11509	P	1835	195	2030	0.00010
ERR675650_1_kneaddata_paired	Spirochaetota	32587	P	267	0	267	0.00001
ERR675650_1_kneaddata_paired	Firmicutes_I	18140	P	257	0	257	0.00001
ERR675650_1_kneaddata_paired	Campylobacterota	8700	P	256	0	256	0.00001
ERR675650_1_kneaddata_paired	Firmicutes_C	17613	P	114	0	114	0.00001
ERR675650_1_kneaddata_paired	Elusimicrobiota	11888	P	31	0	31	0.00000
ERR675650_1_kneaddata_paired	Thermotogota	33086	P	5	0	5	0.00000
ERR675651_1_kneaddata_paired	Firmicutes_A	14608	P	9898875	38872	9937747	0.53650
ERR675651_1_kneaddata_paired	Bacteroidota	4587	P	7466803	37147	7503950	0.40511
ERR675651_1_kneaddata_paired	Firmicutes	12188	P	678766	2994	681760	0.03681
ERR675651_1_kneaddata_paired	Deferribacterota	10822	P	235030	550	235580	0.01272
ERR675651_1_kneaddata_paired	Firmicutes_B	17289	P	61915	1426	63341	0.00342
ERR675651_1_kneaddata_paired	Verrucomicrobiota	33333	P	36577	22	36599	0.00198
ERR675651_1_kneaddata_paired	Cyanobacteria	9876	P	25865	215	26080	0.00141
ERR675651_1_kneaddata_paired	Proteobacteria	22518	P	18398	182	18580	0.00100
ERR675651_1_kneaddata_paired	Actinobacteriota	615	P	15715	18	15733	0.00085
ERR675651_1_kneaddata_paired	Desulfobacterota_A	11509	P	1558	108	1666	0.00009
ERR675651_1_kneaddata_paired	Spirochaetota	32587	P	1023	2	1025	0.00006
ERR675651_1_kneaddata_paired	Campylobacterota	8700	P	631	0	631	0.00003
ERR675651_1_kneaddata_paired	Firmicutes_I	18140	P	282	0	282	0.00002
ERR675651_1_kneaddata_paired	Firmicutes_C	17613	P	135	0	135	0.00001
ERR675651_1_kneaddata_paired	Elusimicrobiota	11888	P	56	0	56	0.00000
ERR675651_1_kneaddata_paired	Thermotogota	33086	P	28	0	28	0.00000
ERR675652_1_kneaddata_paired	Firmicutes_A	14608	P	19754817	84327	19839144	0.72712
ERR675652_1_kneaddata_paired	Bacteroidota	4587	P	6617371	39977	6657348	0.24400
ERR675652_1_kneaddata_paired	Firmicutes	12188	P	416786	2880	419666	0.01538
ERR675652_1_kneaddata_paired	Deferribacterota	10822	P	249551	753	250304	0.00917
ERR675652_1_kneaddata_paired	Firmicutes_B	17289	P	55110	1636	56746	0.00208
ERR675652_1_kneaddata_paired	Actinobacteriota	615	P	36928	69	36997	0.00136
ERR675652_1_kneaddata_paired	Proteobacteria	22518	P	9265	122	9387	0.00034
ERR675652_1_kneaddata_paired	Cyanobacteria	9876	P	7420	92	7512	0.00028
ERR675652_1_kneaddata_paired	Desulfobacterota_A	11509	P	3093	294	3387	0.00012
ERR675652_1_kneaddata_paired	Verrucomicrobiota	33333	P	2634	100	2734	0.00010
ERR675652_1_kneaddata_paired	Spirochaetota	32587	P	456	1	457	0.00002
ERR675652_1_kneaddata_paired	Campylobacterota	8700	P	384	0	384	0.00001
ERR675652_1_kneaddata_paired	Firmicutes_C	17613	P	240	0	240	0.00001
ERR675652_1_kneaddata_paired	Firmicutes_I	18140	P	203	0	203	0.00001
ERR675652_1_kneaddata_paired	Elusimicrobiota	11888	P	43	0	43	0.00000
ERR675652_1_kneaddata_paired	Thermotogota	33086	P	19	0	19	0.00000
ERR675653_1_kneaddata_paired	Bacteroidota	4587	P	5265486	23038	5288524	0.48764
ERR675653_1_kneaddata_paired	Firmicutes_A	14608	P	5243318	13665	5256983	0.48474
ERR675653_1_kneaddata_paired	Desulfobacterota_A	11509	P	182531	181	182712	0.01685
ERR675653_1_kneaddata_paired	Actinobacteriota	615	P	62225	123	62348	0.00575
ERR675653_1_kneaddata_paired	Firmicutes	12188	P	34947	133	35080	0.00323
ERR675653_1_kneaddata_paired	Proteobacteria	22518	P	12030	11	12041	0.00111
ERR675653_1_kneaddata_paired	Campylobacterota	8700	P	5004	1	5005	0.00046
ERR675653_1_kneaddata_paired	Cyanobacteria	9876	P	854	6	860	0.00008
ERR675653_1_kneaddata_paired	Verrucomicrobiota	33333	P	716	20	736	0.00007
ERR675653_1_kneaddata_paired	Spirochaetota	32587	P	262	0	262	0.00002
ERR675653_1_kneaddata_paired	Firmicutes_B	17289	P	147	3	150	0.00001
ERR675653_1_kneaddata_paired	Firmicutes_I	18140	P	136	0	136	0.00001
ERR675653_1_kneaddata_paired	Firmicutes_C	17613	P	108	0	108	0.00001
ERR675653_1_kneaddata_paired	Deferribacterota	10822	P	72	0	72	0.00001
ERR675653_1_kneaddata_paired	Elusimicrobiota	11888	P	22	0	22	0.00000
ERR675653_1_kneaddata_paired	Thermotogota	33086	P	8	0	8	0.00000
ERR675654_1_kneaddata_paired	Bacteroidota	4587	P	6450388	30852	6481240	0.64154
ERR675654_1_kneaddata_paired	Firmicutes_A	14608	P	3377896	10726	3388622	0.33542
ERR675654_1_kneaddata_paired	Actinobacteriota	615	P	90754	204	90958	0.00900
ERR675654_1_kneaddata_paired	Firmicutes	12188	P	66082	271	66353	0.00657
ERR675654_1_kneaddata_paired	Desulfobacterota_A	11509	P	30865	66	30931	0.00306
ERR675654_1_kneaddata_paired	Proteobacteria	22518	P	26757	25	26782	0.00265
ERR675654_1_kneaddata_paired	Campylobacterota	8700	P	13984	5	13989	0.00138
ERR675654_1_kneaddata_paired	Cyanobacteria	9876	P	1673	11	1684	0.00017
ERR675654_1_kneaddata_paired	Deferribacterota	10822	P	1134	2	1136	0.00011
ERR675654_1_kneaddata_paired	Verrucomicrobiota	33333	P	485	12	497	0.00005
ERR675654_1_kneaddata_paired	Firmicutes_I	18140	P	155	0	155	0.00002
ERR675654_1_kneaddata_paired	Firmicutes_B	17289	P	112	2	114	0.00001
ERR675654_1_kneaddata_paired	Spirochaetota	32587	P	99	0	99	0.00001
ERR675654_1_kneaddata_paired	Firmicutes_C	17613	P	62	0	62	0.00001
ERR675654_1_kneaddata_paired	Elusimicrobiota	11888	P	24	0	24	0.00000
ERR675654_1_kneaddata_paired	Thermotogota	33086	P	14	0	14	0.00000
ERR675655_1_kneaddata_paired	Bacteroidota	4587	P	11825865	43922	11869787	0.74931
ERR675655_1_kneaddata_paired	Firmicutes_A	14608	P	3637358	9747	3647105	0.23023
ERR675655_1_kneaddata_paired	Verrucomicrobiota	33333	P	137698	4411	142109	0.00897
ERR675655_1_kneaddata_paired	Actinobacteriota	615	P	69160	152	69312	0.00438
ERR675655_1_kneaddata_paired	Desulfobacterota_A	11509	P	63993	123	64116	0.00405
ERR675655_1_kneaddata_paired	Proteobacteria	22518	P	30533	23	30556	0.00193
ERR675655_1_kneaddata_paired	Firmicutes	12188	P	12374	104	12478	0.00079
ERR675655_1_kneaddata_paired	Campylobacterota	8700	P	2432	0	2432	0.00015
ERR675655_1_kneaddata_paired	Cyanobacteria	9876	P	2376	13	2389	0.00015
ERR675655_1_kneaddata_paired	Spirochaetota	32587	P	146	0	146	0.00001
ERR675655_1_kneaddata_paired	Firmicutes_B	17289	P	125	2	127	0.00001
ERR675655_1_kneaddata_paired	Firmicutes_I	18140	P	121	0	121	0.00001
ERR675655_1_kneaddata_paired	Firmicutes_C	17613	P	117	0	117	0.00001
ERR675655_1_kneaddata_paired	Deferribacterota	10822	P	41	0	41	0.00000
ERR675655_1_kneaddata_paired	Elusimicrobiota	11888	P	26	0	26	0.00000
ERR675655_1_kneaddata_paired	Thermotogota	33086	P	3	0	3	0.00000
ERR675656_1_kneaddata_paired	Firmicutes_A	14608	P	13740942	45763	13786705	0.70223
ERR675656_1_kneaddata_paired	Bacteroidota	4587	P	5046572	32282	5078854	0.25869
ERR675656_1_kneaddata_paired	Campylobacterota	8700	P	310947	18	310965	0.01584
ERR675656_1_kneaddata_paired	Desulfobacterota_A	11509	P	296218	3059	299277	0.01524
ERR675656_1_kneaddata_paired	Firmicutes	12188	P	77574	880	78454	0.00400
ERR675656_1_kneaddata_paired	Cyanobacteria	9876	P	49587	236	49823	0.00254
ERR675656_1_kneaddata_paired	Actinobacteriota	615	P	12328	32	12360	0.00063
ERR675656_1_kneaddata_paired	Proteobacteria	22518	P	6259	27	6286	0.00032
ERR675656_1_kneaddata_paired	Deferribacterota	10822	P	5041	10	5051	0.00026
ERR675656_1_kneaddata_paired	Verrucomicrobiota	33333	P	2996	133	3129	0.00016
ERR675656_1_kneaddata_paired	Firmicutes_B	17289	P	838	24	862	0.00004
ERR675656_1_kneaddata_paired	Spirochaetota	32587	P	593	0	593	0.00003
ERR675656_1_kneaddata_paired	Firmicutes_C	17613	P	224	0	224	0.00001
ERR675656_1_kneaddata_paired	Firmicutes_I	18140	P	184	0	184	0.00001
ERR675656_1_kneaddata_paired	Thermotogota	33086	P	47	0	47	0.00000
ERR675656_1_kneaddata_paired	Elusimicrobiota	11888	P	37	0	37	0.00000
ERR675657_1_kneaddata_paired	Bacteroidota	4587	P	11704267	39367	11743634	0.67399
ERR675657_1_kneaddata_paired	Firmicutes_A	14608	P	5281956	15601	5297557	0.30404
ERR675657_1_kneaddata_paired	Actinobacteriota	615	P	146080	220	146300	0.00840
ERR675657_1_kneaddata_paired	Desulfobacterota_A	11509	P	106947	178	107125	0.00615
ERR675657_1_kneaddata_paired	Firmicutes	12188	P	60258	778	61036	0.00350
ERR675657_1_kneaddata_paired	Proteobacteria	22518	P	37605	29	37634	0.00216
ERR675657_1_kneaddata_paired	Verrucomicrobiota	33333	P	23451	673	24124	0.00138
ERR675657_1_kneaddata_paired	Campylobacterota	8700	P	3845	0	3845	0.00022
ERR675657_1_kneaddata_paired	Cyanobacteria	9876	P	2187	15	2202	0.00013
ERR675657_1_kneaddata_paired	Spirochaetota	32587	P	186	0	186	0.00001
ERR675657_1_kneaddata_paired	Firmicutes_I	18140	P	162	0	162	0.00001
ERR675657_1_kneaddata_paired	Firmicutes_B	17289	P	106	1	107	0.00001
ERR675657_1_kneaddata_paired	Firmicutes_C	17613	P	93	0	93	0.00001
ERR675657_1_kneaddata_paired	Deferribacterota	10822	P	35	0	35	0.00000
ERR675657_1_kneaddata_paired	Elusimicrobiota	11888	P	16	0	16	0.00000
ERR675657_1_kneaddata_paired	Thermotogota	33086	P	2	0	2	0.00000
ERR675658_1_kneaddata_paired	Bacteroidota	4587	P	11648572	41255	11689827	0.66826
ERR675658_1_kneaddata_paired	Firmicutes_A	14608	P	5373031	15487	5388518	0.30804
ERR675658_1_kneaddata_paired	Actinobacteriota	615	P	174415	249	174664	0.00998
ERR675658_1_kneaddata_paired	Desulfobacterota_A	11509	P	132112	196	132308	0.00756
ERR675658_1_kneaddata_paired	Firmicutes	12188	P	63177	1485	64662	0.00370
ERR675658_1_kneaddata_paired	Proteobacteria	22518	P	30968	28	30996	0.00177
ERR675658_1_kneaddata_paired	Verrucomicrobiota	33333	P	5700	181	5881	0.00034
ERR675658_1_kneaddata_paired	Campylobacterota	8700	P	3289	0	3289	0.00019
ERR675658_1_kneaddata_paired	Cyanobacteria	9876	P	2033	11	2044	0.00012
ERR675658_1_kneaddata_paired	Spirochaetota	32587	P	236	0	236	0.00001
ERR675658_1_kneaddata_paired	Firmicutes_I	18140	P	192	0	192	0.00001
ERR675658_1_kneaddata_paired	Firmicutes_B	17289	P	120	2	122	0.00001
ERR675658_1_kneaddata_paired	Firmicutes_C	17613	P	117	0	117	0.00001
ERR675658_1_kneaddata_paired	Elusimicrobiota	11888	P	31	0	31	0.00000
ERR675658_1_kneaddata_paired	Deferribacterota	10822	P	24	0	24	0.00000
ERR675658_1_kneaddata_paired	Thermotogota	33086	P	4	0	4	0.00000
ERR675659_1_kneaddata_paired	Bacteroidota	4587	P	10056023	39266	10095289	0.63812
ERR675659_1_kneaddata_paired	Firmicutes_A	14608	P	5339133	18331	5357464	0.33864
ERR675659_1_kneaddata_paired	Desulfobacterota_A	11509	P	170099	333	170432	0.01077
ERR675659_1_kneaddata_paired	Actinobacteriota	615	P	133582	337	133919	0.00847
ERR675659_1_kneaddata_paired	Proteobacteria	22518	P	20090	19	20109	0.00127
ERR675659_1_kneaddata_paired	Verrucomicrobiota	33333	P	18771	698	19469	0.00123
ERR675659_1_kneaddata_paired	Firmicutes	12188	P	15273	162	15435	0.00098
ERR675659_1_kneaddata_paired	Campylobacterota	8700	P	5519	1	5520	0.00035
ERR675659_1_kneaddata_paired	Cyanobacteria	9876	P	1929	16	1945	0.00012
ERR675659_1_kneaddata_paired	Spirochaetota	32587	P	234	0	234	0.00001
ERR675659_1_kneaddata_paired	Firmicutes_B	17289	P	199	4	203	0.00001
ERR675659_1_kneaddata_paired	Firmicutes_C	17613	P	146	0	146	0.00001
ERR675659_1_kneaddata_paired	Firmicutes_I	18140	P	143	0	143	0.00001
ERR675659_1_kneaddata_paired	Deferribacterota	10822	P	50	0	50	0.00000
ERR675659_1_kneaddata_paired	Elusimicrobiota	11888	P	19	0	19	0.00000
ERR675659_1_kneaddata_paired	Thermotogota	33086	P	5	0	5	0.00000
ERR675660_1_kneaddata_paired	Bacteroidota	4587	P	11121086	33535	11154621	0.77733
ERR675660_1_kneaddata_paired	Firmicutes_A	14608	P	2085232	4718	2089950	0.14564
ERR675660_1_kneaddata_paired	Firmicutes	12188	P	555208	11485	566693	0.03949
ERR675660_1_kneaddata_paired	Actinobacteriota	615	P	358095	420	358515	0.02498
ERR675660_1_kneaddata_paired	Proteobacteria	22518	P	84027	36	84063	0.00586
ERR675660_1_kneaddata_paired	Desulfobacterota_A	11509	P	82798	115	82913	0.00578
ERR675660_1_kneaddata_paired	Campylobacterota	8700	P	10330	1	10331	0.00072
ERR675660_1_kneaddata_paired	Cyanobacteria	9876	P	1182	2	1184	0.00008
ERR675660_1_kneaddata_paired	Verrucomicrobiota	33333	P	1014	16	1030	0.00007
ERR675660_1_kneaddata_paired	Spirochaetota	32587	P	220	0	220	0.00002
ERR675660_1_kneaddata_paired	Firmicutes_I	18140	P	201	0	201	0.00001
ERR675660_1_kneaddata_paired	Firmicutes_C	17613	P	82	0	82	0.00001
ERR675660_1_kneaddata_paired	Deferribacterota	10822	P	77	0	77	0.00001
ERR675660_1_kneaddata_paired	Elusimicrobiota	11888	P	40	0	40	0.00000
ERR675660_1_kneaddata_paired	Firmicutes_B	17289	P	39	0	39	0.00000
ERR675660_1_kneaddata_paired	Thermotogota	33086	P	3	0	3	0.00000
ERR675661_1_kneaddata_paired	Bacteroidota	4587	P	9213458	36573	9250031	0.77784
ERR675661_1_kneaddata_paired	Firmicutes_A	14608	P	2175310	6831	2182141	0.18350
ERR675661_1_kneaddata_paired	Actinobacteriota	615	P	222986	430	223416	0.01879
ERR675661_1_kneaddata_paired	Firmicutes	12188	P	123666	521	124187	0.01044
ERR675661_1_kneaddata_paired	Desulfobacterota_A	11509	P	62677	35	62712	0.00527
ERR675661_1_kneaddata_paired	Proteobacteria	22518	P	43405	26	43431	0.00365
ERR675661_1_kneaddata_paired	Campylobacterota	8700	P	3977	1	3978	0.00033
ERR675661_1_kneaddata_paired	Cyanobacteria	9876	P	1116	4	1120	0.00009
ERR675661_1_kneaddata_paired	Verrucomicrobiota	33333	P	370	6	376	0.00003
ERR675661_1_kneaddata_paired	Firmicutes_I	18140	P	205	0	205	0.00002
ERR675661_1_kneaddata_paired	Spirochaetota	32587	P	138	0	138	0.00001
ERR675661_1_kneaddata_paired	Firmicutes_B	17289	P	53	0	53	0.00000
ERR675661_1_kneaddata_paired	Firmicutes_C	17613	P	51	0	51	0.00000
ERR675661_1_kneaddata_paired	Elusimicrobiota	11888	P	36	0	36	0.00000
ERR675661_1_kneaddata_paired	Deferribacterota	10822	P	10	0	10	0.00000
ERR675661_1_kneaddata_paired	Thermotogota	33086	P	2	0	2	0.00000
ERR675662_1_kneaddata_paired	Bacteroidota	4587	P	13178973	65313	13244286	0.72514
ERR675662_1_kneaddata_paired	Firmicutes_A	14608	P	4199248	17000	4216248	0.23085
ERR675662_1_kneaddata_paired	Actinobacteriota	615	P	370361	1045	371406	0.02034
ERR675662_1_kneaddata_paired	Firmicutes	12188	P	260834	2784	263618	0.01443
ERR675662_1_kneaddata_paired	Desulfobacterota_A	11509	P	106491	166	106657	0.00584
ERR675662_1_kneaddata_paired	Proteobacteria	22518	P	49834	46	49880	0.00273
ERR675662_1_kneaddata_paired	Campylobacterota	8700	P	8381	3	8384	0.00046
ERR675662_1_kneaddata_paired	Cyanobacteria	9876	P	1945	13	1958	0.00011
ERR675662_1_kneaddata_paired	Verrucomicrobiota	33333	P	1035	36	1071	0.00006
ERR675662_1_kneaddata_paired	Spirochaetota	32587	P	266	0	266	0.00001
ERR675662_1_kneaddata_paired	Firmicutes_I	18140	P	211	0	211	0.00001
ERR675662_1_kneaddata_paired	Deferribacterota	10822	P	149	0	149	0.00001
ERR675662_1_kneaddata_paired	Firmicutes_B	17289	P	104	2	106	0.00001
ERR675662_1_kneaddata_paired	Firmicutes_C	17613	P	83	0	83	0.00000
ERR675662_1_kneaddata_paired	Elusimicrobiota	11888	P	47	0	47	0.00000
ERR675662_1_kneaddata_paired	Thermotogota	33086	P	6	0	6	0.00000
ERR675663_1_kneaddata_paired	Bacteroidota	4587	P	8638026	39415	8677441	0.56626
ERR675663_1_kneaddata_paired	Firmicutes_A	14608	P	5950675	16414	5967089	0.38939
ERR675663_1_kneaddata_paired	Actinobacteriota	615	P	266325	825	267150	0.01743
ERR675663_1_kneaddata_paired	Desulfobacterota_A	11509	P	205689	414	206103	0.01345
ERR675663_1_kneaddata_paired	Firmicutes	12188	P	154404	4503	158907	0.01037
ERR675663_1_kneaddata_paired	Proteobacteria	22518	P	36732	24	36756	0.00240
ERR675663_1_kneaddata_paired	Campylobacterota	8700	P	5094	1	5095	0.00033
ERR675663_1_kneaddata_paired	Verrucomicrobiota	33333	P	3579	44	3623	0.00024
ERR675663_1_kneaddata_paired	Cyanobacteria	9876	P	1049	9	1058	0.00007
ERR675663_1_kneaddata_paired	Spirochaetota	32587	P	266	0	266	0.00002
ERR675663_1_kneaddata_paired	Firmicutes_I	18140	P	192	0	192	0.00001
ERR675663_1_kneaddata_paired	Firmicutes_B	17289	P	132	2	134	0.00001
ERR675663_1_kneaddata_paired	Firmicutes_C	17613	P	128	0	128	0.00001
ERR675663_1_kneaddata_paired	Deferribacterota	10822	P	84	0	84	0.00001
ERR675663_1_kneaddata_paired	Elusimicrobiota	11888	P	38	0	38	0.00000
ERR675663_1_kneaddata_paired	Thermotogota	33086	P	4	0	4	0.00000
ERR675664_1_kneaddata_paired	Firmicutes_A	14608	P	6008062	23095	6031157	0.63633
ERR675664_1_kneaddata_paired	Bacteroidota	4587	P	3040633	25549	3066182	0.32350
ERR675664_1_kneaddata_paired	Desulfobacterota_A	11509	P	163175	1422	164597	0.01737
ERR675664_1_kneaddata_paired	Firmicutes	12188	P	106895	2184	109079	0.01151
ERR675664_1_kneaddata_paired	Campylobacterota	8700	P	62486	21	62507	0.00660
ERR675664_1_kneaddata_paired	Actinobacteriota	615	P	27880	236	28116	0.00297
ERR675664_1_kneaddata_paired	Proteobacteria	22518	P	6982	11	6993	0.00074
ERR675664_1_kneaddata_paired	Verrucomicrobiota	33333	P	3461	134	3595	0.00038
ERR675664_1_kneaddata_paired	Deferribacterota	10822	P	3208	7	3215	0.00034
ERR675664_1_kneaddata_paired	Cyanobacteria	9876	P	1271	17	1288	0.00014
ERR675664_1_kneaddata_paired	Firmicutes_B	17289	P	657	16	673	0.00007
ERR675664_1_kneaddata_paired	Firmicutes_C	17613	P	218	0	218	0.00002
ERR675664_1_kneaddata_paired	Spirochaetota	32587	P	201	0	201	0.00002
ERR675664_1_kneaddata_paired	Firmicutes_I	18140	P	149	0	149	0.00002
ERR675664_1_kneaddata_paired	Elusimicrobiota	11888	P	24	0	24	0.00000
ERR675664_1_kneaddata_paired	Thermotogota	33086	P	9	0	9	0.00000
ERR675665_1_kneaddata_paired	Firmicutes_A	14608	P	7624061	17507	7641568	0.70419
ERR675665_1_kneaddata_paired	Bacteroidota	4587	P	2604185	9831	2614016	0.24089
ERR675665_1_kneaddata_paired	Verrucomicrobiota	33333	P	233784	7448	241232	0.02223
ERR675665_1_kneaddata_paired	Desulfobacterota_A	11509	P	121615	401	122016	0.01124
ERR675665_1_kneaddata_paired	Actinobacteriota	615	P	100670	442	101112	0.00932
ERR675665_1_kneaddata_paired	Firmicutes	12188	P	90915	5584	96499	0.00889
ERR675665_1_kneaddata_paired	Proteobacteria	22518	P	28707	18	28725	0.00265
ERR675665_1_kneaddata_paired	Campylobacterota	8700	P	5053	1	5054	0.00047
ERR675665_1_kneaddata_paired	Cyanobacteria	9876	P	514	2	516	0.00005
ERR675665_1_kneaddata_paired	Firmicutes_B	17289	P	247	4	251	0.00002
ERR675665_1_kneaddata_paired	Firmicutes_C	17613	P	196	0	196	0.00002
ERR675665_1_kneaddata_paired	Firmicutes_I	18140	P	157	0	157	0.00001
ERR675665_1_kneaddata_paired	Spirochaetota	32587	P	102	0	102	0.00001
ERR675665_1_kneaddata_paired	Deferribacterota	10822	P	48	0	48	0.00000
ERR675665_1_kneaddata_paired	Elusimicrobiota	11888	P	32	0	32	0.00000
ERR675665_1_kneaddata_paired	Thermotogota	33086	P	3	0	3	0.00000
ERR675666_1_kneaddata_paired	Firmicutes_A	14608	P	11391826	29388	11421214	0.78130
ERR675666_1_kneaddata_paired	Bacteroidota	4587	P	2299283	14878	2314161	0.15831
ERR675666_1_kneaddata_paired	Desulfobacterota_A	11509	P	436005	2660	438665	0.03001
ERR675666_1_kneaddata_paired	Firmicutes	12188	P	248709	13137	261846	0.01791
ERR675666_1_kneaddata_paired	Actinobacteriota	615	P	92011	757	92768	0.00635
ERR675666_1_kneaddata_paired	Campylobacterota	8700	P	51787	18	51805	0.00354
ERR675666_1_kneaddata_paired	Proteobacteria	22518	P	28316	28	28344	0.00194
ERR675666_1_kneaddata_paired	Verrucomicrobiota	33333	P	5206	187	5393	0.00037
ERR675666_1_kneaddata_paired	Cyanobacteria	9876	P	1309	13	1322	0.00009
ERR675666_1_kneaddata_paired	Deferribacterota	10822	P	1127	2	1129	0.00008
ERR675666_1_kneaddata_paired	Firmicutes_B	17289	P	771	18	789	0.00005
ERR675666_1_kneaddata_paired	Spirochaetota	32587	P	296	0	296	0.00002
ERR675666_1_kneaddata_paired	Firmicutes_C	17613	P	270	0	270	0.00002
ERR675666_1_kneaddata_paired	Firmicutes_I	18140	P	176	0	176	0.00001
ERR675666_1_kneaddata_paired	Elusimicrobiota	11888	P	49	0	49	0.00000
ERR675666_1_kneaddata_paired	Thermotogota	33086	P	5	0	5	0.00000
ERR675667_1_kneaddata_paired	Firmicutes_A	14608	P	10402648	34641	10437289	0.79390
ERR675667_1_kneaddata_paired	Bacteroidota	4587	P	1934248	13708	1947956	0.14817
ERR675667_1_kneaddata_paired	Desulfobacterota_A	11509	P	344288	1971	346259	0.02634
ERR675667_1_kneaddata_paired	Firmicutes	12188	P	250718	5927	256645	0.01952
ERR675667_1_kneaddata_paired	Campylobacterota	8700	P	80704	10	80714	0.00614
ERR675667_1_kneaddata_paired	Actinobacteriota	615	P	59678	415	60093	0.00457
ERR675667_1_kneaddata_paired	Proteobacteria	22518	P	8370	12	8382	0.00064
ERR675667_1_kneaddata_paired	Verrucomicrobiota	33333	P	3889	132	4021	0.00031
ERR675667_1_kneaddata_paired	Deferribacterota	10822	P	2348	4	2352	0.00018
ERR675667_1_kneaddata_paired	Firmicutes_B	17289	P	1109	23	1132	0.00009
ERR675667_1_kneaddata_paired	Cyanobacteria	9876	P	1094	8	1102	0.00008
ERR675667_1_kneaddata_paired	Firmicutes_C	17613	P	324	0	324	0.00002
ERR675667_1_kneaddata_paired	Spirochaetota	32587	P	262	0	262	0.00002
ERR675667_1_kneaddata_paired	Firmicutes_I	18140	P	208	0	208	0.00002
ERR675667_1_kneaddata_paired	Thermotogota	33086	P	23	0	23	0.00000
ERR675667_1_kneaddata_paired	Elusimicrobiota	11888	P	19	0	19	0.00000
ERR675668_1_kneaddata_paired	Bacteroidota	4587	P	21574766	128472	21703238	0.76785
ERR675668_1_kneaddata_paired	Firmicutes_A	14608	P	5463087	60307	5523394	0.19541
ERR675668_1_kneaddata_paired	Firmicutes	12188	P	398006	35478	433484	0.01534
ERR675668_1_kneaddata_paired	Actinobacteriota	615	P	274727	752	275479	0.00975
ERR675668_1_kneaddata_paired	Proteobacteria	22518	P	186959	4190	191149	0.00676
ERR675668_1_kneaddata_paired	Cyanobacteria	9876	P	80098	2384	82482	0.00292
ERR675668_1_kneaddata_paired	Desulfobacterota_A	11509	P	40633	263	40896	0.00145
ERR675668_1_kneaddata_paired	Deferribacterota	10822	P	12951	69	13020	0.00046
ERR675668_1_kneaddata_paired	Verrucomicrobiota	33333	P	555	42	597	0.00002
ERR675668_1_kneaddata_paired	Campylobacterota	8700	P	394	0	394	0.00001
ERR675668_1_kneaddata_paired	Firmicutes_B	17289	P	311	16	327	0.00001
ERR675668_1_kneaddata_paired	Spirochaetota	32587	P	244	0	244	0.00001
ERR675668_1_kneaddata_paired	Firmicutes_I	18140	P	170	0	170	0.00001
ERR675668_1_kneaddata_paired	Firmicutes_C	17613	P	161	0	161	0.00001
ERR675668_1_kneaddata_paired	Elusimicrobiota	11888	P	18	0	18	0.00000
ERR675668_1_kneaddata_paired	Thermotogota	33086	P	4	0	4	0.00000
ERR675669_1_kneaddata_paired	Bacteroidota	4587	P	25138681	150455	25289136	0.79501
ERR675669_1_kneaddata_paired	Firmicutes_A	14608	P	4480648	54571	4535219	0.14257
ERR675669_1_kneaddata_paired	Firmicutes	12188	P	1363383	80621	1444004	0.04539
ERR675669_1_kneaddata_paired	Actinobacteriota	615	P	243765	432	244197	0.00768
ERR675669_1_kneaddata_paired	Proteobacteria	22518	P	210230	5222	215452	0.00677
ERR675669_1_kneaddata_paired	Desulfobacterota_A	11509	P	31622	248	31870	0.00100
ERR675669_1_kneaddata_paired	Cyanobacteria	9876	P	24394	975	25369	0.00080
ERR675669_1_kneaddata_paired	Deferribacterota	10822	P	22001	110	22111	0.00070
ERR675669_1_kneaddata_paired	Verrucomicrobiota	33333	P	918	70	988	0.00003
ERR675669_1_kneaddata_paired	Firmicutes_B	17289	P	389	19	408	0.00001
ERR675669_1_kneaddata_paired	Campylobacterota	8700	P	388	0	388	0.00001
ERR675669_1_kneaddata_paired	Spirochaetota	32587	P	327	0	327	0.00001
ERR675669_1_kneaddata_paired	Firmicutes_I	18140	P	173	0	173	0.00001
ERR675669_1_kneaddata_paired	Firmicutes_C	17613	P	122	0	122	0.00000
ERR675669_1_kneaddata_paired	Elusimicrobiota	11888	P	20	0	20	0.00000
ERR675669_1_kneaddata_paired	Thermotogota	33086	P	12	0	12	0.00000
ERR675670_1_kneaddata_paired	Bacteroidota	4587	P	25583143	110172	25693315	0.75620
ERR675670_1_kneaddata_paired	Firmicutes_A	14608	P	5573922	29213	5603135	0.16491
ERR675670_1_kneaddata_paired	Firmicutes	12188	P	1911578	83550	1995128	0.05872
ERR675670_1_kneaddata_paired	Actinobacteriota	615	P	471977	851	472828	0.01392
ERR675670_1_kneaddata_paired	Cyanobacteria	9876	P	86783	355	87138	0.00256
ERR675670_1_kneaddata_paired	Desulfobacterota_A	11509	P	76324	164	76488	0.00225
ERR675670_1_kneaddata_paired	Campylobacterota	8700	P	40845	1	40846	0.00120
ERR675670_1_kneaddata_paired	Proteobacteria	22518	P	4783	27	4810	0.00014
ERR675670_1_kneaddata_paired	Verrucomicrobiota	33333	P	1753	77	1830	0.00005
ERR675670_1_kneaddata_paired	Spirochaetota	32587	P	454	0	454	0.00001
ERR675670_1_kneaddata_paired	Deferribacterota	10822	P	404	0	404	0.00001
ERR675670_1_kneaddata_paired	Firmicutes_I	18140	P	357	0	357	0.00001
ERR675670_1_kneaddata_paired	Firmicutes_B	17289	P	249	7	256	0.00001
ERR675670_1_kneaddata_paired	Firmicutes_C	17613	P	46	0	46	0.00000
ERR675670_1_kneaddata_paired	Elusimicrobiota	11888	P	17	0	17	0.00000
ERR675670_1_kneaddata_paired	Thermotogota	33086	P	16	0	16	0.00000
ERR675671_1_kneaddata_paired	Bacteroidota	4587	P	14244501	59530	14304031	0.56477
ERR675671_1_kneaddata_paired	Firmicutes_A	14608	P	9232827	40893	9273720	0.36616
ERR675671_1_kneaddata_paired	Firmicutes	12188	P	954244	41039	995283	0.03930
ERR675671_1_kneaddata_paired	Actinobacteriota	615	P	387047	876	387923	0.01532
ERR675671_1_kneaddata_paired	Desulfobacterota_A	11509	P	142076	274	142350	0.00562
ERR675671_1_kneaddata_paired	Campylobacterota	8700	P	129059	3	129062	0.00510
ERR675671_1_kneaddata_paired	Cyanobacteria	9876	P	88071	405	88476	0.00349
ERR675671_1_kneaddata_paired	Proteobacteria	22518	P	3213	18	3231	0.00013
ERR675671_1_kneaddata_paired	Verrucomicrobiota	33333	P	1203	46	1249	0.00005
ERR675671_1_kneaddata_paired	Spirochaetota	32587	P	654	0	654	0.00003
ERR675671_1_kneaddata_paired	Deferribacterota	10822	P	372	0	372	0.00001
ERR675671_1_kneaddata_paired	Firmicutes_B	17289	P	306	8	314	0.00001
ERR675671_1_kneaddata_paired	Firmicutes_I	18140	P	185	0	185	0.00001
ERR675671_1_kneaddata_paired	Firmicutes_C	17613	P	90	0	90	0.00000
ERR675671_1_kneaddata_paired	Elusimicrobiota	11888	P	27	0	27	0.00000
ERR675671_1_kneaddata_paired	Thermotogota	33086	P	17	0	17	0.00000
ERR675672_1_kneaddata_paired	Bacteroidota	4587	P	24477632	92351	24569983	0.84204
ERR675672_1_kneaddata_paired	Firmicutes_A	14608	P	2446558	14387	2460945	0.08434
ERR675672_1_kneaddata_paired	Firmicutes	12188	P	1506518	65864	1572382	0.05389
ERR675672_1_kneaddata_paired	Actinobacteriota	615	P	390651	526	391177	0.01341
ERR675672_1_kneaddata_paired	Cyanobacteria	9876	P	108765	357	109122	0.00374
ERR675672_1_kneaddata_paired	Campylobacterota	8700	P	42744	1	42745	0.00146
ERR675672_1_kneaddata_paired	Desulfobacterota_A	11509	P	25951	62	26013	0.00089
ERR675672_1_kneaddata_paired	Proteobacteria	22518	P	4111	18	4129	0.00014
ERR675672_1_kneaddata_paired	Verrucomicrobiota	33333	P	1515	59	1574	0.00005
ERR675672_1_kneaddata_paired	Spirochaetota	32587	P	311	0	311	0.00001
ERR675672_1_kneaddata_paired	Firmicutes_I	18140	P	245	0	245	0.00001
ERR675672_1_kneaddata_paired	Deferribacterota	10822	P	231	0	231	0.00001
ERR675672_1_kneaddata_paired	Firmicutes_B	17289	P	105	2	107	0.00000
ERR675672_1_kneaddata_paired	Firmicutes_C	17613	P	47	0	47	0.00000
ERR675672_1_kneaddata_paired	Elusimicrobiota	11888	P	35	0	35	0.00000
ERR675672_1_kneaddata_paired	Thermotogota	33086	P	7	0	7	0.00000
ERR675673_1_kneaddata_paired	Bacteroidota	4587	P	20036646	63653	20100299	0.80971
ERR675673_1_kneaddata_paired	Firmicutes_A	14608	P	2239805	11409	2251214	0.09069
ERR675673_1_kneaddata_paired	Firmicutes	12188	P	1628842	68216	1697058	0.06836
ERR675673_1_kneaddata_paired	Actinobacteriota	615	P	635451	717	636168	0.02563
ERR675673_1_kneaddata_paired	Desulfobacterota_A	11509	P	52443	84	52527	0.00212
ERR675673_1_kneaddata_paired	Campylobacterota	8700	P	44555	1	44556	0.00179
ERR675673_1_kneaddata_paired	Cyanobacteria	9876	P	34245	109	34354	0.00138
ERR675673_1_kneaddata_paired	Proteobacteria	22518	P	3834	13	3847	0.00016
ERR675673_1_kneaddata_paired	Verrucomicrobiota	33333	P	3005	100	3105	0.00013
ERR675673_1_kneaddata_paired	Spirochaetota	32587	P	346	0	346	0.00001
ERR675673_1_kneaddata_paired	Deferribacterota	10822	P	210	0	210	0.00001
ERR675673_1_kneaddata_paired	Firmicutes_I	18140	P	170	0	170	0.00001
ERR675673_1_kneaddata_paired	Firmicutes_B	17289	P	108	2	110	0.00000
ERR675673_1_kneaddata_paired	Elusimicrobiota	11888	P	39	0	39	0.00000
ERR675673_1_kneaddata_paired	Firmicutes_C	17613	P	36	0	36	0.00000
ERR675673_1_kneaddata_paired	Thermotogota	33086	P	9	0	9	0.00000
ERR675674_1_kneaddata_paired	Bacteroidota	4587	P	22340017	60975	22400992	0.87567
ERR675674_1_kneaddata_paired	Firmicutes_A	14608	P	1219843	8423	1228266	0.04801
ERR675674_1_kneaddata_paired	Firmicutes	12188	P	1210186	62565	1272751	0.04975
ERR675674_1_kneaddata_paired	Actinobacteriota	615	P	605958	637	606595	0.02371
ERR675674_1_kneaddata_paired	Campylobacterota	8700	P	24964	0	24964	0.00098
ERR675674_1_kneaddata_paired	Cyanobacteria	9876	P	23274	96	23370	0.00091
ERR675674_1_kneaddata_paired	Desulfobacterota_A	11509	P	18396	40	18436	0.00072
ERR675674_1_kneaddata_paired	Proteobacteria	22518	P	3978	13	3991	0.00016
ERR675674_1_kneaddata_paired	Verrucomicrobiota	33333	P	1532	57	1589	0.00006
ERR675674_1_kneaddata_paired	Spirochaetota	32587	P	238	0	238	0.00001
ERR675674_1_kneaddata_paired	Firmicutes_I	18140	P	159	0	159	0.00001
ERR675674_1_kneaddata_paired	Deferribacterota	10822	P	148	0	148	0.00001
ERR675674_1_kneaddata_paired	Firmicutes_B	17289	P	58	1	59	0.00000
ERR675674_1_kneaddata_paired	Firmicutes_C	17613	P	28	0	28	0.00000
ERR675674_1_kneaddata_paired	Elusimicrobiota	11888	P	27	0	27	0.00000
ERR675674_1_kneaddata_paired	Thermotogota	33086	P	1	0	1	0.00000
ERR675675_1_kneaddata_paired	Bacteroidota	4587	P	15760062	102803	15862865	0.77950
ERR675675_1_kneaddata_paired	Firmicutes_A	14608	P	3809667	22414	3832081	0.18831
ERR675675_1_kneaddata_paired	Firmicutes	12188	P	489275	5455	494730	0.02431
ERR675675_1_kneaddata_paired	Campylobacterota	8700	P	71475	2	71477	0.00351
ERR675675_1_kneaddata_paired	Cyanobacteria	9876	P	45612	204	45816	0.00225
ERR675675_1_kneaddata_paired	Actinobacteriota	615	P	30573	86	30659	0.00151
ERR675675_1_kneaddata_paired	Desulfobacterota_A	11509	P	9071	39	9110	0.00045
ERR675675_1_kneaddata_paired	Proteobacteria	22518	P	2629	17	2646	0.00013
ERR675675_1_kneaddata_paired	Firmicutes_B	17289	P	204	5	209	0.00001
ERR675675_1_kneaddata_paired	Verrucomicrobiota	33333	P	183	6	189	0.00001
ERR675675_1_kneaddata_paired	Deferribacterota	10822	P	170	0	170	0.00001
ERR675675_1_kneaddata_paired	Spirochaetota	32587	P	97	0	97	0.00000
ERR675675_1_kneaddata_paired	Firmicutes_I	18140	P	87	0	87	0.00000
ERR675675_1_kneaddata_paired	Firmicutes_C	17613	P	36	0	36	0.00000
ERR675675_1_kneaddata_paired	Elusimicrobiota	11888	P	3	0	3	0.00000
ERR675675_1_kneaddata_paired	Thermotogota	33086	P	3	0	3	0.00000
ERR675676_1_kneaddata_paired	Bacteroidota	4587	P	19424575	100507	19525082	0.84070
ERR675676_1_kneaddata_paired	Firmicutes_A	14608	P	3212499	20433	3232932	0.13920
ERR675676_1_kneaddata_paired	Firmicutes	12188	P	329324	3114	332438	0.01431
ERR675676_1_kneaddata_paired	Cyanobacteria	9876	P	51374	236	51610	0.00222
ERR675676_1_kneaddata_paired	Actinobacteriota	615	P	40627	112	40739	0.00175
ERR675676_1_kneaddata_paired	Campylobacterota	8700	P	17129	0	17129	0.00074
ERR675676_1_kneaddata_paired	Desulfobacterota_A	11509	P	14300	67	14367	0.00062
ERR675676_1_kneaddata_paired	Proteobacteria	22518	P	9400	38	9438	0.00041
ERR675676_1_kneaddata_paired	Firmicutes_B	17289	P	281	8	289	0.00001
ERR675676_1_kneaddata_paired	Spirochaetota	32587	P	261	0	261	0.00001
ERR675676_1_kneaddata_paired	Verrucomicrobiota	33333	P	205	4	209	0.00001
ERR675676_1_kneaddata_paired	Deferribacterota	10822	P	160	0	160	0.00001
ERR675676_1_kneaddata_paired	Firmicutes_I	18140	P	146	0	146	0.00001
ERR675676_1_kneaddata_paired	Firmicutes_C	17613	P	47	0	47	0.00000
ERR675676_1_kneaddata_paired	Elusimicrobiota	11888	P	11	0	11	0.00000
ERR675676_1_kneaddata_paired	Thermotogota	33086	P	10	0	10	0.00000
ERR675677_1_kneaddata_paired	Bacteroidota	4587	P	18185549	94255	18279804	0.89161
ERR675677_1_kneaddata_paired	Firmicutes_A	14608	P	1849831	16605	1866436	0.09104
ERR675677_1_kneaddata_paired	Firmicutes	12188	P	262913	2444	265357	0.01294
ERR675677_1_kneaddata_paired	Campylobacterota	8700	P	32177	1	32178	0.00157
ERR675677_1_kneaddata_paired	Actinobacteriota	615	P	29496	93	29589	0.00144
ERR675677_1_kneaddata_paired	Cyanobacteria	9876	P	22345	162	22507	0.00110
ERR675677_1_kneaddata_paired	Desulfobacterota_A	11509	P	2701	34	2735	0.00013
ERR675677_1_kneaddata_paired	Proteobacteria	22518	P	2597	14	2611	0.00013
ERR675677_1_kneaddata_paired	Spirochaetota	32587	P	200	0	200	0.00001
ERR675677_1_kneaddata_paired	Firmicutes_B	17289	P	169	5	174	0.00001
ERR675677_1_kneaddata_paired	Verrucomicrobiota	33333	P	130	4	134	0.00001
ERR675677_1_kneaddata_paired	Deferribacterota	10822	P	117	0	117	0.00001
ERR675677_1_kneaddata_paired	Firmicutes_I	18140	P	76	0	76	0.00000
ERR675677_1_kneaddata_paired	Firmicutes_C	17613	P	21	0	21	0.00000
ERR675677_1_kneaddata_paired	Elusimicrobiota	11888	P	7	0	7	0.00000
ERR675677_1_kneaddata_paired	Thermotogota	33086	P	4	0	4	0.00000
ERR675678_1_kneaddata_paired	Bacteroidota	4587	P	19091559	104829	19196388	0.82371
ERR675678_1_kneaddata_paired	Firmicutes_A	14608	P	2917302	21143	2938445	0.12609
ERR675678_1_kneaddata_paired	Firmicutes	12188	P	890451	8112	898563	0.03856
ERR675678_1_kneaddata_paired	Actinobacteriota	615	P	184163	544	184707	0.00793
ERR675678_1_kneaddata_paired	Cyanobacteria	9876	P	38408	213	38621	0.00166
ERR675678_1_kneaddata_paired	Campylobacterota	8700	P	26645	0	26645	0.00114
ERR675678_1_kneaddata_paired	Desulfobacterota_A	11509	P	17542	51	17593	0.00075
ERR675678_1_kneaddata_paired	Proteobacteria	22518	P	3010	19	3029	0.00013
ERR675678_1_kneaddata_paired	Spirochaetota	32587	P	256	0	256	0.00001
ERR675678_1_kneaddata_paired	Deferribacterota	10822	P	185	0	185	0.00001
ERR675678_1_kneaddata_paired	Firmicutes_B	17289	P	163	5	168	0.00001
ERR675678_1_kneaddata_paired	Verrucomicrobiota	33333	P	151	5	156	0.00001
ERR675678_1_kneaddata_paired	Firmicutes_I	18140	P	109	0	109	0.00000
ERR675678_1_kneaddata_paired	Firmicutes_C	17613	P	42	0	42	0.00000
ERR675678_1_kneaddata_paired	Elusimicrobiota	11888	P	8	0	8	0.00000
ERR675678_1_kneaddata_paired	Thermotogota	33086	P	4	0	4	0.00000
ERR675679_1_kneaddata_paired	Firmicutes_A	14608	P	13483869	94887	13578756	0.53634
ERR675679_1_kneaddata_paired	Bacteroidota	4587	P	10949017	70059	11019076	0.43523
ERR675679_1_kneaddata_paired	Actinobacteriota	615	P	175729	396	176125	0.00696
ERR675679_1_kneaddata_paired	Firmicutes	12188	P	155733	12769	168502	0.00666
ERR675679_1_kneaddata_paired	Desulfobacterota_A	11509	P	152608	320	152928	0.00604
ERR675679_1_kneaddata_paired	Deferribacterota	10822	P	149311	621	149932	0.00592
ERR675679_1_kneaddata_paired	Proteobacteria	22518	P	53023	950	53973	0.00213
ERR675679_1_kneaddata_paired	Cyanobacteria	9876	P	15733	257	15990	0.00063
ERR675679_1_kneaddata_paired	Verrucomicrobiota	33333	P	760	46	806	0.00003
ERR675679_1_kneaddata_paired	Spirochaetota	32587	P	596	0	596	0.00002
ERR675679_1_kneaddata_paired	Firmicutes_B	17289	P	294	12	306	0.00001
ERR675679_1_kneaddata_paired	Firmicutes_I	18140	P	259	0	259	0.00001
ERR675679_1_kneaddata_paired	Campylobacterota	8700	P	210	0	210	0.00001
ERR675679_1_kneaddata_paired	Firmicutes_C	17613	P	156	0	156	0.00001
ERR675679_1_kneaddata_paired	Thermotogota	33086	P	16	0	16	0.00000
ERR675679_1_kneaddata_paired	Elusimicrobiota	11888	P	6	0	6	0.00000
ERR675680_1_kneaddata_paired	Firmicutes_A	14608	P	18406952	103461	18510413	0.71230
ERR675680_1_kneaddata_paired	Bacteroidota	4587	P	6641411	32120	6673531	0.25680
ERR675680_1_kneaddata_paired	Actinobacteriota	615	P	265184	951	266135	0.01024
ERR675680_1_kneaddata_paired	Firmicutes	12188	P	257922	5956	263878	0.01015
ERR675680_1_kneaddata_paired	Campylobacterota	8700	P	185128	7	185135	0.00712
ERR675680_1_kneaddata_paired	Desulfobacterota_A	11509	P	72241	285	72526	0.00279
ERR675680_1_kneaddata_paired	Cyanobacteria	9876	P	9792	123	9915	0.00038
ERR675680_1_kneaddata_paired	Proteobacteria	22518	P	2204	31	2235	0.00009
ERR675680_1_kneaddata_paired	Verrucomicrobiota	33333	P	1312	69	1381	0.00005
ERR675680_1_kneaddata_paired	Firmicutes_B	17289	P	464	16	480	0.00002
ERR675680_1_kneaddata_paired	Deferribacterota	10822	P	351	0	351	0.00001
ERR675680_1_kneaddata_paired	Spirochaetota	32587	P	322	0	322	0.00001
ERR675680_1_kneaddata_paired	Firmicutes_I	18140	P	290	0	290	0.00001
ERR675680_1_kneaddata_paired	Firmicutes_C	17613	P	157	0	157	0.00001
ERR675680_1_kneaddata_paired	Thermotogota	33086	P	10	0	10	0.00000
ERR675680_1_kneaddata_paired	Elusimicrobiota	11888	P	9	0	9	0.00000
ERR675681_1_kneaddata_paired	Bacteroidota	4587	P	12058983	74562	12133545	0.48611
ERR675681_1_kneaddata_paired	Firmicutes_A	14608	P	11962898	108100	12070998	0.48360
ERR675681_1_kneaddata_paired	Firmicutes	12188	P	252613	15403	268016	0.01074
ERR675681_1_kneaddata_paired	Actinobacteriota	615	P	227993	873	228866	0.00917
ERR675681_1_kneaddata_paired	Proteobacteria	22518	P	105969	2476	108445	0.00434
ERR675681_1_kneaddata_paired	Desulfobacterota_A	11509	P	83405	546	83951	0.00336
ERR675681_1_kneaddata_paired	Cyanobacteria	9876	P	31559	1542	33101	0.00133
ERR675681_1_kneaddata_paired	Deferribacterota	10822	P	31093	182	31275	0.00125
ERR675681_1_kneaddata_paired	Verrucomicrobiota	33333	P	572	47	619	0.00002
ERR675681_1_kneaddata_paired	Firmicutes_B	17289	P	566	33	599	0.00002
ERR675681_1_kneaddata_paired	Campylobacterota	8700	P	372	0	372	0.00001
ERR675681_1_kneaddata_paired	Spirochaetota	32587	P	367	0	367	0.00001
ERR675681_1_kneaddata_paired	Firmicutes_I	18140	P	205	0	205	0.00001
ERR675681_1_kneaddata_paired	Firmicutes_C	17613	P	183	0	183	0.00001
ERR675681_1_kneaddata_paired	Elusimicrobiota	11888	P	19	0	19	0.00000
ERR675681_1_kneaddata_paired	Thermotogota	33086	P	14	0	14	0.00000
ERR675682_1_kneaddata_paired	Bacteroidota	4587	P	26360152	172693	26532845	0.81799
ERR675682_1_kneaddata_paired	Firmicutes_A	14608	P	4478417	56867	4535284	0.13982
ERR675682_1_kneaddata_paired	Firmicutes	12188	P	644172	46023	690195	0.02128
ERR675682_1_kneaddata_paired	Actinobacteriota	615	P	300110	817	300927	0.00928
ERR675682_1_kneaddata_paired	Proteobacteria	22518	P	266629	6453	273082	0.00842
ERR675682_1_kneaddata_paired	Cyanobacteria	9876	P	66766	1588	68354	0.00211
ERR675682_1_kneaddata_paired	Desulfobacterota_A	11509	P	25223	252	25475	0.00079
ERR675682_1_kneaddata_paired	Deferribacterota	10822	P	8417	44	8461	0.00026
ERR675682_1_kneaddata_paired	Verrucomicrobiota	33333	P	614	48	662	0.00002
ERR675682_1_kneaddata_paired	Campylobacterota	8700	P	469	0	469	0.00001
ERR675682_1_kneaddata_paired	Firmicutes_B	17289	P	334	17	351	0.00001
ERR675682_1_kneaddata_paired	Spirochaetota	32587	P	245	0	245	0.00001
ERR675682_1_kneaddata_paired	Firmicutes_I	18140	P	204	0	204	0.00001
ERR675682_1_kneaddata_paired	Firmicutes_C	17613	P	191	0	191	0.00001
ERR675682_1_kneaddata_paired	Elusimicrobiota	11888	P	21	0	21	0.00000
ERR675682_1_kneaddata_paired	Thermotogota	33086	P	7	0	7	0.00000
ERR675683_1_kneaddata_paired	Bacteroidota	4587	P	23234059	154806	23388865	0.76183
ERR675683_1_kneaddata_paired	Firmicutes_A	14608	P	6318817	62495	6381312	0.20785
ERR675683_1_kneaddata_paired	Actinobacteriota	615	P	356216	556	356772	0.01162
ERR675683_1_kneaddata_paired	Firmicutes	12188	P	227406	16861	244267	0.00796
ERR675683_1_kneaddata_paired	Proteobacteria	22518	P	164952	3426	168378	0.00548
ERR675683_1_kneaddata_paired	Desulfobacterota_A	11509	P	123793	286	124079	0.00404
ERR675683_1_kneaddata_paired	Deferribacterota	10822	P	28254	123	28377	0.00092
ERR675683_1_kneaddata_paired	Cyanobacteria	9876	P	6949	347	7296	0.00024
ERR675683_1_kneaddata_paired	Spirochaetota	32587	P	394	0	394	0.00001
ERR675683_1_kneaddata_paired	Verrucomicrobiota	33333	P	332	20	352	0.00001
ERR675683_1_kneaddata_paired	Firmicutes_B	17289	P	304	13	317	0.00001
ERR675683_1_kneaddata_paired	Firmicutes_I	18140	P	218	0	218	0.00001
ERR675683_1_kneaddata_paired	Campylobacterota	8700	P	197	0	197	0.00001
ERR675683_1_kneaddata_paired	Firmicutes_C	17613	P	113	0	113	0.00000
ERR675683_1_kneaddata_paired	Thermotogota	33086	P	8	0	8	0.00000
ERR675683_1_kneaddata_paired	Elusimicrobiota	11888	P	5	0	5	0.00000
ERR675684_1_kneaddata_paired	Firmicutes_A	14608	P	15625058	100749	15725807	0.50880
ERR675684_1_kneaddata_paired	Bacteroidota	4587	P	14321689	118410	14440099	0.46720
ERR675684_1_kneaddata_paired	Firmicutes	12188	P	362399	3562	365961	0.01184
ERR675684_1_kneaddata_paired	Deferribacterota	10822	P	98862	407	99269	0.00321
ERR675684_1_kneaddata_paired	Proteobacteria	22518	P	85865	1717	87582	0.00283
ERR675684_1_kneaddata_paired	Cyanobacteria	9876	P	84053	737	84790	0.00274
ERR675684_1_kneaddata_paired	Desulfobacterota_A	11509	P	61095	466	61561	0.00199
ERR675684_1_kneaddata_paired	Actinobacteriota	615	P	39155	151	39306	0.00127
ERR675684_1_kneaddata_paired	Firmicutes_B	17289	P	1059	43	1102	0.00004
ERR675684_1_kneaddata_paired	Verrucomicrobiota	33333	P	718	38	756	0.00002
ERR675684_1_kneaddata_paired	Campylobacterota	8700	P	438	0	438	0.00001
ERR675684_1_kneaddata_paired	Spirochaetota	32587	P	435	0	435	0.00001
ERR675684_1_kneaddata_paired	Firmicutes_I	18140	P	268	0	268	0.00001
ERR675684_1_kneaddata_paired	Firmicutes_C	17613	P	211	0	211	0.00001
ERR675684_1_kneaddata_paired	Elusimicrobiota	11888	P	29	0	29	0.00000
ERR675684_1_kneaddata_paired	Thermotogota	33086	P	26	0	26	0.00000
ERR675685_1_kneaddata_paired	Firmicutes_A	14608	P	18068107	112461	18180568	0.59072
ERR675685_1_kneaddata_paired	Bacteroidota	4587	P	11389239	98687	11487926	0.37326
ERR675685_1_kneaddata_paired	Deferribacterota	10822	P	455006	1670	456676	0.01484
ERR675685_1_kneaddata_paired	Firmicutes	12188	P	298149	2289	300438	0.00976
ERR675685_1_kneaddata_paired	Desulfobacterota_A	11509	P	124397	641	125038	0.00406
ERR675685_1_kneaddata_paired	Cyanobacteria	9876	P	115703	750	116453	0.00378
ERR675685_1_kneaddata_paired	Actinobacteriota	615	P	59614	251	59865	0.00195
ERR675685_1_kneaddata_paired	Proteobacteria	22518	P	45567	686	46253	0.00150
ERR675685_1_kneaddata_paired	Firmicutes_B	17289	P	1086	39	1125	0.00004
ERR675685_1_kneaddata_paired	Verrucomicrobiota	33333	P	937	48	985	0.00003
ERR675685_1_kneaddata_paired	Spirochaetota	32587	P	645	1	646	0.00002
ERR675685_1_kneaddata_paired	Campylobacterota	8700	P	477	0	477	0.00002
ERR675685_1_kneaddata_paired	Firmicutes_C	17613	P	301	0	301	0.00001
ERR675685_1_kneaddata_paired	Firmicutes_I	18140	P	265	0	265	0.00001
ERR675685_1_kneaddata_paired	Thermotogota	33086	P	36	0	36	0.00000
ERR675685_1_kneaddata_paired	Elusimicrobiota	11888	P	21	0	21	0.00000
ERR675686_1_kneaddata_paired	Firmicutes_A	14608	P	16205369	102906	16308275	0.49251
ERR675686_1_kneaddata_paired	Bacteroidota	4587	P	14943601	95541	15039142	0.45418
ERR675686_1_kneaddata_paired	Firmicutes	12188	P	662716	46371	709087	0.02141
ERR675686_1_kneaddata_paired	Deferribacterota	10822	P	357514	1724	359238	0.01085
ERR675686_1_kneaddata_paired	Actinobacteriota	615	P	232930	532	233462	0.00705
ERR675686_1_kneaddata_paired	Desulfobacterota_A	11509	P	170541	653	171194	0.00517
ERR675686_1_kneaddata_paired	Proteobacteria	22518	P	146754	2766	149520	0.00452
ERR675686_1_kneaddata_paired	Cyanobacteria	9876	P	137010	1338	138348	0.00418
ERR675686_1_kneaddata_paired	Verrucomicrobiota	33333	P	1341	93	1434	0.00004
ERR675686_1_kneaddata_paired	Firmicutes_B	17289	P	1081	52	1133	0.00003
ERR675686_1_kneaddata_paired	Spirochaetota	32587	P	760	1	761	0.00002
ERR675686_1_kneaddata_paired	Campylobacterota	8700	P	553	0	553	0.00002
ERR675686_1_kneaddata_paired	Firmicutes_C	17613	P	279	0	279	0.00001
ERR675686_1_kneaddata_paired	Firmicutes_I	18140	P	266	0	266	0.00001
ERR675686_1_kneaddata_paired	Thermotogota	33086	P	31	0	31	0.00000
ERR675686_1_kneaddata_paired	Elusimicrobiota	11888	P	28	0	28	0.00000
ERR675687_1_kneaddata_paired	Firmicutes_A	14608	P	17751328	100978	17852306	0.54953
ERR675687_1_kneaddata_paired	Bacteroidota	4587	P	12480655	68224	12548879	0.38628
ERR675687_1_kneaddata_paired	Firmicutes	12188	P	869417	60414	929831	0.02862
ERR675687_1_kneaddata_paired	Actinobacteriota	615	P	419850	829	420679	0.01295
ERR675687_1_kneaddata_paired	Deferribacterota	10822	P	328483	1331	329814	0.01015
ERR675687_1_kneaddata_paired	Desulfobacterota_A	11509	P	243866	674	244540	0.00753
ERR675687_1_kneaddata_paired	Proteobacteria	22518	P	114068	2014	116082	0.00357
ERR675687_1_kneaddata_paired	Cyanobacteria	9876	P	39425	491	39916	0.00123
ERR675687_1_kneaddata_paired	Verrucomicrobiota	33333	P	1529	90	1619	0.00005
ERR675687_1_kneaddata_paired	Firmicutes_B	17289	P	876	35	911	0.00003
ERR675687_1_kneaddata_paired	Spirochaetota	32587	P	848	1	849	0.00003
ERR675687_1_kneaddata_paired	Campylobacterota	8700	P	513	0	513	0.00002
ERR675687_1_kneaddata_paired	Firmicutes_I	18140	P	277	0	277	0.00001
ERR675687_1_kneaddata_paired	Firmicutes_C	17613	P	258	0	258	0.00001
ERR675687_1_kneaddata_paired	Thermotogota	33086	P	33	0	33	0.00000
ERR675687_1_kneaddata_paired	Elusimicrobiota	11888	P	21	0	21	0.00000
ERR899270_1_kneaddata_paired	Firmicutes_A	14608	P	31718301	163063	31881364	0.79818
ERR899270_1_kneaddata_paired	Bacteroidota	4587	P	6391545	37954	6429499	0.16097
ERR899270_1_kneaddata_paired	Firmicutes	12188	P	916808	7570	924378	0.02314
ERR899270_1_kneaddata_paired	Actinobacteriota	615	P	235956	1019	236975	0.00593
ERR899270_1_kneaddata_paired	Deferribacterota	10822	P	177336	712	178048	0.00446
ERR899270_1_kneaddata_paired	Desulfobacterota_A	11509	P	155101	1039	156140	0.00391
ERR899270_1_kneaddata_paired	Proteobacteria	22518	P	90089	157	90246	0.00226
ERR899270_1_kneaddata_paired	Verrucomicrobiota	33333	P	22439	265	22704	0.00057
ERR899270_1_kneaddata_paired	Cyanobacteria	9876	P	19756	168	19924	0.00050
ERR899270_1_kneaddata_paired	Firmicutes_B	17289	P	1037	40	1077	0.00003
ERR899270_1_kneaddata_paired	Spirochaetota	32587	P	916	2	918	0.00002
ERR899270_1_kneaddata_paired	Campylobacterota	8700	P	570	0	570	0.00001
ERR899270_1_kneaddata_paired	Firmicutes_I	18140	P	337	0	337	0.00001
ERR899270_1_kneaddata_paired	Firmicutes_C	17613	P	271	0	271	0.00001
ERR899270_1_kneaddata_paired	Elusimicrobiota	11888	P	34	0	34	0.00000
ERR899270_1_kneaddata_paired	Thermotogota	33086	P	31	0	31	0.00000
ERR899271_1_kneaddata_paired	Firmicutes_A	14608	P	33419346	150601	33569947	0.84758
ERR899271_1_kneaddata_paired	Bacteroidota	4587	P	4875415	21668	4897083	0.12364
ERR899271_1_kneaddata_paired	Firmicutes	12188	P	560185	3206	563391	0.01422
ERR899271_1_kneaddata_paired	Desulfobacterota_A	11509	P	251611	783	252394	0.00637
ERR899271_1_kneaddata_paired	Actinobacteriota	615	P	134061	300	134361	0.00339
ERR899271_1_kneaddata_paired	Deferribacterota	10822	P	89710	261	89971	0.00227
ERR899271_1_kneaddata_paired	Cyanobacteria	9876	P	50375	189	50564	0.00128
ERR899271_1_kneaddata_paired	Proteobacteria	22518	P	42321	91	42412	0.00107
ERR899271_1_kneaddata_paired	Verrucomicrobiota	33333	P	2646	106	2752	0.00007
ERR899271_1_kneaddata_paired	Firmicutes_B	17289	P	1683	48	1731	0.00004
ERR899271_1_kneaddata_paired	Spirochaetota	32587	P	547	0	547	0.00001
ERR899271_1_kneaddata_paired	Campylobacterota	8700	P	530	0	530	0.00001
ERR899271_1_kneaddata_paired	Firmicutes_I	18140	P	396	0	396	0.00001
ERR899271_1_kneaddata_paired	Firmicutes_C	17613	P	387	0	387	0.00001
ERR899271_1_kneaddata_paired	Thermotogota	33086	P	121	0	121	0.00000
ERR899271_1_kneaddata_paired	Elusimicrobiota	11888	P	48	0	48	0.00000
ERR899278_1_kneaddata_paired	Bacteroidota	4587	P	18360957	95346	18456303	0.46764
ERR899278_1_kneaddata_paired	Firmicutes_A	14608	P	17452719	117207	17569926	0.44518
ERR899278_1_kneaddata_paired	Firmicutes	12188	P	2249631	14874	2264505	0.05738
ERR899278_1_kneaddata_paired	Actinobacteriota	615	P	494346	2191	496537	0.01258
ERR899278_1_kneaddata_paired	Proteobacteria	22518	P	397995	1930	399925	0.01013
ERR899278_1_kneaddata_paired	Desulfobacterota_A	11509	P	111429	700	112129	0.00284
ERR899278_1_kneaddata_paired	Verrucomicrobiota	33333	P	90185	928	91113	0.00231
ERR899278_1_kneaddata_paired	Cyanobacteria	9876	P	54753	176	54929	0.00139
ERR899278_1_kneaddata_paired	Deferribacterota	10822	P	18250	85	18335	0.00046
ERR899278_1_kneaddata_paired	Campylobacterota	8700	P	1329	1	1330	0.00003
ERR899278_1_kneaddata_paired	Firmicutes_B	17289	P	802	36	838	0.00002
ERR899278_1_kneaddata_paired	Firmicutes_I	18140	P	487	0	487	0.00001
ERR899278_1_kneaddata_paired	Spirochaetota	32587	P	348	0	348	0.00001
ERR899278_1_kneaddata_paired	Firmicutes_C	17613	P	256	0	256	0.00001
ERR899278_1_kneaddata_paired	Elusimicrobiota	11888	P	88	0	88	0.00000
ERR899278_1_kneaddata_paired	Thermotogota	33086	P	25	0	25	0.00000
ERR899280_1_kneaddata_paired	Firmicutes_A	14608	P	25138034	116888	25254922	0.58357
ERR899280_1_kneaddata_paired	Bacteroidota	4587	P	13666800	75339	13742139	0.31754
ERR899280_1_kneaddata_paired	Firmicutes	12188	P	2920215	17427	2937642	0.06788
ERR899280_1_kneaddata_paired	Actinobacteriota	615	P	807168	2848	810016	0.01872
ERR899280_1_kneaddata_paired	Proteobacteria	22518	P	284393	694	285087	0.00659
ERR899280_1_kneaddata_paired	Desulfobacterota_A	11509	P	137396	879	138275	0.00320
ERR899280_1_kneaddata_paired	Cyanobacteria	9876	P	63200	258	63458	0.00147
ERR899280_1_kneaddata_paired	Deferribacterota	10822	P	21569	77	21646	0.00050
ERR899280_1_kneaddata_paired	Verrucomicrobiota	33333	P	18885	214	19099	0.00044
ERR899280_1_kneaddata_paired	Campylobacterota	8700	P	1751	1	1752	0.00004
ERR899280_1_kneaddata_paired	Firmicutes_B	17289	P	820	28	848	0.00002
ERR899280_1_kneaddata_paired	Firmicutes_I	18140	P	795	0	795	0.00002
ERR899280_1_kneaddata_paired	Firmicutes_C	17613	P	564	1	565	0.00001
ERR899280_1_kneaddata_paired	Spirochaetota	32587	P	422	0	422	0.00001
ERR899280_1_kneaddata_paired	Elusimicrobiota	11888	P	189	0	189	0.00000
ERR899280_1_kneaddata_paired	Thermotogota	33086	P	67	0	67	0.00000
ERR899281_1_kneaddata_paired	Firmicutes_A	14608	P	31227689	117982	31345671	0.80570
ERR899281_1_kneaddata_paired	Bacteroidota	4587	P	6026350	25465	6051815	0.15555
ERR899281_1_kneaddata_paired	Firmicutes	12188	P	777603	3913	781516	0.02009
ERR899281_1_kneaddata_paired	Desulfobacterota_A	11509	P	308964	869	309833	0.00796
ERR899281_1_kneaddata_paired	Actinobacteriota	615	P	242014	664	242678	0.00624
ERR899281_1_kneaddata_paired	Cyanobacteria	9876	P	68492	207	68699	0.00177
ERR899281_1_kneaddata_paired	Deferribacterota	10822	P	55839	166	56005	0.00144
ERR899281_1_kneaddata_paired	Proteobacteria	22518	P	42318	54	42372	0.00109
ERR899281_1_kneaddata_paired	Verrucomicrobiota	33333	P	2460	102	2562	0.00007
ERR899281_1_kneaddata_paired	Firmicutes_B	17289	P	1557	45	1602	0.00004
ERR899281_1_kneaddata_paired	Campylobacterota	8700	P	750	0	750	0.00002
ERR899281_1_kneaddata_paired	Spirochaetota	32587	P	631	0	631	0.00002
ERR899281_1_kneaddata_paired	Firmicutes_I	18140	P	437	0	437	0.00001
ERR899281_1_kneaddata_paired	Firmicutes_C	17613	P	385	0	385	0.00001
ERR899281_1_kneaddata_paired	Thermotogota	33086	P	60	0	60	0.00000
ERR899281_1_kneaddata_paired	Elusimicrobiota	11888	P	35	0	35	0.00000
ERR899284_1_kneaddata_paired	Firmicutes_A	14608	P	20879011	98563	20977574	0.60498
ERR899284_1_kneaddata_paired	Bacteroidota	4587	P	11517518	71029	11588547	0.33421
ERR899284_1_kneaddata_paired	Firmicutes	12188	P	1316651	5715	1322366	0.03814
ERR899284_1_kneaddata_paired	Actinobacteriota	615	P	495740	2132	497872	0.01436
ERR899284_1_kneaddata_paired	Proteobacteria	22518	P	145513	2631	148144	0.00427
ERR899284_1_kneaddata_paired	Desulfobacterota_A	11509	P	89486	482	89968	0.00259
ERR899284_1_kneaddata_paired	Deferribacterota	10822	P	22711	85	22796	0.00066
ERR899284_1_kneaddata_paired	Cyanobacteria	9876	P	17591	92	17683	0.00051
ERR899284_1_kneaddata_paired	Firmicutes_B	17289	P	5727	211	5938	0.00017
ERR899284_1_kneaddata_paired	Verrucomicrobiota	33333	P	2243	118	2361	0.00007
ERR899284_1_kneaddata_paired	Campylobacterota	8700	P	816	0	816	0.00002
ERR899284_1_kneaddata_paired	Spirochaetota	32587	P	270	0	270	0.00001
ERR899284_1_kneaddata_paired	Firmicutes_I	18140	P	258	0	258	0.00001
ERR899284_1_kneaddata_paired	Firmicutes_C	17613	P	241	0	241	0.00001
ERR899284_1_kneaddata_paired	Elusimicrobiota	11888	P	30	0	30	0.00000
ERR899284_1_kneaddata_paired	Thermotogota	33086	P	26	0	26	0.00000
ERR899292_1_kneaddata_paired	Firmicutes_A	14608	P	38359674	228255	38587929	0.86478
ERR899292_1_kneaddata_paired	Bacteroidota	4587	P	4844575	45543	4890118	0.10959
ERR899292_1_kneaddata_paired	Firmicutes	12188	P	591484	8204	599688	0.01344
ERR899292_1_kneaddata_paired	Desulfobacterota_A	11509	P	269259	1314	270573	0.00606
ERR899292_1_kneaddata_paired	Actinobacteriota	615	P	133029	486	133515	0.00299
ERR899292_1_kneaddata_paired	Deferribacterota	10822	P	62043	264	62307	0.00140
ERR899292_1_kneaddata_paired	Cyanobacteria	9876	P	39739	352	40091	0.00090
ERR899292_1_kneaddata_paired	Proteobacteria	22518	P	31103	91	31194	0.00070
ERR899292_1_kneaddata_paired	Firmicutes_B	17289	P	2126	88	2214	0.00005
ERR899292_1_kneaddata_paired	Verrucomicrobiota	33333	P	1880	102	1982	0.00004
ERR899292_1_kneaddata_paired	Spirochaetota	32587	P	719	1	720	0.00002
ERR899292_1_kneaddata_paired	Campylobacterota	8700	P	501	0	501	0.00001
ERR899292_1_kneaddata_paired	Firmicutes_C	17613	P	337	0	337	0.00001
ERR899292_1_kneaddata_paired	Firmicutes_I	18140	P	255	0	255	0.00001
ERR899292_1_kneaddata_paired	Thermotogota	33086	P	71	0	71	0.00000
ERR899292_1_kneaddata_paired	Elusimicrobiota	11888	P	66	0	66	0.00000
ERR899293_1_kneaddata_paired	Bacteroidota	4587	P	22524352	122851	22647203	0.57116
ERR899293_1_kneaddata_paired	Firmicutes_A	14608	P	11960834	96594	12057428	0.30409
ERR899293_1_kneaddata_paired	Firmicutes	12188	P	3790610	25282	3815892	0.09624
ERR899293_1_kneaddata_paired	Actinobacteriota	615	P	614625	2901	617526	0.01557
ERR899293_1_kneaddata_paired	Proteobacteria	22518	P	313129	1266	314395	0.00793
ERR899293_1_kneaddata_paired	Cyanobacteria	9876	P	88930	238	89168	0.00225
ERR899293_1_kneaddata_paired	Desulfobacterota_A	11509	P	83167	533	83700	0.00211
ERR899293_1_kneaddata_paired	Deferribacterota	10822	P	16891	85	16976	0.00043
ERR899293_1_kneaddata_paired	Verrucomicrobiota	33333	P	5307	241	5548	0.00014
ERR899293_1_kneaddata_paired	Campylobacterota	8700	P	1431	1	1432	0.00004
ERR899293_1_kneaddata_paired	Firmicutes_B	17289	P	637	31	668	0.00002
ERR899293_1_kneaddata_paired	Firmicutes_I	18140	P	516	0	516	0.00001
ERR899293_1_kneaddata_paired	Spirochaetota	32587	P	282	0	282	0.00001
ERR899293_1_kneaddata_paired	Firmicutes_C	17613	P	150	0	150	0.00000
ERR899293_1_kneaddata_paired	Elusimicrobiota	11888	P	129	0	129	0.00000
ERR899293_1_kneaddata_paired	Thermotogota	33086	P	6	0	6	0.00000
ERR982795_1_kneaddata_paired	Bacteroidota	4587	P	9601104	46160	9647264	0.47796
ERR982795_1_kneaddata_paired	Firmicutes_A	14608	P	9319082	26183	9345265	0.46300
ERR982795_1_kneaddata_paired	Verrucomicrobiota	33333	P	503431	11452	514883	0.02551
ERR982795_1_kneaddata_paired	Firmicutes	12188	P	386580	10263	396843	0.01966
ERR982795_1_kneaddata_paired	Proteobacteria	22518	P	141370	254	141624	0.00702
ERR982795_1_kneaddata_paired	Desulfobacterota_A	11509	P	126596	445	127041	0.00629
ERR982795_1_kneaddata_paired	Actinobacteriota	615	P	7001	6	7007	0.00035
ERR982795_1_kneaddata_paired	Cyanobacteria	9876	P	2569	17	2586	0.00013
ERR982795_1_kneaddata_paired	Firmicutes_B	17289	P	588	8	596	0.00003
ERR982795_1_kneaddata_paired	Spirochaetota	32587	P	457	0	457	0.00002
ERR982795_1_kneaddata_paired	Campylobacterota	8700	P	236	0	236	0.00001
ERR982795_1_kneaddata_paired	Deferribacterota	10822	P	105	0	105	0.00001
ERR982795_1_kneaddata_paired	Firmicutes_I	18140	P	70	0	70	0.00000
ERR982795_1_kneaddata_paired	Firmicutes_C	17613	P	65	0	65	0.00000
ERR982795_1_kneaddata_paired	Thermotogota	33086	P	8	0	8	0.00000
ERR982795_1_kneaddata_paired	Elusimicrobiota	11888	P	7	0	7	0.00000
ERR982796_1_kneaddata_paired	Bacteroidota	4587	P	6938052	33866	6971918	0.44390
ERR982796_1_kneaddata_paired	Firmicutes_A	14608	P	6113674	14215	6127889	0.39016
ERR982796_1_kneaddata_paired	Verrucomicrobiota	33333	P	1024108	17904	1042012	0.06634
ERR982796_1_kneaddata_paired	Proteobacteria	22518	P	786498	912	787410	0.05013
ERR982796_1_kneaddata_paired	Firmicutes	12188	P	566981	10392	577373	0.03676
ERR982796_1_kneaddata_paired	Desulfobacterota_A	11509	P	178672	389	179061	0.01140
ERR982796_1_kneaddata_paired	Actinobacteriota	615	P	17506	11	17517	0.00112
ERR982796_1_kneaddata_paired	Cyanobacteria	9876	P	1337	8	1345	0.00009
ERR982796_1_kneaddata_paired	Spirochaetota	32587	P	690	0	690	0.00004
ERR982796_1_kneaddata_paired	Firmicutes_B	17289	P	449	4	453	0.00003
ERR982796_1_kneaddata_paired	Campylobacterota	8700	P	158	0	158	0.00001
ERR982796_1_kneaddata_paired	Deferribacterota	10822	P	70	0	70	0.00000
ERR982796_1_kneaddata_paired	Firmicutes_C	17613	P	60	0	60	0.00000
ERR982796_1_kneaddata_paired	Firmicutes_I	18140	P	58	0	58	0.00000
ERR982796_1_kneaddata_paired	Thermotogota	33086	P	12	0	12	0.00000
ERR982796_1_kneaddata_paired	Elusimicrobiota	11888	P	5	0	5	0.00000
ERR982797_1_kneaddata_paired	Firmicutes_A	14608	P	10468481	55266	10523747	0.56252
ERR982797_1_kneaddata_paired	Firmicutes	12188	P	5034525	32837	5067362	0.27086
ERR982797_1_kneaddata_paired	Bacteroidota	4587	P	2595117	36346	2631463	0.14066
ERR982797_1_kneaddata_paired	Verrucomicrobiota	33333	P	194661	10792	205453	0.01098
ERR982797_1_kneaddata_paired	Proteobacteria	22518	P	177933	666	178599	0.00955
ERR982797_1_kneaddata_paired	Actinobacteriota	615	P	63321	161	63482	0.00339
ERR982797_1_kneaddata_paired	Desulfobacterota_A	11509	P	32659	1667	34326	0.00183
ERR982797_1_kneaddata_paired	Cyanobacteria	9876	P	1624	30	1654	0.00009
ERR982797_1_kneaddata_paired	Firmicutes_B	17289	P	1056	36	1092	0.00006
ERR982797_1_kneaddata_paired	Campylobacterota	8700	P	530	0	530	0.00003
ERR982797_1_kneaddata_paired	Spirochaetota	32587	P	232	0	232	0.00001
ERR982797_1_kneaddata_paired	Deferribacterota	10822	P	173	0	173	0.00001
ERR982797_1_kneaddata_paired	Firmicutes_C	17613	P	103	0	103	0.00001
ERR982797_1_kneaddata_paired	Firmicutes_I	18140	P	86	0	86	0.00000
ERR982797_1_kneaddata_paired	Thermotogota	33086	P	46	0	46	0.00000
ERR982797_1_kneaddata_paired	Elusimicrobiota	11888	P	6	0	6	0.00000
ERR982798_1_kneaddata_paired	Firmicutes_A	14608	P	11475048	50846	11525894	0.77607
ERR982798_1_kneaddata_paired	Bacteroidota	4587	P	3012404	38250	3050654	0.20541
ERR982798_1_kneaddata_paired	Firmicutes	12188	P	168479	1270	169749	0.01143
ERR982798_1_kneaddata_paired	Desulfobacterota_A	11509	P	49029	1381	50410	0.00339
ERR982798_1_kneaddata_paired	Actinobacteriota	615	P	31380	52	31432	0.00212
ERR982798_1_kneaddata_paired	Verrucomicrobiota	33333	P	16963	687	17650	0.00119
ERR982798_1_kneaddata_paired	Proteobacteria	22518	P	3122	28	3150	0.00021
ERR982798_1_kneaddata_paired	Cyanobacteria	9876	P	1246	21	1267	0.00009
ERR982798_1_kneaddata_paired	Spirochaetota	32587	P	537	0	537	0.00004
ERR982798_1_kneaddata_paired	Firmicutes_B	17289	P	532	13	545	0.00004
ERR982798_1_kneaddata_paired	Firmicutes_C	17613	P	118	0	118	0.00001
ERR982798_1_kneaddata_paired	Campylobacterota	8700	P	94	0	94	0.00001
ERR982798_1_kneaddata_paired	Deferribacterota	10822	P	90	0	90	0.00001
ERR982798_1_kneaddata_paired	Firmicutes_I	18140	P	63	0	63	0.00000
ERR982798_1_kneaddata_paired	Thermotogota	33086	P	31	0	31	0.00000
ERR982798_1_kneaddata_paired	Elusimicrobiota	11888	P	13	0	13	0.00000
ERR982799_1_kneaddata_paired	Bacteroidota	4587	P	8102948	35440	8138388	0.54842
ERR982799_1_kneaddata_paired	Firmicutes_A	14608	P	5462625	13397	5476022	0.36901
ERR982799_1_kneaddata_paired	Verrucomicrobiota	33333	P	567068	10547	577615	0.03892
ERR982799_1_kneaddata_paired	Firmicutes	12188	P	332167	9712	341879	0.02304
ERR982799_1_kneaddata_paired	Desulfobacterota_A	11509	P	179686	391	180077	0.01213
ERR982799_1_kneaddata_paired	Proteobacteria	22518	P	114817	131	114948	0.00775
ERR982799_1_kneaddata_paired	Actinobacteriota	615	P	8357	6	8363	0.00056
ERR982799_1_kneaddata_paired	Cyanobacteria	9876	P	888	6	894	0.00006
ERR982799_1_kneaddata_paired	Spirochaetota	32587	P	635	0	635	0.00004
ERR982799_1_kneaddata_paired	Firmicutes_B	17289	P	432	4	436	0.00003
ERR982799_1_kneaddata_paired	Campylobacterota	8700	P	310	0	310	0.00002
ERR982799_1_kneaddata_paired	Firmicutes_I	18140	P	78	0	78	0.00001
ERR982799_1_kneaddata_paired	Firmicutes_C	17613	P	58	0	58	0.00000
ERR982799_1_kneaddata_paired	Deferribacterota	10822	P	41	0	41	0.00000
ERR982799_1_kneaddata_paired	Thermotogota	33086	P	12	0	12	0.00000
ERR982799_1_kneaddata_paired	Elusimicrobiota	11888	P	5	0	5	0.00000
ERR982800_1_kneaddata_paired	Firmicutes_A	14608	P	9663910	29777	9693687	0.61025
ERR982800_1_kneaddata_paired	Bacteroidota	4587	P	3464614	23366	3487980	0.21958
ERR982800_1_kneaddata_paired	Verrucomicrobiota	33333	P	1675062	43028	1718090	0.10816
ERR982800_1_kneaddata_paired	Firmicutes	12188	P	554825	2081	556906	0.03506
ERR982800_1_kneaddata_paired	Firmicutes_B	17289	P	197607	3133	200740	0.01264
ERR982800_1_kneaddata_paired	Desulfobacterota_A	11509	P	139526	986	140512	0.00885
ERR982800_1_kneaddata_paired	Actinobacteriota	615	P	50476	56	50532	0.00318
ERR982800_1_kneaddata_paired	Proteobacteria	22518	P	33174	58	33232	0.00209
ERR982800_1_kneaddata_paired	Cyanobacteria	9876	P	1458	14	1472	0.00009
ERR982800_1_kneaddata_paired	Spirochaetota	32587	P	1146	0	1146	0.00007
ERR982800_1_kneaddata_paired	Campylobacterota	8700	P	189	0	189	0.00001
ERR982800_1_kneaddata_paired	Firmicutes_I	18140	P	124	0	124	0.00001
ERR982800_1_kneaddata_paired	Firmicutes_C	17613	P	121	0	121	0.00001
ERR982800_1_kneaddata_paired	Deferribacterota	10822	P	117	0	117	0.00001
ERR982800_1_kneaddata_paired	Thermotogota	33086	P	23	0	23	0.00000
ERR982800_1_kneaddata_paired	Elusimicrobiota	11888	P	19	0	19	0.00000
ERR982801_1_kneaddata_paired	Firmicutes_A	14608	P	14160184	79032	14239216	0.62593
ERR982801_1_kneaddata_paired	Bacteroidota	4587	P	6208334	64237	6272571	0.27573
ERR982801_1_kneaddata_paired	Firmicutes	12188	P	1522902	9034	1531936	0.06734
ERR982801_1_kneaddata_paired	Proteobacteria	22518	P	510675	595	511270	0.02247
ERR982801_1_kneaddata_paired	Actinobacteriota	615	P	112788	197	112985	0.00497
ERR982801_1_kneaddata_paired	Desulfobacterota_A	11509	P	49892	1911	51803	0.00228
ERR982801_1_kneaddata_paired	Verrucomicrobiota	33333	P	19742	848	20590	0.00091
ERR982801_1_kneaddata_paired	Cyanobacteria	9876	P	5333	59	5392	0.00024
ERR982801_1_kneaddata_paired	Firmicutes_B	17289	P	1074	28	1102	0.00005
ERR982801_1_kneaddata_paired	Spirochaetota	32587	P	693	0	693	0.00003
ERR982801_1_kneaddata_paired	Campylobacterota	8700	P	582	0	582	0.00003
ERR982801_1_kneaddata_paired	Deferribacterota	10822	P	305	0	305	0.00001
ERR982801_1_kneaddata_paired	Firmicutes_C	17613	P	182	0	182	0.00001
ERR982801_1_kneaddata_paired	Firmicutes_I	18140	P	128	0	128	0.00001
ERR982801_1_kneaddata_paired	Thermotogota	33086	P	40	0	40	0.00000
ERR982801_1_kneaddata_paired	Elusimicrobiota	11888	P	19	0	19	0.00000
ERR982802_1_kneaddata_paired	Bacteroidota	4587	P	16354225	63794	16418019	0.60116
ERR982802_1_kneaddata_paired	Firmicutes_A	14608	P	7926906	16666	7943572	0.29086
ERR982802_1_kneaddata_paired	Verrucomicrobiota	33333	P	1445266	23924	1469190	0.05380
ERR982802_1_kneaddata_paired	Firmicutes	12188	P	775778	15156	790934	0.02896
ERR982802_1_kneaddata_paired	Proteobacteria	22518	P	351469	400	351869	0.01288
ERR982802_1_kneaddata_paired	Desulfobacterota_A	11509	P	304028	446	304474	0.01115
ERR982802_1_kneaddata_paired	Actinobacteriota	615	P	28272	14	28286	0.00104
ERR982802_1_kneaddata_paired	Cyanobacteria	9876	P	1729	11	1740	0.00006
ERR982802_1_kneaddata_paired	Firmicutes_B	17289	P	894	9	903	0.00003
ERR982802_1_kneaddata_paired	Spirochaetota	32587	P	796	0	796	0.00003
ERR982802_1_kneaddata_paired	Campylobacterota	8700	P	616	0	616	0.00002
ERR982802_1_kneaddata_paired	Firmicutes_I	18140	P	125	0	125	0.00000
ERR982802_1_kneaddata_paired	Firmicutes_C	17613	P	112	0	112	0.00000
ERR982802_1_kneaddata_paired	Deferribacterota	10822	P	62	0	62	0.00000
ERR982802_1_kneaddata_paired	Elusimicrobiota	11888	P	8	0	8	0.00000
ERR982802_1_kneaddata_paired	Thermotogota	33086	P	6	0	6	0.00000
ERR982803_1_kneaddata_paired	Firmicutes_A	14608	P	12235136	54604	12289740	0.79612
ERR982803_1_kneaddata_paired	Bacteroidota	4587	P	1486211	15619	1501830	0.09729
ERR982803_1_kneaddata_paired	Verrucomicrobiota	33333	P	663051	30363	693414	0.04492
ERR982803_1_kneaddata_paired	Firmicutes	12188	P	425420	2647	428067	0.02773
ERR982803_1_kneaddata_paired	Firmicutes_B	17289	P	273533	7732	281265	0.01822
ERR982803_1_kneaddata_paired	Actinobacteriota	615	P	111117	220	111337	0.00721
ERR982803_1_kneaddata_paired	Desulfobacterota_A	11509	P	97843	1157	99000	0.00641
ERR982803_1_kneaddata_paired	Proteobacteria	22518	P	30193	66	30259	0.00196
ERR982803_1_kneaddata_paired	Cyanobacteria	9876	P	927	12	939	0.00006
ERR982803_1_kneaddata_paired	Spirochaetota	32587	P	617	0	617	0.00004
ERR982803_1_kneaddata_paired	Firmicutes_C	17613	P	240	0	240	0.00002
ERR982803_1_kneaddata_paired	Campylobacterota	8700	P	203	0	203	0.00001
ERR982803_1_kneaddata_paired	Firmicutes_I	18140	P	108	0	108	0.00001
ERR982803_1_kneaddata_paired	Deferribacterota	10822	P	23	0	23	0.00000
ERR982803_1_kneaddata_paired	Elusimicrobiota	11888	P	15	0	15	0.00000
ERR982803_1_kneaddata_paired	Thermotogota	33086	P	7	0	7	0.00000
ERR982804_1_kneaddata_paired	Firmicutes_A	14608	P	14415360	72000	14487360	0.82996
ERR982804_1_kneaddata_paired	Bacteroidota	4587	P	1972727	30683	2003410	0.11477
ERR982804_1_kneaddata_paired	Firmicutes	12188	P	617238	3990	621228	0.03559
ERR982804_1_kneaddata_paired	Desulfobacterota_A	11509	P	117098	1531	118629	0.00680
ERR982804_1_kneaddata_paired	Proteobacteria	22518	P	114995	398	115393	0.00661
ERR982804_1_kneaddata_paired	Actinobacteriota	615	P	84957	144	85101	0.00488
ERR982804_1_kneaddata_paired	Verrucomicrobiota	33333	P	17335	864	18199	0.00104
ERR982804_1_kneaddata_paired	Cyanobacteria	9876	P	2732	19	2751	0.00016
ERR982804_1_kneaddata_paired	Firmicutes_B	17289	P	1630	49	1679	0.00010
ERR982804_1_kneaddata_paired	Spirochaetota	32587	P	822	0	822	0.00005
ERR982804_1_kneaddata_paired	Campylobacterota	8700	P	342	0	342	0.00002
ERR982804_1_kneaddata_paired	Firmicutes_C	17613	P	294	0	294	0.00002
ERR982804_1_kneaddata_paired	Firmicutes_I	18140	P	107	0	107	0.00001
ERR982804_1_kneaddata_paired	Deferribacterota	10822	P	78	0	78	0.00000
ERR982804_1_kneaddata_paired	Thermotogota	33086	P	24	0	24	0.00000
ERR982804_1_kneaddata_paired	Elusimicrobiota	11888	P	8	0	8	0.00000
ERR982805_1_kneaddata_paired	Bacteroidota	4587	P	12074994	42100	12117094	0.56750
ERR982805_1_kneaddata_paired	Firmicutes_A	14608	P	6795166	14112	6809278	0.31891
ERR982805_1_kneaddata_paired	Verrucomicrobiota	33333	P	933374	15754	949128	0.04445
ERR982805_1_kneaddata_paired	Firmicutes	12188	P	910887	31532	942419	0.04414
ERR982805_1_kneaddata_paired	Desulfobacterota_A	11509	P	253916	350	254266	0.01191
ERR982805_1_kneaddata_paired	Proteobacteria	22518	P	219131	293	219424	0.01028
ERR982805_1_kneaddata_paired	Actinobacteriota	615	P	53923	25	53948	0.00253
ERR982805_1_kneaddata_paired	Cyanobacteria	9876	P	4660	60	4720	0.00022
ERR982805_1_kneaddata_paired	Firmicutes_B	17289	P	540	5	545	0.00003
ERR982805_1_kneaddata_paired	Spirochaetota	32587	P	433	0	433	0.00002
ERR982805_1_kneaddata_paired	Campylobacterota	8700	P	246	0	246	0.00001
ERR982805_1_kneaddata_paired	Deferribacterota	10822	P	76	0	76	0.00000
ERR982805_1_kneaddata_paired	Firmicutes_C	17613	P	66	0	66	0.00000
ERR982805_1_kneaddata_paired	Firmicutes_I	18140	P	52	0	52	0.00000
ERR982805_1_kneaddata_paired	Elusimicrobiota	11888	P	11	0	11	0.00000
ERR982805_1_kneaddata_paired	Thermotogota	33086	P	8	0	8	0.00000
ERR982806_1_kneaddata_paired	Firmicutes_A	14608	P	16078101	72282	16150383	0.74922
ERR982806_1_kneaddata_paired	Bacteroidota	4587	P	3742040	30722	3772762	0.17502
ERR982806_1_kneaddata_paired	Firmicutes	12188	P	623232	5498	628730	0.02917
ERR982806_1_kneaddata_paired	Verrucomicrobiota	33333	P	536082	23569	559651	0.02596
ERR982806_1_kneaddata_paired	Desulfobacterota_A	11509	P	327543	1930	329473	0.01528
ERR982806_1_kneaddata_paired	Actinobacteriota	615	P	68362	121	68483	0.00318
ERR982806_1_kneaddata_paired	Proteobacteria	22518	P	41976	104	42080	0.00195
ERR982806_1_kneaddata_paired	Firmicutes_B	17289	P	1798	48	1846	0.00009
ERR982806_1_kneaddata_paired	Cyanobacteria	9876	P	1721	20	1741	0.00008
ERR982806_1_kneaddata_paired	Campylobacterota	8700	P	353	0	353	0.00002
ERR982806_1_kneaddata_paired	Spirochaetota	32587	P	288	0	288	0.00001
ERR982806_1_kneaddata_paired	Firmicutes_C	17613	P	223	0	223	0.00001
ERR982806_1_kneaddata_paired	Firmicutes_I	18140	P	150	0	150	0.00001
ERR982806_1_kneaddata_paired	Thermotogota	33086	P	33	0	33	0.00000
ERR982806_1_kneaddata_paired	Deferribacterota	10822	P	31	0	31	0.00000
ERR982806_1_kneaddata_paired	Elusimicrobiota	11888	P	13	0	13	0.00000
ERR982807_1_kneaddata_paired	Firmicutes_A	14608	P	9927786	45851	9973637	0.62839
ERR982807_1_kneaddata_paired	Bacteroidota	4587	P	3869228	44366	3913594	0.24658
ERR982807_1_kneaddata_paired	Firmicutes	12188	P	1755712	14452	1770164	0.11153
ERR982807_1_kneaddata_paired	Actinobacteriota	615	P	112124	148	112272	0.00707
ERR982807_1_kneaddata_paired	Desulfobacterota_A	11509	P	59556	896	60452	0.00381
ERR982807_1_kneaddata_paired	Proteobacteria	22518	P	26449	69	26518	0.00167
ERR982807_1_kneaddata_paired	Verrucomicrobiota	33333	P	11097	436	11533	0.00073
ERR982807_1_kneaddata_paired	Cyanobacteria	9876	P	984	5	989	0.00006
ERR982807_1_kneaddata_paired	Firmicutes_B	17289	P	943	22	965	0.00006
ERR982807_1_kneaddata_paired	Spirochaetota	32587	P	587	0	587	0.00004
ERR982807_1_kneaddata_paired	Campylobacterota	8700	P	524	0	524	0.00003
ERR982807_1_kneaddata_paired	Deferribacterota	10822	P	187	0	187	0.00001
ERR982807_1_kneaddata_paired	Firmicutes_C	17613	P	113	0	113	0.00001
ERR982807_1_kneaddata_paired	Firmicutes_I	18140	P	51	0	51	0.00000
ERR982807_1_kneaddata_paired	Thermotogota	33086	P	27	0	27	0.00000
ERR982807_1_kneaddata_paired	Elusimicrobiota	11888	P	4	0	4	0.00000
ERR982808_1_kneaddata_paired	Firmicutes_A	14608	P	7070785	23110	7093895	0.62477
ERR982808_1_kneaddata_paired	Bacteroidota	4587	P	2975867	25361	3001228	0.26432
ERR982808_1_kneaddata_paired	Verrucomicrobiota	33333	P	630164	17923	648087	0.05708
ERR982808_1_kneaddata_paired	Firmicutes	12188	P	253923	980	254903	0.02245
ERR982808_1_kneaddata_paired	Desulfobacterota_A	11509	P	248519	741	249260	0.02195
ERR982808_1_kneaddata_paired	Proteobacteria	22518	P	77790	157	77947	0.00686
ERR982808_1_kneaddata_paired	Actinobacteriota	615	P	26480	37	26517	0.00234
ERR982808_1_kneaddata_paired	Cyanobacteria	9876	P	951	8	959	0.00008
ERR982808_1_kneaddata_paired	Firmicutes_B	17289	P	911	15	926	0.00008
ERR982808_1_kneaddata_paired	Campylobacterota	8700	P	217	0	217	0.00002
ERR982808_1_kneaddata_paired	Spirochaetota	32587	P	216	0	216	0.00002
ERR982808_1_kneaddata_paired	Firmicutes_C	17613	P	144	0	144	0.00001
ERR982808_1_kneaddata_paired	Firmicutes_I	18140	P	91	0	91	0.00001
ERR982808_1_kneaddata_paired	Deferribacterota	10822	P	51	0	51	0.00000
ERR982808_1_kneaddata_paired	Elusimicrobiota	11888	P	15	0	15	0.00000
ERR982808_1_kneaddata_paired	Thermotogota	33086	P	10	0	10	0.00000
ERR982809_1_kneaddata_paired	Bacteroidota	4587	P	12054648	60594	12115242	0.55121
ERR982809_1_kneaddata_paired	Firmicutes_A	14608	P	8360611	20111	8380722	0.38130
ERR982809_1_kneaddata_paired	Verrucomicrobiota	33333	P	745368	16786	762154	0.03468
ERR982809_1_kneaddata_paired	Desulfobacterota_A	11509	P	338304	529	338833	0.01542
ERR982809_1_kneaddata_paired	Firmicutes	12188	P	228629	731	229360	0.01044
ERR982809_1_kneaddata_paired	Proteobacteria	22518	P	125433	196	125629	0.00572
ERR982809_1_kneaddata_paired	Actinobacteriota	615	P	23316	22	23338	0.00106
ERR982809_1_kneaddata_paired	Cyanobacteria	9876	P	2381	11	2392	0.00011
ERR982809_1_kneaddata_paired	Spirochaetota	32587	P	631	0	631	0.00003
ERR982809_1_kneaddata_paired	Firmicutes_B	17289	P	563	7	570	0.00003
ERR982809_1_kneaddata_paired	Campylobacterota	8700	P	287	0	287	0.00001
ERR982809_1_kneaddata_paired	Firmicutes_C	17613	P	108	0	108	0.00000
ERR982809_1_kneaddata_paired	Firmicutes_I	18140	P	73	0	73	0.00000
ERR982809_1_kneaddata_paired	Deferribacterota	10822	P	55	0	55	0.00000
ERR982809_1_kneaddata_paired	Thermotogota	33086	P	19	0	19	0.00000
ERR982809_1_kneaddata_paired	Elusimicrobiota	11888	P	9	0	9	0.00000
ERR982810_1_kneaddata_paired	Firmicutes_A	14608	P	11477514	56956	11534470	0.66942
ERR982810_1_kneaddata_paired	Bacteroidota	4587	P	4453657	50959	4504616	0.26143
ERR982810_1_kneaddata_paired	Firmicutes	12188	P	766873	4421	771294	0.04476
ERR982810_1_kneaddata_paired	Desulfobacterota_A	11509	P	280103	1679	281782	0.01635
ERR982810_1_kneaddata_paired	Actinobacteriota	615	P	85322	160	85482	0.00496
ERR982810_1_kneaddata_paired	Proteobacteria	22518	P	31877	121	31998	0.00186
ERR982810_1_kneaddata_paired	Verrucomicrobiota	33333	P	16668	754	17422	0.00101
ERR982810_1_kneaddata_paired	Cyanobacteria	9876	P	1196	20	1216	0.00007
ERR982810_1_kneaddata_paired	Firmicutes_B	17289	P	857	23	880	0.00005
ERR982810_1_kneaddata_paired	Spirochaetota	32587	P	850	0	850	0.00005
ERR982810_1_kneaddata_paired	Campylobacterota	8700	P	199	0	199	0.00001
ERR982810_1_kneaddata_paired	Firmicutes_C	17613	P	172	0	172	0.00001
ERR982810_1_kneaddata_paired	Firmicutes_I	18140	P	127	0	127	0.00001
ERR982810_1_kneaddata_paired	Deferribacterota	10822	P	90	0	90	0.00001
ERR982810_1_kneaddata_paired	Elusimicrobiota	11888	P	19	0	19	0.00000
ERR982810_1_kneaddata_paired	Thermotogota	33086	P	2	0	2	0.00000
ERR982811_1_kneaddata_paired	Firmicutes_A	14608	P	9664062	25434	9689496	0.56452
ERR982811_1_kneaddata_paired	Bacteroidota	4587	P	5482215	35519	5517734	0.32147
ERR982811_1_kneaddata_paired	Verrucomicrobiota	33333	P	1074167	25366	1099533	0.06406
ERR982811_1_kneaddata_paired	Firmicutes	12188	P	561483	15291	576774	0.03360
ERR982811_1_kneaddata_paired	Desulfobacterota_A	11509	P	192767	709	193476	0.01127
ERR982811_1_kneaddata_paired	Actinobacteriota	615	P	60462	62	60524	0.00353
ERR982811_1_kneaddata_paired	Proteobacteria	22518	P	23265	36	23301	0.00136
ERR982811_1_kneaddata_paired	Cyanobacteria	9876	P	1217	9	1226	0.00007
ERR982811_1_kneaddata_paired	Spirochaetota	32587	P	1084	0	1084	0.00006
ERR982811_1_kneaddata_paired	Firmicutes_B	17289	P	681	9	690	0.00004
ERR982811_1_kneaddata_paired	Firmicutes_C	17613	P	110	0	110	0.00001
ERR982811_1_kneaddata_paired	Campylobacterota	8700	P	94	0	94	0.00001
ERR982811_1_kneaddata_paired	Firmicutes_I	18140	P	85	0	85	0.00000
ERR982811_1_kneaddata_paired	Deferribacterota	10822	P	75	0	75	0.00000
ERR982811_1_kneaddata_paired	Thermotogota	33086	P	16	0	16	0.00000
ERR982811_1_kneaddata_paired	Elusimicrobiota	11888	P	8	0	8	0.00000
ERR982812_1_kneaddata_paired	Bacteroidota	4587	P	8569144	37949	8607093	0.50580
ERR982812_1_kneaddata_paired	Firmicutes_A	14608	P	6665629	15841	6681470	0.39264
ERR982812_1_kneaddata_paired	Firmicutes	12188	P	870030	30579	900609	0.05293
ERR982812_1_kneaddata_paired	Verrucomicrobiota	33333	P	388511	8005	396516	0.02330
ERR982812_1_kneaddata_paired	Firmicutes_B	17289	P	184759	2350	187109	0.01100
ERR982812_1_kneaddata_paired	Proteobacteria	22518	P	136746	204	136950	0.00805
ERR982812_1_kneaddata_paired	Desulfobacterota_A	11509	P	79798	329	80127	0.00471
ERR982812_1_kneaddata_paired	Actinobacteriota	615	P	24774	21	24795	0.00146
ERR982812_1_kneaddata_paired	Cyanobacteria	9876	P	935	5	940	0.00006
ERR982812_1_kneaddata_paired	Spirochaetota	32587	P	581	0	581	0.00003
ERR982812_1_kneaddata_paired	Campylobacterota	8700	P	231	0	231	0.00001
ERR982812_1_kneaddata_paired	Firmicutes_I	18140	P	74	0	74	0.00000
ERR982812_1_kneaddata_paired	Firmicutes_C	17613	P	65	0	65	0.00000
ERR982812_1_kneaddata_paired	Deferribacterota	10822	P	59	0	59	0.00000
ERR982812_1_kneaddata_paired	Elusimicrobiota	11888	P	12	0	12	0.00000
ERR982812_1_kneaddata_paired	Thermotogota	33086	P	7	0	7	0.00000
ERR982813_1_kneaddata_paired	Firmicutes_A	14608	P	12403831	63890	12467721	0.78707
ERR982813_1_kneaddata_paired	Bacteroidota	4587	P	2124274	16230	2140504	0.13513
ERR982813_1_kneaddata_paired	Firmicutes	12188	P	459436	1932	461368	0.02913
ERR982813_1_kneaddata_paired	Verrucomicrobiota	33333	P	320854	11758	332612	0.02100
ERR982813_1_kneaddata_paired	Desulfobacterota_A	11509	P	191789	1373	193162	0.01219
ERR982813_1_kneaddata_paired	Proteobacteria	22518	P	156944	414	157358	0.00993
ERR982813_1_kneaddata_paired	Actinobacteriota	615	P	84416	138	84554	0.00534
ERR982813_1_kneaddata_paired	Firmicutes_B	17289	P	1213	27	1240	0.00008
ERR982813_1_kneaddata_paired	Cyanobacteria	9876	P	1191	9	1200	0.00008
ERR982813_1_kneaddata_paired	Spirochaetota	32587	P	357	0	357	0.00002
ERR982813_1_kneaddata_paired	Campylobacterota	8700	P	355	0	355	0.00002
ERR982813_1_kneaddata_paired	Firmicutes_C	17613	P	137	0	137	0.00001
ERR982813_1_kneaddata_paired	Firmicutes_I	18140	P	92	0	92	0.00001
ERR982813_1_kneaddata_paired	Deferribacterota	10822	P	56	0	56	0.00000
ERR982813_1_kneaddata_paired	Thermotogota	33086	P	38	0	38	0.00000
ERR982813_1_kneaddata_paired	Elusimicrobiota	11888	P	10	0	10	0.00000
ERR982814_1_kneaddata_paired	Firmicutes_A	14608	P	6816825	18523	6835348	0.43993
ERR982814_1_kneaddata_paired	Bacteroidota	4587	P	6384125	30401	6414526	0.41285
ERR982814_1_kneaddata_paired	Verrucomicrobiota	33333	P	1433377	30771	1464148	0.09423
ERR982814_1_kneaddata_paired	Firmicutes	12188	P	412885	1085	413970	0.02664
ERR982814_1_kneaddata_paired	Desulfobacterota_A	11509	P	306718	600	307318	0.01978
ERR982814_1_kneaddata_paired	Actinobacteriota	615	P	70722	63	70785	0.00456
ERR982814_1_kneaddata_paired	Proteobacteria	22518	P	28110	20	28130	0.00181
ERR982814_1_kneaddata_paired	Cyanobacteria	9876	P	1439	13	1452	0.00009
ERR982814_1_kneaddata_paired	Firmicutes_B	17289	P	664	8	672	0.00004
ERR982814_1_kneaddata_paired	Spirochaetota	32587	P	523	0	523	0.00003
ERR982814_1_kneaddata_paired	Campylobacterota	8700	P	181	0	181	0.00001
ERR982814_1_kneaddata_paired	Firmicutes_C	17613	P	85	0	85	0.00001
ERR982814_1_kneaddata_paired	Firmicutes_I	18140	P	83	0	83	0.00001
ERR982814_1_kneaddata_paired	Deferribacterota	10822	P	81	0	81	0.00001
ERR982814_1_kneaddata_paired	Thermotogota	33086	P	8	0	8	0.00000
ERR982814_1_kneaddata_paired	Elusimicrobiota	11888	P	7	0	7	0.00000
ERR982815_1_kneaddata_paired	Bacteroidota	4587	P	13036579	55444	13092023	0.56526
ERR982815_1_kneaddata_paired	Firmicutes_A	14608	P	6981903	16463	6998366	0.30216
ERR982815_1_kneaddata_paired	Firmicutes	12188	P	1343291	39796	1383087	0.05972
ERR982815_1_kneaddata_paired	Verrucomicrobiota	33333	P	1026438	19798	1046236	0.04517
ERR982815_1_kneaddata_paired	Desulfobacterota_A	11509	P	327594	522	328116	0.01417
ERR982815_1_kneaddata_paired	Proteobacteria	22518	P	291696	432	292128	0.01261
ERR982815_1_kneaddata_paired	Actinobacteriota	615	P	16496	14	16510	0.00071
ERR982815_1_kneaddata_paired	Cyanobacteria	9876	P	1457	9	1466	0.00006
ERR982815_1_kneaddata_paired	Firmicutes_B	17289	P	1430	17	1447	0.00006
ERR982815_1_kneaddata_paired	Spirochaetota	32587	P	1112	0	1112	0.00005
ERR982815_1_kneaddata_paired	Campylobacterota	8700	P	435	0	435	0.00002
ERR982815_1_kneaddata_paired	Firmicutes_I	18140	P	94	0	94	0.00000
ERR982815_1_kneaddata_paired	Deferribacterota	10822	P	87	0	87	0.00000
ERR982815_1_kneaddata_paired	Firmicutes_C	17613	P	68	0	68	0.00000
ERR982815_1_kneaddata_paired	Thermotogota	33086	P	9	0	9	0.00000
ERR982815_1_kneaddata_paired	Elusimicrobiota	11888	P	7	0	7	0.00000
ERR982816_1_kneaddata_paired	Firmicutes_A	14608	P	11787369	36270	11823639	0.66562
ERR982816_1_kneaddata_paired	Bacteroidota	4587	P	5214956	50751	5265707	0.29644
ERR982816_1_kneaddata_paired	Firmicutes	12188	P	285813	1703	287516	0.01619
ERR982816_1_kneaddata_paired	Verrucomicrobiota	33333	P	215152	7099	222251	0.01251
ERR982816_1_kneaddata_paired	Desulfobacterota_A	11509	P	95450	884	96334	0.00542
ERR982816_1_kneaddata_paired	Actinobacteriota	615	P	57163	71	57234	0.00322
ERR982816_1_kneaddata_paired	Proteobacteria	22518	P	7014	24	7038	0.00040
ERR982816_1_kneaddata_paired	Cyanobacteria	9876	P	1202	13	1215	0.00007
ERR982816_1_kneaddata_paired	Firmicutes_B	17289	P	1187	24	1211	0.00007
ERR982816_1_kneaddata_paired	Spirochaetota	32587	P	695	0	695	0.00004
ERR982816_1_kneaddata_paired	Campylobacterota	8700	P	187	0	187	0.00001
ERR982816_1_kneaddata_paired	Firmicutes_C	17613	P	138	0	138	0.00001
ERR982816_1_kneaddata_paired	Firmicutes_I	18140	P	78	0	78	0.00000
ERR982816_1_kneaddata_paired	Deferribacterota	10822	P	45	0	45	0.00000
ERR982816_1_kneaddata_paired	Elusimicrobiota	11888	P	20	0	20	0.00000
ERR982816_1_kneaddata_paired	Thermotogota	33086	P	18	0	18	0.00000
ERR982817_1_kneaddata_paired	Bacteroidota	4587	P	10096075	63745	10159820	0.51385
ERR982817_1_kneaddata_paired	Firmicutes_A	14608	P	8767926	24874	8792800	0.44471
ERR982817_1_kneaddata_paired	Verrucomicrobiota	33333	P	448700	10489	459189	0.02322
ERR982817_1_kneaddata_paired	Firmicutes	12188	P	195801	1009	196810	0.00995
ERR982817_1_kneaddata_paired	Desulfobacterota_A	11509	P	73599	666	74265	0.00376
ERR982817_1_kneaddata_paired	Actinobacteriota	615	P	66554	65	66619	0.00337
ERR982817_1_kneaddata_paired	Proteobacteria	22518	P	20009	15	20024	0.00101
ERR982817_1_kneaddata_paired	Cyanobacteria	9876	P	1157	13	1170	0.00006
ERR982817_1_kneaddata_paired	Spirochaetota	32587	P	457	0	457	0.00002
ERR982817_1_kneaddata_paired	Firmicutes_B	17289	P	369	5	374	0.00002
ERR982817_1_kneaddata_paired	Campylobacterota	8700	P	202	0	202	0.00001
ERR982817_1_kneaddata_paired	Deferribacterota	10822	P	124	0	124	0.00001
ERR982817_1_kneaddata_paired	Firmicutes_I	18140	P	112	0	112	0.00001
ERR982817_1_kneaddata_paired	Firmicutes_C	17613	P	111	0	111	0.00001
ERR982817_1_kneaddata_paired	Thermotogota	33086	P	21	0	21	0.00000
ERR982817_1_kneaddata_paired	Elusimicrobiota	11888	P	16	0	16	0.00000
ERR982818_1_kneaddata_paired	Firmicutes_A	14608	P	12507156	74689	12581845	0.81257
ERR982818_1_kneaddata_paired	Bacteroidota	4587	P	1599379	24585	1623964	0.10488
ERR982818_1_kneaddata_paired	Firmicutes	12188	P	976381	6898	983279	0.06350
ERR982818_1_kneaddata_paired	Desulfobacterota_A	11509	P	118697	2303	121000	0.00781
ERR982818_1_kneaddata_paired	Verrucomicrobiota	33333	P	78861	4623	83484	0.00539
ERR982818_1_kneaddata_paired	Actinobacteriota	615	P	53940	117	54057	0.00349
ERR982818_1_kneaddata_paired	Proteobacteria	22518	P	31850	130	31980	0.00207
ERR982818_1_kneaddata_paired	Cyanobacteria	9876	P	1680	26	1706	0.00011
ERR982818_1_kneaddata_paired	Firmicutes_B	17289	P	947	34	981	0.00006
ERR982818_1_kneaddata_paired	Spirochaetota	32587	P	929	0	929	0.00006
ERR982818_1_kneaddata_paired	Campylobacterota	8700	P	408	0	408	0.00003
ERR982818_1_kneaddata_paired	Firmicutes_C	17613	P	143	0	143	0.00001
ERR982818_1_kneaddata_paired	Firmicutes_I	18140	P	122	0	122	0.00001
ERR982818_1_kneaddata_paired	Deferribacterota	10822	P	77	0	77	0.00000
ERR982818_1_kneaddata_paired	Thermotogota	33086	P	19	0	19	0.00000
ERR982818_1_kneaddata_paired	Elusimicrobiota	11888	P	10	0	10	0.00000
ERR982819_1_kneaddata_paired	Bacteroidota	4587	P	12858299	15915	12874214	0.60519
ERR982819_1_kneaddata_paired	Firmicutes_A	14608	P	3157890	6844	3164734	0.14877
ERR982819_1_kneaddata_paired	Verrucomicrobiota	33333	P	2267896	30681	2298577	0.10805
ERR982819_1_kneaddata_paired	Firmicutes	12188	P	1878014	56775	1934789	0.09095
ERR982819_1_kneaddata_paired	Desulfobacterota_A	11509	P	461208	16906	478114	0.02248
ERR982819_1_kneaddata_paired	Actinobacteriota	615	P	326331	2363	328694	0.01545
ERR982819_1_kneaddata_paired	Proteobacteria	22518	P	92099	133	92232	0.00434
ERR982819_1_kneaddata_paired	Deferribacterota	10822	P	82580	70	82650	0.00389
ERR982819_1_kneaddata_paired	Cyanobacteria	9876	P	18185	231	18416	0.00087
ERR982819_1_kneaddata_paired	Spirochaetota	32587	P	290	0	290	0.00001
ERR982819_1_kneaddata_paired	Firmicutes_B	17289	P	225	1	226	0.00001
ERR982819_1_kneaddata_paired	Campylobacterota	8700	P	91	0	91	0.00000
ERR982819_1_kneaddata_paired	Firmicutes_I	18140	P	53	0	53	0.00000
ERR982819_1_kneaddata_paired	Firmicutes_C	17613	P	38	0	38	0.00000
ERR982819_1_kneaddata_paired	Elusimicrobiota	11888	P	8	0	8	0.00000
ERR982819_1_kneaddata_paired	Thermotogota	33086	P	2	0	2	0.00000
ERR982820_1_kneaddata_paired	Firmicutes_A	14608	P	10418743	17213	10435956	0.52898
ERR982820_1_kneaddata_paired	Bacteroidota	4587	P	2871032	9780	2880812	0.14602
ERR982820_1_kneaddata_paired	Firmicutes	12188	P	2719095	51438	2770533	0.14043
ERR982820_1_kneaddata_paired	Verrucomicrobiota	33333	P	2427608	34030	2461638	0.12478
ERR982820_1_kneaddata_paired	Desulfobacterota_A	11509	P	581004	21511	602515	0.03054
ERR982820_1_kneaddata_paired	Actinobacteriota	615	P	499530	3317	502847	0.02549
ERR982820_1_kneaddata_paired	Deferribacterota	10822	P	38339	33	38372	0.00195
ERR982820_1_kneaddata_paired	Firmicutes_B	17289	P	29074	251	29325	0.00149
ERR982820_1_kneaddata_paired	Proteobacteria	22518	P	4541	3	4544	0.00023
ERR982820_1_kneaddata_paired	Cyanobacteria	9876	P	871	5	876	0.00004
ERR982820_1_kneaddata_paired	Spirochaetota	32587	P	433	0	433	0.00002
ERR982820_1_kneaddata_paired	Campylobacterota	8700	P	182	0	182	0.00001
ERR982820_1_kneaddata_paired	Firmicutes_C	17613	P	161	0	161	0.00001
ERR982820_1_kneaddata_paired	Firmicutes_I	18140	P	113	0	113	0.00001
ERR982820_1_kneaddata_paired	Thermotogota	33086	P	14	0	14	0.00000
ERR982820_1_kneaddata_paired	Elusimicrobiota	11888	P	7	0	7	0.00000
ERR982821_1_kneaddata_paired	Firmicutes_A	14608	P	7414852	10917	7425769	0.51977
ERR982821_1_kneaddata_paired	Verrucomicrobiota	33333	P	2531227	41769	2572996	0.18010
ERR982821_1_kneaddata_paired	Firmicutes	12188	P	1840080	38191	1878271	0.13147
ERR982821_1_kneaddata_paired	Bacteroidota	4587	P	1725976	2242	1728218	0.12097
ERR982821_1_kneaddata_paired	Actinobacteriota	615	P	352168	2485	354653	0.02482
ERR982821_1_kneaddata_paired	Desulfobacterota_A	11509	P	194246	7622	201868	0.01413
ERR982821_1_kneaddata_paired	Firmicutes_B	17289	P	105962	1078	107040	0.00749
ERR982821_1_kneaddata_paired	Proteobacteria	22518	P	15958	16	15974	0.00112
ERR982821_1_kneaddata_paired	Cyanobacteria	9876	P	1090	6	1096	0.00008
ERR982821_1_kneaddata_paired	Spirochaetota	32587	P	359	0	359	0.00003
ERR982821_1_kneaddata_paired	Deferribacterota	10822	P	165	0	165	0.00001
ERR982821_1_kneaddata_paired	Campylobacterota	8700	P	124	0	124	0.00001
ERR982821_1_kneaddata_paired	Firmicutes_C	17613	P	110	0	110	0.00001
ERR982821_1_kneaddata_paired	Firmicutes_I	18140	P	97	0	97	0.00001
ERR982821_1_kneaddata_paired	Thermotogota	33086	P	19	0	19	0.00000
ERR982821_1_kneaddata_paired	Elusimicrobiota	11888	P	15	0	15	0.00000
ERR982822_1_kneaddata_paired	Bacteroidota	4587	P	13322605	18229	13340834	0.68844
ERR982822_1_kneaddata_paired	Firmicutes_A	14608	P	3070637	8856	3079493	0.15891
ERR982822_1_kneaddata_paired	Verrucomicrobiota	33333	P	1833220	37188	1870408	0.09652
ERR982822_1_kneaddata_paired	Firmicutes	12188	P	689320	28989	718309	0.03707
ERR982822_1_kneaddata_paired	Desulfobacterota_A	11509	P	264531	12711	277242	0.01431
ERR982822_1_kneaddata_paired	Deferribacterota	10822	P	51708	65	51773	0.00267
ERR982822_1_kneaddata_paired	Actinobacteriota	615	P	19796	21	19817	0.00102
ERR982822_1_kneaddata_paired	Proteobacteria	22518	P	15263	12	15275	0.00079
ERR982822_1_kneaddata_paired	Cyanobacteria	9876	P	4498	29	4527	0.00023
ERR982822_1_kneaddata_paired	Firmicutes_B	17289	P	236	2	238	0.00001
ERR982822_1_kneaddata_paired	Spirochaetota	32587	P	236	0	236	0.00001
ERR982822_1_kneaddata_paired	Campylobacterota	8700	P	113	0	113	0.00001
ERR982822_1_kneaddata_paired	Firmicutes_C	17613	P	58	0	58	0.00000
ERR982822_1_kneaddata_paired	Firmicutes_I	18140	P	50	0	50	0.00000
ERR982822_1_kneaddata_paired	Elusimicrobiota	11888	P	6	0	6	0.00000
ERR982822_1_kneaddata_paired	Thermotogota	33086	P	5	0	5	0.00000
ERR982823_1_kneaddata_paired	Firmicutes_A	14608	P	12494931	31637	12526568	0.69439
ERR982823_1_kneaddata_paired	Bacteroidota	4587	P	2022839	5275	2028114	0.11243
ERR982823_1_kneaddata_paired	Firmicutes	12188	P	1693756	40018	1733774	0.09611
ERR982823_1_kneaddata_paired	Verrucomicrobiota	33333	P	1227842	29862	1257704	0.06972
ERR982823_1_kneaddata_paired	Desulfobacterota_A	11509	P	324471	19771	344242	0.01908
ERR982823_1_kneaddata_paired	Actinobacteriota	615	P	82283	91	82374	0.00457
ERR982823_1_kneaddata_paired	Deferribacterota	10822	P	54611	83	54694	0.00303
ERR982823_1_kneaddata_paired	Firmicutes_B	17289	P	5384	80	5464	0.00030
ERR982823_1_kneaddata_paired	Proteobacteria	22518	P	4619	8	4627	0.00026
ERR982823_1_kneaddata_paired	Cyanobacteria	9876	P	1121	12	1133	0.00006
ERR982823_1_kneaddata_paired	Spirochaetota	32587	P	419	0	419	0.00002
ERR982823_1_kneaddata_paired	Campylobacterota	8700	P	190	0	190	0.00001
ERR982823_1_kneaddata_paired	Firmicutes_C	17613	P	147	0	147	0.00001
ERR982823_1_kneaddata_paired	Firmicutes_I	18140	P	128	0	128	0.00001
ERR982823_1_kneaddata_paired	Thermotogota	33086	P	20	0	20	0.00000
ERR982823_1_kneaddata_paired	Elusimicrobiota	11888	P	19	0	19	0.00000
ERR982824_1_kneaddata_paired	Firmicutes_A	14608	P	8219734	12795	8232529	0.53447
ERR982824_1_kneaddata_paired	Verrucomicrobiota	33333	P	2571240	45488	2616728	0.16988
ERR982824_1_kneaddata_paired	Bacteroidota	4587	P	2494389	4101	2498490	0.16221
ERR982824_1_kneaddata_paired	Firmicutes	12188	P	1035403	30590	1065993	0.06921
ERR982824_1_kneaddata_paired	Actinobacteriota	615	P	415049	3185	418234	0.02715
ERR982824_1_kneaddata_paired	Desulfobacterota_A	11509	P	375015	16864	391879	0.02544
ERR982824_1_kneaddata_paired	Firmicutes_B	17289	P	131815	1439	133254	0.00865
ERR982824_1_kneaddata_paired	Deferribacterota	10822	P	38491	42	38533	0.00250
ERR982824_1_kneaddata_paired	Proteobacteria	22518	P	5170	6	5176	0.00034
ERR982824_1_kneaddata_paired	Cyanobacteria	9876	P	1344	10	1354	0.00009
ERR982824_1_kneaddata_paired	Spirochaetota	32587	P	425	0	425	0.00003
ERR982824_1_kneaddata_paired	Firmicutes_C	17613	P	175	0	175	0.00001
ERR982824_1_kneaddata_paired	Campylobacterota	8700	P	171	0	171	0.00001
ERR982824_1_kneaddata_paired	Firmicutes_I	18140	P	82	0	82	0.00001
ERR982824_1_kneaddata_paired	Elusimicrobiota	11888	P	12	0	12	0.00000
ERR982824_1_kneaddata_paired	Thermotogota	33086	P	9	0	9	0.00000
ERR982825_1_kneaddata_paired	Bacteroidota	4587	P	8955716	8523	8964239	0.53409
ERR982825_1_kneaddata_paired	Firmicutes_A	14608	P	3257646	5128	3262774	0.19439
ERR982825_1_kneaddata_paired	Firmicutes	12188	P	1904025	58771	1962796	0.11694
ERR982825_1_kneaddata_paired	Verrucomicrobiota	33333	P	1733674	23384	1757058	0.10468
ERR982825_1_kneaddata_paired	Actinobacteriota	615	P	457717	3051	460768	0.02745
ERR982825_1_kneaddata_paired	Desulfobacterota_A	11509	P	241141	8375	249516	0.01487
ERR982825_1_kneaddata_paired	Deferribacterota	10822	P	75634	64	75698	0.00451
ERR982825_1_kneaddata_paired	Proteobacteria	22518	P	49449	66	49515	0.00295
ERR982825_1_kneaddata_paired	Cyanobacteria	9876	P	1239	8	1247	0.00007
ERR982825_1_kneaddata_paired	Spirochaetota	32587	P	347	0	347	0.00002
ERR982825_1_kneaddata_paired	Firmicutes_B	17289	P	143	1	144	0.00001
ERR982825_1_kneaddata_paired	Campylobacterota	8700	P	65	0	65	0.00000
ERR982825_1_kneaddata_paired	Firmicutes_I	18140	P	48	0	48	0.00000
ERR982825_1_kneaddata_paired	Firmicutes_C	17613	P	47	0	47	0.00000
ERR982825_1_kneaddata_paired	Elusimicrobiota	11888	P	13	0	13	0.00000
ERR982825_1_kneaddata_paired	Thermotogota	33086	P	3	0	3	0.00000
ERR982826_1_kneaddata_paired	Firmicutes_A	14608	P	9748695	25720	9774415	0.53080
ERR982826_1_kneaddata_paired	Bacteroidota	4587	P	3141020	8396	3149416	0.17103
ERR982826_1_kneaddata_paired	Verrucomicrobiota	33333	P	2855196	76354	2931550	0.15920
ERR982826_1_kneaddata_paired	Firmicutes	12188	P	2018768	35122	2053890	0.11154
ERR982826_1_kneaddata_paired	Desulfobacterota_A	11509	P	272270	18305	290575	0.01578
ERR982826_1_kneaddata_paired	Actinobacteriota	615	P	97056	400	97456	0.00529
ERR982826_1_kneaddata_paired	Firmicutes_B	17289	P	55696	919	56615	0.00307
ERR982826_1_kneaddata_paired	Deferribacterota	10822	P	50385	84	50469	0.00274
ERR982826_1_kneaddata_paired	Proteobacteria	22518	P	7136	15	7151	0.00039
ERR982826_1_kneaddata_paired	Cyanobacteria	9876	P	1733	18	1751	0.00010
ERR982826_1_kneaddata_paired	Campylobacterota	8700	P	501	0	501	0.00003
ERR982826_1_kneaddata_paired	Spirochaetota	32587	P	457	0	457	0.00002
ERR982826_1_kneaddata_paired	Firmicutes_C	17613	P	144	0	144	0.00001
ERR982826_1_kneaddata_paired	Firmicutes_I	18140	P	142	0	142	0.00001
ERR982826_1_kneaddata_paired	Elusimicrobiota	11888	P	16	0	16	0.00000
ERR982826_1_kneaddata_paired	Thermotogota	33086	P	11	0	11	0.00000
ERR982827_1_kneaddata_paired	Firmicutes_A	14608	P	12673547	26285	12699832	0.52237
ERR982827_1_kneaddata_paired	Verrucomicrobiota	33333	P	4257856	80398	4338254	0.17844
ERR982827_1_kneaddata_paired	Bacteroidota	4587	P	3671877	8529	3680406	0.15138
ERR982827_1_kneaddata_paired	Firmicutes	12188	P	2796612	37587	2834199	0.11658
ERR982827_1_kneaddata_paired	Desulfobacterota_A	11509	P	456009	22152	478161	0.01967
ERR982827_1_kneaddata_paired	Actinobacteriota	615	P	176830	882	177712	0.00731
ERR982827_1_kneaddata_paired	Deferribacterota	10822	P	86383	102	86485	0.00356
ERR982827_1_kneaddata_paired	Proteobacteria	22518	P	12858	16	12874	0.00053
ERR982827_1_kneaddata_paired	Cyanobacteria	9876	P	1927	14	1941	0.00008
ERR982827_1_kneaddata_paired	Firmicutes_B	17289	P	877	10	887	0.00004
ERR982827_1_kneaddata_paired	Spirochaetota	32587	P	511	0	511	0.00002
ERR982827_1_kneaddata_paired	Campylobacterota	8700	P	201	0	201	0.00001
ERR982827_1_kneaddata_paired	Firmicutes_C	17613	P	183	0	183	0.00001
ERR982827_1_kneaddata_paired	Firmicutes_I	18140	P	125	0	125	0.00001
ERR982827_1_kneaddata_paired	Elusimicrobiota	11888	P	21	0	21	0.00000
ERR982827_1_kneaddata_paired	Thermotogota	33086	P	8	0	8	0.00000
ERR982828_1_kneaddata_paired	Bacteroidota	4587	P	13216085	11259	13227344	0.57803
ERR982828_1_kneaddata_paired	Verrucomicrobiota	33333	P	3393674	44643	3438317	0.15025
ERR982828_1_kneaddata_paired	Firmicutes_A	14608	P	2964124	5164	2969288	0.12976
ERR982828_1_kneaddata_paired	Firmicutes	12188	P	2199697	65691	2265388	0.09900
ERR982828_1_kneaddata_paired	Actinobacteriota	615	P	482582	3366	485948	0.02124
ERR982828_1_kneaddata_paired	Desulfobacterota_A	11509	P	255276	8494	263770	0.01153
ERR982828_1_kneaddata_paired	Proteobacteria	22518	P	178307	243	178550	0.00780
ERR982828_1_kneaddata_paired	Deferribacterota	10822	P	51806	42	51848	0.00227
ERR982828_1_kneaddata_paired	Cyanobacteria	9876	P	2222	11	2233	0.00010
ERR982828_1_kneaddata_paired	Firmicutes_B	17289	P	206	1	207	0.00001
ERR982828_1_kneaddata_paired	Spirochaetota	32587	P	181	0	181	0.00001
ERR982828_1_kneaddata_paired	Campylobacterota	8700	P	103	0	103	0.00000
ERR982828_1_kneaddata_paired	Firmicutes_C	17613	P	64	0	64	0.00000
ERR982828_1_kneaddata_paired	Firmicutes_I	18140	P	51	0	51	0.00000
ERR982828_1_kneaddata_paired	Elusimicrobiota	11888	P	9	0	9	0.00000
ERR982828_1_kneaddata_paired	Thermotogota	33086	P	1	0	1	0.00000
ERR982829_1_kneaddata_paired	Bacteroidota	4587	P	12252374	37867	12290241	0.60430
ERR982829_1_kneaddata_paired	Firmicutes_A	14608	P	5839507	11894	5851401	0.28771
ERR982829_1_kneaddata_paired	Verrucomicrobiota	33333	P	918280	14134	932414	0.04585
ERR982829_1_kneaddata_paired	Firmicutes	12188	P	675738	22007	697745	0.03431
ERR982829_1_kneaddata_paired	Proteobacteria	22518	P	264812	320	265132	0.01304
ERR982829_1_kneaddata_paired	Firmicutes_B	17289	P	173863	1651	175514	0.00863
ERR982829_1_kneaddata_paired	Desulfobacterota_A	11509	P	107170	226	107396	0.00528
ERR982829_1_kneaddata_paired	Actinobacteriota	615	P	14495	7	14502	0.00071
ERR982829_1_kneaddata_paired	Cyanobacteria	9876	P	2319	8	2327	0.00011
ERR982829_1_kneaddata_paired	Spirochaetota	32587	P	839	0	839	0.00004
ERR982829_1_kneaddata_paired	Campylobacterota	8700	P	282	0	282	0.00001
ERR982829_1_kneaddata_paired	Deferribacterota	10822	P	97	0	97	0.00000
ERR982829_1_kneaddata_paired	Firmicutes_C	17613	P	55	0	55	0.00000
ERR982829_1_kneaddata_paired	Firmicutes_I	18140	P	36	0	36	0.00000
ERR982829_1_kneaddata_paired	Elusimicrobiota	11888	P	5	0	5	0.00000
ERR982829_1_kneaddata_paired	Thermotogota	33086	P	5	0	5	0.00000
ERR982830_1_kneaddata_paired	Firmicutes_A	14608	P	8406619	25872	8432491	0.59466
ERR982830_1_kneaddata_paired	Bacteroidota	4587	P	3129105	8319	3137424	0.22125
ERR982830_1_kneaddata_paired	Verrucomicrobiota	33333	P	1891352	50107	1941459	0.13691
ERR982830_1_kneaddata_paired	Firmicutes	12188	P	312799	1223	314022	0.02215
ERR982830_1_kneaddata_paired	Desulfobacterota_A	11509	P	214904	13766	228670	0.01613
ERR982830_1_kneaddata_paired	Actinobacteriota	615	P	64583	82	64665	0.00456
ERR982830_1_kneaddata_paired	Deferribacterota	10822	P	52643	87	52730	0.00372
ERR982830_1_kneaddata_paired	Proteobacteria	22518	P	5402	9	5411	0.00038
ERR982830_1_kneaddata_paired	Cyanobacteria	9876	P	1623	20	1643	0.00012
ERR982830_1_kneaddata_paired	Firmicutes_B	17289	P	966	15	981	0.00007
ERR982830_1_kneaddata_paired	Spirochaetota	32587	P	307	0	307	0.00002
ERR982830_1_kneaddata_paired	Campylobacterota	8700	P	182	0	182	0.00001
ERR982830_1_kneaddata_paired	Firmicutes_C	17613	P	154	0	154	0.00001
ERR982830_1_kneaddata_paired	Firmicutes_I	18140	P	73	0	73	0.00001
ERR982830_1_kneaddata_paired	Thermotogota	33086	P	18	0	18	0.00000
ERR982830_1_kneaddata_paired	Elusimicrobiota	11888	P	15	0	15	0.00000
ERR982831_1_kneaddata_paired	Firmicutes_A	14608	P	6341903	8906	6350809	0.41102
ERR982831_1_kneaddata_paired	Bacteroidota	4587	P	3033413	5307	3038720	0.19666
ERR982831_1_kneaddata_paired	Verrucomicrobiota	33333	P	2592181	41049	2633230	0.17042
ERR982831_1_kneaddata_paired	Firmicutes	12188	P	2546494	53796	2600290	0.16829
ERR982831_1_kneaddata_paired	Actinobacteriota	615	P	422546	3348	425894	0.02756
ERR982831_1_kneaddata_paired	Desulfobacterota_A	11509	P	332086	13740	345826	0.02238
ERR982831_1_kneaddata_paired	Deferribacterota	10822	P	36415	36	36451	0.00236
ERR982831_1_kneaddata_paired	Firmicutes_B	17289	P	14914	145	15059	0.00097
ERR982831_1_kneaddata_paired	Proteobacteria	22518	P	2909	3	2912	0.00019
ERR982831_1_kneaddata_paired	Cyanobacteria	9876	P	1308	9	1317	0.00009
ERR982831_1_kneaddata_paired	Spirochaetota	32587	P	413	0	413	0.00003
ERR982831_1_kneaddata_paired	Campylobacterota	8700	P	167	0	167	0.00001
ERR982831_1_kneaddata_paired	Firmicutes_C	17613	P	157	0	157	0.00001
ERR982831_1_kneaddata_paired	Firmicutes_I	18140	P	125	0	125	0.00001
ERR982831_1_kneaddata_paired	Elusimicrobiota	11888	P	12	0	12	0.00000
ERR982831_1_kneaddata_paired	Thermotogota	33086	P	7	0	7	0.00000
ERR982832_1_kneaddata_paired	Bacteroidota	4587	P	14273569	21204	14294773	0.57577
ERR982832_1_kneaddata_paired	Firmicutes_A	14608	P	6226278	19080	6245358	0.25155
ERR982832_1_kneaddata_paired	Verrucomicrobiota	33333	P	2067324	40581	2107905	0.08490
ERR982832_1_kneaddata_paired	Firmicutes	12188	P	1280641	56179	1336820	0.05384
ERR982832_1_kneaddata_paired	Desulfobacterota_A	11509	P	350284	17144	367428	0.01480
ERR982832_1_kneaddata_paired	Actinobacteriota	615	P	227764	2259	230023	0.00926
ERR982832_1_kneaddata_paired	Deferribacterota	10822	P	206544	254	206798	0.00833
ERR982832_1_kneaddata_paired	Proteobacteria	22518	P	34252	34	34286	0.00138
ERR982832_1_kneaddata_paired	Cyanobacteria	9876	P	2794	36	2830	0.00011
ERR982832_1_kneaddata_paired	Firmicutes_B	17289	P	409	4	413	0.00002
ERR982832_1_kneaddata_paired	Spirochaetota	32587	P	376	0	376	0.00002
ERR982832_1_kneaddata_paired	Campylobacterota	8700	P	86	0	86	0.00000
ERR982832_1_kneaddata_paired	Firmicutes_I	18140	P	72	0	72	0.00000
ERR982832_1_kneaddata_paired	Firmicutes_C	17613	P	62	0	62	0.00000
ERR982832_1_kneaddata_paired	Elusimicrobiota	11888	P	24	0	24	0.00000
ERR982832_1_kneaddata_paired	Thermotogota	33086	P	1	0	1	0.00000
ERR982833_1_kneaddata_paired	Firmicutes_A	14608	P	12404192	56568	12460760	0.70464
ERR982833_1_kneaddata_paired	Bacteroidota	4587	P	2320939	6915	2327854	0.13164
ERR982833_1_kneaddata_paired	Firmicutes	12188	P	1633994	9767	1643761	0.09295
ERR982833_1_kneaddata_paired	Verrucomicrobiota	33333	P	746290	31184	777474	0.04396
ERR982833_1_kneaddata_paired	Desulfobacterota_A	11509	P	322408	32795	355203	0.02009
ERR982833_1_kneaddata_paired	Actinobacteriota	615	P	86213	175	86388	0.00489
ERR982833_1_kneaddata_paired	Proteobacteria	22518	P	28024	41	28065	0.00159
ERR982833_1_kneaddata_paired	Cyanobacteria	9876	P	1614	26	1640	0.00009
ERR982833_1_kneaddata_paired	Firmicutes_B	17289	P	962	24	986	0.00006
ERR982833_1_kneaddata_paired	Campylobacterota	8700	P	830	0	830	0.00005
ERR982833_1_kneaddata_paired	Spirochaetota	32587	P	379	0	379	0.00002
ERR982833_1_kneaddata_paired	Firmicutes_C	17613	P	204	0	204	0.00001
ERR982833_1_kneaddata_paired	Deferribacterota	10822	P	184	0	184	0.00001
ERR982833_1_kneaddata_paired	Firmicutes_I	18140	P	147	0	147	0.00001
ERR982833_1_kneaddata_paired	Elusimicrobiota	11888	P	34	0	34	0.00000
ERR982833_1_kneaddata_paired	Thermotogota	33086	P	28	0	28	0.00000
ERR982834_1_kneaddata_paired	Bacteroidota	4587	P	11447031	20170	11467201	0.71648
ERR982834_1_kneaddata_paired	Firmicutes_A	14608	P	3040244	11630	3051874	0.19068
ERR982834_1_kneaddata_paired	Verrucomicrobiota	33333	P	774881	20435	795316	0.04969
ERR982834_1_kneaddata_paired	Firmicutes	12188	P	347867	18026	365893	0.02286
ERR982834_1_kneaddata_paired	Desulfobacterota_A	11509	P	198211	11064	209275	0.01308
ERR982834_1_kneaddata_paired	Actinobacteriota	615	P	86877	1096	87973	0.00550
ERR982834_1_kneaddata_paired	Deferribacterota	10822	P	14183	23	14206	0.00089
ERR982834_1_kneaddata_paired	Cyanobacteria	9876	P	7944	31	7975	0.00050
ERR982834_1_kneaddata_paired	Proteobacteria	22518	P	4531	7	4538	0.00028
ERR982834_1_kneaddata_paired	Firmicutes_B	17289	P	452	7	459	0.00003
ERR982834_1_kneaddata_paired	Spirochaetota	32587	P	127	0	127	0.00001
ERR982834_1_kneaddata_paired	Campylobacterota	8700	P	60	0	60	0.00000
ERR982834_1_kneaddata_paired	Firmicutes_I	18140	P	43	0	43	0.00000
ERR982834_1_kneaddata_paired	Firmicutes_C	17613	P	42	0	42	0.00000
ERR982834_1_kneaddata_paired	Elusimicrobiota	11888	P	11	0	11	0.00000
ERR982834_1_kneaddata_paired	Thermotogota	33086	P	4	0	4	0.00000
ERR982835_1_kneaddata_paired	Firmicutes_A	14608	P	12854008	28422	12882430	0.66250
ERR982835_1_kneaddata_paired	Bacteroidota	4587	P	2094321	5234	2099555	0.10797
ERR982835_1_kneaddata_paired	Verrucomicrobiota	33333	P	1750264	41295	1791559	0.09213
ERR982835_1_kneaddata_paired	Firmicutes	12188	P	1723291	49626	1772917	0.09117
ERR982835_1_kneaddata_paired	Desulfobacterota_A	11509	P	520915	31277	552192	0.02840
ERR982835_1_kneaddata_paired	Deferribacterota	10822	P	165100	245	165345	0.00850
ERR982835_1_kneaddata_paired	Actinobacteriota	615	P	134225	144	134369	0.00691
ERR982835_1_kneaddata_paired	Firmicutes_B	17289	P	39825	579	40404	0.00208
ERR982835_1_kneaddata_paired	Proteobacteria	22518	P	4301	11	4312	0.00022
ERR982835_1_kneaddata_paired	Cyanobacteria	9876	P	1012	8	1020	0.00005
ERR982835_1_kneaddata_paired	Spirochaetota	32587	P	612	0	612	0.00003
ERR982835_1_kneaddata_paired	Firmicutes_C	17613	P	197	0	197	0.00001
ERR982835_1_kneaddata_paired	Campylobacterota	8700	P	174	0	174	0.00001
ERR982835_1_kneaddata_paired	Firmicutes_I	18140	P	123	0	123	0.00001
ERR982835_1_kneaddata_paired	Elusimicrobiota	11888	P	10	0	10	0.00000
ERR982835_1_kneaddata_paired	Thermotogota	33086	P	1	0	1	0.00000
ERR982836_1_kneaddata_paired	Firmicutes_A	14608	P	10812323	25697	10838020	0.69046
ERR982836_1_kneaddata_paired	Bacteroidota	4587	P	1881422	4890	1886312	0.12017
ERR982836_1_kneaddata_paired	Verrucomicrobiota	33333	P	1843076	46199	1889275	0.12036
ERR982836_1_kneaddata_paired	Desulfobacterota_A	11509	P	427260	27021	454281	0.02894
ERR982836_1_kneaddata_paired	Firmicutes	12188	P	413379	9573	422952	0.02695
ERR982836_1_kneaddata_paired	Deferribacterota	10822	P	106146	167	106313	0.00677
ERR982836_1_kneaddata_paired	Actinobacteriota	615	P	93566	179	93745	0.00597
ERR982836_1_kneaddata_paired	Proteobacteria	22518	P	2428	4	2432	0.00015
ERR982836_1_kneaddata_paired	Firmicutes_B	17289	P	1274	19	1293	0.00008
ERR982836_1_kneaddata_paired	Cyanobacteria	9876	P	1028	11	1039	0.00007
ERR982836_1_kneaddata_paired	Spirochaetota	32587	P	540	0	540	0.00003
ERR982836_1_kneaddata_paired	Campylobacterota	8700	P	214	0	214	0.00001
ERR982836_1_kneaddata_paired	Firmicutes_C	17613	P	146	0	146	0.00001
ERR982836_1_kneaddata_paired	Firmicutes_I	18140	P	122	0	122	0.00001
ERR982836_1_kneaddata_paired	Thermotogota	33086	P	25	0	25	0.00000
ERR982836_1_kneaddata_paired	Elusimicrobiota	11888	P	22	0	22	0.00000
ERR982837_1_kneaddata_paired	Bacteroidota	4587	P	12442348	20980	12463328	0.71976
ERR982837_1_kneaddata_paired	Firmicutes_A	14608	P	3345494	15362	3360856	0.19409
ERR982837_1_kneaddata_paired	Verrucomicrobiota	33333	P	990172	26344	1016516	0.05870
ERR982837_1_kneaddata_paired	Desulfobacterota_A	11509	P	254316	16210	270526	0.01562
ERR982837_1_kneaddata_paired	Firmicutes	12188	P	70996	372	71368	0.00412
ERR982837_1_kneaddata_paired	Proteobacteria	22518	P	62753	159	62912	0.00363
ERR982837_1_kneaddata_paired	Deferribacterota	10822	P	42844	71	42915	0.00248
ERR982837_1_kneaddata_paired	Actinobacteriota	615	P	21039	33	21072	0.00122
ERR982837_1_kneaddata_paired	Cyanobacteria	9876	P	5685	59	5744	0.00033
ERR982837_1_kneaddata_paired	Spirochaetota	32587	P	187	0	187	0.00001
ERR982837_1_kneaddata_paired	Firmicutes_B	17289	P	176	2	178	0.00001
ERR982837_1_kneaddata_paired	Campylobacterota	8700	P	158	0	158	0.00001
ERR982837_1_kneaddata_paired	Firmicutes_I	18140	P	89	0	89	0.00001
ERR982837_1_kneaddata_paired	Firmicutes_C	17613	P	34	0	34	0.00000
ERR982837_1_kneaddata_paired	Elusimicrobiota	11888	P	19	0	19	0.00000
ERR982837_1_kneaddata_paired	Thermotogota	33086	P	8	0	8	0.00000
ERR982838_1_kneaddata_paired	Firmicutes_A	14608	P	6987262	9961	6997223	0.51509
ERR982838_1_kneaddata_paired	Bacteroidota	4587	P	2130220	8298	2138518	0.15742
ERR982838_1_kneaddata_paired	Firmicutes	12188	P	1765357	38000	1803357	0.13275
ERR982838_1_kneaddata_paired	Verrucomicrobiota	33333	P	1705317	26524	1731841	0.12749
ERR982838_1_kneaddata_paired	Actinobacteriota	615	P	560073	4113	564186	0.04153
ERR982838_1_kneaddata_paired	Desulfobacterota_A	11509	P	268451	10381	278832	0.02053
ERR982838_1_kneaddata_paired	Deferribacterota	10822	P	47749	46	47795	0.00352
ERR982838_1_kneaddata_paired	Firmicutes_B	17289	P	16876	162	17038	0.00125
ERR982838_1_kneaddata_paired	Proteobacteria	22518	P	4324	4	4328	0.00032
ERR982838_1_kneaddata_paired	Cyanobacteria	9876	P	687	5	692	0.00005
ERR982838_1_kneaddata_paired	Spirochaetota	32587	P	405	0	405	0.00003
ERR982838_1_kneaddata_paired	Campylobacterota	8700	P	108	0	108	0.00001
ERR982838_1_kneaddata_paired	Firmicutes_I	18140	P	81	0	81	0.00001
ERR982838_1_kneaddata_paired	Firmicutes_C	17613	P	80	0	80	0.00001
ERR982838_1_kneaddata_paired	Thermotogota	33086	P	15	0	15	0.00000
ERR982838_1_kneaddata_paired	Elusimicrobiota	11888	P	11	0	11	0.00000
ERR982839_1_kneaddata_paired	Firmicutes_A	14608	P	12327771	42556	12370327	0.66160
ERR982839_1_kneaddata_paired	Bacteroidota	4587	P	5188872	54038	5242910	0.28040
ERR982839_1_kneaddata_paired	Firmicutes	12188	P	716065	3018	719083	0.03846
ERR982839_1_kneaddata_paired	Verrucomicrobiota	33333	P	220126	7010	227136	0.01215
ERR982839_1_kneaddata_paired	Actinobacteriota	615	P	65961	71	66032	0.00353
ERR982839_1_kneaddata_paired	Desulfobacterota_A	11509	P	59662	1021	60683	0.00325
ERR982839_1_kneaddata_paired	Proteobacteria	22518	P	7771	29	7800	0.00042
ERR982839_1_kneaddata_paired	Cyanobacteria	9876	P	1353	18	1371	0.00007
ERR982839_1_kneaddata_paired	Firmicutes_B	17289	P	899	17	916	0.00005
ERR982839_1_kneaddata_paired	Spirochaetota	32587	P	682	0	682	0.00004
ERR982839_1_kneaddata_paired	Campylobacterota	8700	P	267	0	267	0.00001
ERR982839_1_kneaddata_paired	Deferribacterota	10822	P	207	0	207	0.00001
ERR982839_1_kneaddata_paired	Firmicutes_C	17613	P	137	0	137	0.00001
ERR982839_1_kneaddata_paired	Firmicutes_I	18140	P	82	0	82	0.00000
ERR982839_1_kneaddata_paired	Elusimicrobiota	11888	P	15	0	15	0.00000
ERR982839_1_kneaddata_paired	Thermotogota	33086	P	14	0	14	0.00000
ERR982840_1_kneaddata_paired	Firmicutes_A	14608	P	11792384	28088	11820472	0.67057
ERR982840_1_kneaddata_paired	Bacteroidota	4587	P	2783143	6792	2789935	0.15827
ERR982840_1_kneaddata_paired	Firmicutes	12188	P	1136722	26711	1163433	0.06600
ERR982840_1_kneaddata_paired	Verrucomicrobiota	33333	P	1088607	26926	1115533	0.06328
ERR982840_1_kneaddata_paired	Desulfobacterota_A	11509	P	417829	26316	444145	0.02520
ERR982840_1_kneaddata_paired	Deferribacterota	10822	P	117461	182	117643	0.00667
ERR982840_1_kneaddata_paired	Firmicutes_B	17289	P	95931	1464	97395	0.00553
ERR982840_1_kneaddata_paired	Actinobacteriota	615	P	72635	103	72738	0.00413
ERR982840_1_kneaddata_paired	Proteobacteria	22518	P	3998	6	4004	0.00023
ERR982840_1_kneaddata_paired	Cyanobacteria	9876	P	1049	10	1059	0.00006
ERR982840_1_kneaddata_paired	Spirochaetota	32587	P	527	0	527	0.00003
ERR982840_1_kneaddata_paired	Campylobacterota	8700	P	267	0	267	0.00002
ERR982840_1_kneaddata_paired	Firmicutes_C	17613	P	142	0	142	0.00001
ERR982840_1_kneaddata_paired	Firmicutes_I	18140	P	97	0	97	0.00001
ERR982840_1_kneaddata_paired	Elusimicrobiota	11888	P	18	0	18	0.00000
ERR982840_1_kneaddata_paired	Thermotogota	33086	P	2	0	2	0.00000
ERR982841_1_kneaddata_paired	Firmicutes_A	14608	P	11310155	26235	11336390	0.65762
ERR982841_1_kneaddata_paired	Bacteroidota	4587	P	3177742	8457	3186199	0.18483
ERR982841_1_kneaddata_paired	Verrucomicrobiota	33333	P	1869711	45599	1915310	0.11111
ERR982841_1_kneaddata_paired	Desulfobacterota_A	11509	P	323476	19717	343193	0.01991
ERR982841_1_kneaddata_paired	Firmicutes	12188	P	293299	1139	294438	0.01708
ERR982841_1_kneaddata_paired	Actinobacteriota	615	P	93655	128	93783	0.00544
ERR982841_1_kneaddata_paired	Deferribacterota	10822	P	49197	75	49272	0.00286
ERR982841_1_kneaddata_paired	Firmicutes_B	17289	P	13257	199	13456	0.00078
ERR982841_1_kneaddata_paired	Proteobacteria	22518	P	4239	8	4247	0.00025
ERR982841_1_kneaddata_paired	Cyanobacteria	9876	P	1351	19	1370	0.00008
ERR982841_1_kneaddata_paired	Spirochaetota	32587	P	451	0	451	0.00003
ERR982841_1_kneaddata_paired	Campylobacterota	8700	P	157	0	157	0.00001
ERR982841_1_kneaddata_paired	Firmicutes_C	17613	P	127	0	127	0.00001
ERR982841_1_kneaddata_paired	Firmicutes_I	18140	P	106	0	106	0.00001
ERR982841_1_kneaddata_paired	Elusimicrobiota	11888	P	18	0	18	0.00000
ERR982841_1_kneaddata_paired	Thermotogota	33086	P	18	0	18	0.00000
ERR982842_1_kneaddata_paired	Firmicutes_A	14608	P	10865798	15949	10881747	0.49791
ERR982842_1_kneaddata_paired	Bacteroidota	4587	P	3566846	6433	3573279	0.16350
ERR982842_1_kneaddata_paired	Verrucomicrobiota	33333	P	3314092	52324	3366416	0.15404
ERR982842_1_kneaddata_paired	Firmicutes	12188	P	2739694	65105	2804799	0.12834
ERR982842_1_kneaddata_paired	Actinobacteriota	615	P	788169	5930	794099	0.03634
ERR982842_1_kneaddata_paired	Desulfobacterota_A	11509	P	353677	13981	367658	0.01682
ERR982842_1_kneaddata_paired	Deferribacterota	10822	P	48854	48	48902	0.00224
ERR982842_1_kneaddata_paired	Firmicutes_B	17289	P	8533	83	8616	0.00039
ERR982842_1_kneaddata_paired	Proteobacteria	22518	P	6732	7	6739	0.00031
ERR982842_1_kneaddata_paired	Cyanobacteria	9876	P	1289	8	1297	0.00006
ERR982842_1_kneaddata_paired	Spirochaetota	32587	P	625	0	625	0.00003
ERR982842_1_kneaddata_paired	Campylobacterota	8700	P	216	0	216	0.00001
ERR982842_1_kneaddata_paired	Firmicutes_C	17613	P	137	0	137	0.00001
ERR982842_1_kneaddata_paired	Firmicutes_I	18140	P	128	0	128	0.00001
ERR982842_1_kneaddata_paired	Elusimicrobiota	11888	P	23	0	23	0.00000
ERR982842_1_kneaddata_paired	Thermotogota	33086	P	18	0	18	0.00000
ERR982843_1_kneaddata_paired	Firmicutes_A	14608	P	12120542	51353	12171895	0.74401
ERR982843_1_kneaddata_paired	Bacteroidota	4587	P	3412125	15104	3427229	0.20949
ERR982843_1_kneaddata_paired	Desulfobacterota_A	11509	P	288996	29005	318001	0.01944
ERR982843_1_kneaddata_paired	Firmicutes	12188	P	235062	1533	236595	0.01446
ERR982843_1_kneaddata_paired	Deferribacterota	10822	P	107554	289	107843	0.00659
ERR982843_1_kneaddata_paired	Actinobacteriota	615	P	44689	91	44780	0.00274
ERR982843_1_kneaddata_paired	Verrucomicrobiota	33333	P	43461	1873	45334	0.00277
ERR982843_1_kneaddata_paired	Proteobacteria	22518	P	5630	20	5650	0.00035
ERR982843_1_kneaddata_paired	Cyanobacteria	9876	P	1014	21	1035	0.00006
ERR982843_1_kneaddata_paired	Firmicutes_B	17289	P	558	14	572	0.00004
ERR982843_1_kneaddata_paired	Spirochaetota	32587	P	488	0	488	0.00003
ERR982843_1_kneaddata_paired	Campylobacterota	8700	P	178	0	178	0.00001
ERR982843_1_kneaddata_paired	Firmicutes_I	18140	P	122	0	122	0.00001
ERR982843_1_kneaddata_paired	Firmicutes_C	17613	P	116	0	116	0.00001
ERR982843_1_kneaddata_paired	Elusimicrobiota	11888	P	21	0	21	0.00000
ERR982843_1_kneaddata_paired	Thermotogota	33086	P	20	0	20	0.00000
ERR982844_1_kneaddata_paired	Firmicutes_A	14608	P	10648086	22223	10670309	0.54926
ERR982844_1_kneaddata_paired	Bacteroidota	4587	P	3621751	9356	3631107	0.18691
ERR982844_1_kneaddata_paired	Verrucomicrobiota	33333	P	3038820	61445	3100265	0.15959
ERR982844_1_kneaddata_paired	Firmicutes	12188	P	1129847	2772	1132619	0.05830
ERR982844_1_kneaddata_paired	Desulfobacterota_A	11509	P	612940	32484	645424	0.03322
ERR982844_1_kneaddata_paired	Actinobacteriota	615	P	149406	101	149507	0.00770
ERR982844_1_kneaddata_paired	Deferribacterota	10822	P	90121	114	90235	0.00464
ERR982844_1_kneaddata_paired	Proteobacteria	22518	P	2975	4	2979	0.00015
ERR982844_1_kneaddata_paired	Cyanobacteria	9876	P	1848	15	1863	0.00010
ERR982844_1_kneaddata_paired	Firmicutes_B	17289	P	1102	13	1115	0.00006
ERR982844_1_kneaddata_paired	Spirochaetota	32587	P	548	0	548	0.00003
ERR982844_1_kneaddata_paired	Campylobacterota	8700	P	290	0	290	0.00001
ERR982844_1_kneaddata_paired	Firmicutes_C	17613	P	150	0	150	0.00001
ERR982844_1_kneaddata_paired	Firmicutes_I	18140	P	118	0	118	0.00001
ERR982844_1_kneaddata_paired	Elusimicrobiota	11888	P	28	0	28	0.00000
ERR982844_1_kneaddata_paired	Thermotogota	33086	P	12	0	12	0.00000
ERR982845_1_kneaddata_paired	Firmicutes_A	14608	P	8004776	23717	8028493	0.54087
ERR982845_1_kneaddata_paired	Bacteroidota	4587	P	6295856	56501	6352357	0.42795
ERR982845_1_kneaddata_paired	Firmicutes	12188	P	318407	1202	319609	0.02153
ERR982845_1_kneaddata_paired	Desulfobacterota_A	11509	P	97295	579	97874	0.00659
ERR982845_1_kneaddata_paired	Actinobacteriota	615	P	23028	23	23051	0.00155
ERR982845_1_kneaddata_paired	Verrucomicrobiota	33333	P	10246	285	10531	0.00071
ERR982845_1_kneaddata_paired	Proteobacteria	22518	P	7244	14	7258	0.00049
ERR982845_1_kneaddata_paired	Cyanobacteria	9876	P	2464	15	2479	0.00017
ERR982845_1_kneaddata_paired	Spirochaetota	32587	P	905	0	905	0.00006
ERR982845_1_kneaddata_paired	Firmicutes_B	17289	P	647	11	658	0.00004
ERR982845_1_kneaddata_paired	Campylobacterota	8700	P	137	0	137	0.00001
ERR982845_1_kneaddata_paired	Deferribacterota	10822	P	119	0	119	0.00001
ERR982845_1_kneaddata_paired	Firmicutes_C	17613	P	111	0	111	0.00001
ERR982845_1_kneaddata_paired	Firmicutes_I	18140	P	66	0	66	0.00000
ERR982845_1_kneaddata_paired	Thermotogota	33086	P	19	0	19	0.00000
ERR982845_1_kneaddata_paired	Elusimicrobiota	11888	P	2	0	2	0.00000
ERR982846_1_kneaddata_paired	Bacteroidota	4587	P	10204897	49141	10254038	0.55304
ERR982846_1_kneaddata_paired	Firmicutes_A	14608	P	6968508	21584	6990092	0.37701
ERR982846_1_kneaddata_paired	Verrucomicrobiota	33333	P	490262	11720	501982	0.02707
ERR982846_1_kneaddata_paired	Proteobacteria	22518	P	459708	721	460429	0.02483
ERR982846_1_kneaddata_paired	Firmicutes	12188	P	168241	712	168953	0.00911
ERR982846_1_kneaddata_paired	Desulfobacterota_A	11509	P	154790	422	155212	0.00837
ERR982846_1_kneaddata_paired	Actinobacteriota	615	P	6341	5	6346	0.00034
ERR982846_1_kneaddata_paired	Cyanobacteria	9876	P	2675	21	2696	0.00015
ERR982846_1_kneaddata_paired	Spirochaetota	32587	P	504	0	504	0.00003
ERR982846_1_kneaddata_paired	Firmicutes_B	17289	P	349	5	354	0.00002
ERR982846_1_kneaddata_paired	Campylobacterota	8700	P	284	0	284	0.00002
ERR982846_1_kneaddata_paired	Firmicutes_C	17613	P	84	0	84	0.00000
ERR982846_1_kneaddata_paired	Firmicutes_I	18140	P	50	0	50	0.00000
ERR982846_1_kneaddata_paired	Deferribacterota	10822	P	31	0	31	0.00000
ERR982846_1_kneaddata_paired	Thermotogota	33086	P	7	0	7	0.00000
ERR982846_1_kneaddata_paired	Elusimicrobiota	11888	P	6	0	6	0.00000
ERR982847_1_kneaddata_paired	Firmicutes_A	14608	P	16344876	78812	16423688	0.83109
ERR982847_1_kneaddata_paired	Bacteroidota	4587	P	1522337	21936	1544273	0.07814
ERR982847_1_kneaddata_paired	Firmicutes	12188	P	814493	7386	821879	0.04159
ERR982847_1_kneaddata_paired	Verrucomicrobiota	33333	P	630540	27475	658015	0.03330
ERR982847_1_kneaddata_paired	Desulfobacterota_A	11509	P	147253	2720	149973	0.00759
ERR982847_1_kneaddata_paired	Proteobacteria	22518	P	85128	253	85381	0.00432
ERR982847_1_kneaddata_paired	Actinobacteriota	615	P	73961	135	74096	0.00375
ERR982847_1_kneaddata_paired	Cyanobacteria	9876	P	1575	20	1595	0.00008
ERR982847_1_kneaddata_paired	Firmicutes_B	17289	P	1273	34	1307	0.00007
ERR982847_1_kneaddata_paired	Spirochaetota	32587	P	569	0	569	0.00003
ERR982847_1_kneaddata_paired	Campylobacterota	8700	P	401	0	401	0.00002
ERR982847_1_kneaddata_paired	Firmicutes_C	17613	P	201	0	201	0.00001
ERR982847_1_kneaddata_paired	Firmicutes_I	18140	P	147	0	147	0.00001
ERR982847_1_kneaddata_paired	Deferribacterota	10822	P	65	0	65	0.00000
ERR982847_1_kneaddata_paired	Thermotogota	33086	P	31	0	31	0.00000
ERR982847_1_kneaddata_paired	Elusimicrobiota	11888	P	13	0	13	0.00000
ERR982848_1_kneaddata_paired	Firmicutes_A	14608	P	7567577	27562	7595139	0.61131
ERR982848_1_kneaddata_paired	Bacteroidota	4587	P	3935252	36773	3972025	0.31970
ERR982848_1_kneaddata_paired	Firmicutes	12188	P	395747	1628	397375	0.03198
ERR982848_1_kneaddata_paired	Verrucomicrobiota	33333	P	340070	9833	349903	0.02816
ERR982848_1_kneaddata_paired	Desulfobacterota_A	11509	P	72685	751	73436	0.00591
ERR982848_1_kneaddata_paired	Actinobacteriota	615	P	19408	22	19430	0.00156
ERR982848_1_kneaddata_paired	Proteobacteria	22518	P	13789	29	13818	0.00111
ERR982848_1_kneaddata_paired	Cyanobacteria	9876	P	1197	14	1211	0.00010
ERR982848_1_kneaddata_paired	Spirochaetota	32587	P	754	0	754	0.00006
ERR982848_1_kneaddata_paired	Firmicutes_B	17289	P	735	13	748	0.00006
ERR982848_1_kneaddata_paired	Campylobacterota	8700	P	268	0	268	0.00002
ERR982848_1_kneaddata_paired	Firmicutes_C	17613	P	133	0	133	0.00001
ERR982848_1_kneaddata_paired	Deferribacterota	10822	P	78	0	78	0.00001
ERR982848_1_kneaddata_paired	Firmicutes_I	18140	P	56	0	56	0.00000
ERR982848_1_kneaddata_paired	Thermotogota	33086	P	8	0	8	0.00000
ERR982848_1_kneaddata_paired	Elusimicrobiota	11888	P	5	0	5	0.00000
mgm4537490.3_kneaddata	Firmicutes_A	14608	P	2427269	34998	2462267	0.49225
mgm4537490.3_kneaddata	Bacteroidota	4587	P	2203868	25304	2229172	0.44565
mgm4537490.3_kneaddata	Deferribacterota	10822	P	108862	1004	109866	0.02196
mgm4537490.3_kneaddata	Firmicutes	12188	P	89544	1993	91537	0.01830
mgm4537490.3_kneaddata	Proteobacteria	22518	P	41347	543	41890	0.00837
mgm4537490.3_kneaddata	Verrucomicrobiota	33333	P	21492	2958	24450	0.00489
mgm4537490.3_kneaddata	Cyanobacteria	9876	P	21334	475	21809	0.00436
mgm4537490.3_kneaddata	Desulfobacterota_A	11509	P	17851	202	18053	0.00361
mgm4537490.3_kneaddata	Actinobacteriota	615	P	2556	23	2579	0.00052
mgm4537490.3_kneaddata	Firmicutes_B	17289	P	203	18	221	0.00004
mgm4537490.3_kneaddata	Campylobacterota	8700	P	103	0	103	0.00002
mgm4537490.3_kneaddata	Spirochaetota	32587	P	66	0	66	0.00001
mgm4537490.3_kneaddata	Firmicutes_I	18140	P	33	0	33	0.00001
mgm4537490.3_kneaddata	Firmicutes_C	17613	P	24	0	24	0.00000
mgm4537490.3_kneaddata	Elusimicrobiota	11888	P	1	0	1	0.00000
mgm4537490.3_kneaddata	Thermotogota	33086	P	1	0	1	0.00000
mgm4538631.3_kneaddata	Firmicutes_A	14608	P	2089171	22729	2111900	0.52075
mgm4538631.3_kneaddata	Bacteroidota	4587	P	1706635	18168	1724803	0.42530
mgm4538631.3_kneaddata	Firmicutes	12188	P	95403	2973	98376	0.02426
mgm4538631.3_kneaddata	Deferribacterota	10822	P	63373	530	63903	0.01576
mgm4538631.3_kneaddata	Verrucomicrobiota	33333	P	15973	1980	17953	0.00443
mgm4538631.3_kneaddata	Desulfobacterota_A	11509	P	13529	171	13700	0.00338
mgm4538631.3_kneaddata	Cyanobacteria	9876	P	12346	210	12556	0.00310
mgm4538631.3_kneaddata	Proteobacteria	22518	P	9182	102	9284	0.00229
mgm4538631.3_kneaddata	Actinobacteriota	615	P	2633	19	2652	0.00065
mgm4538631.3_kneaddata	Firmicutes_B	17289	P	116	9	125	0.00003
mgm4538631.3_kneaddata	Campylobacterota	8700	P	89	0	89	0.00002
mgm4538631.3_kneaddata	Spirochaetota	32587	P	55	0	55	0.00001
mgm4538631.3_kneaddata	Firmicutes_I	18140	P	34	0	34	0.00001
mgm4538631.3_kneaddata	Firmicutes_C	17613	P	24	0	24	0.00001
mgm4538631.3_kneaddata	Thermotogota	33086	P	21	0	21	0.00001
mgm4538631.3_kneaddata	Elusimicrobiota	11888	P	2	0	2	0.00000
mgm4538804.3_kneaddata	Bacteroidota	4587	P	3276156	37974	3314130	0.52199
mgm4538804.3_kneaddata	Firmicutes_A	14608	P	2479482	19902	2499384	0.39366
mgm4538804.3_kneaddata	Firmicutes	12188	P	211529	4223	215752	0.03398
mgm4538804.3_kneaddata	Deferribacterota	10822	P	174526	1076	175602	0.02766
mgm4538804.3_kneaddata	Verrucomicrobiota	33333	P	43571	4004	47575	0.00749
mgm4538804.3_kneaddata	Proteobacteria	22518	P	43321	996	44317	0.00698
mgm4538804.3_kneaddata	Actinobacteriota	615	P	30503	152	30655	0.00483
mgm4538804.3_kneaddata	Firmicutes_B	17289	P	13433	830	14263	0.00225
mgm4538804.3_kneaddata	Cyanobacteria	9876	P	5636	89	5725	0.00090
mgm4538804.3_kneaddata	Desulfobacterota_A	11509	P	1249	70	1319	0.00021
mgm4538804.3_kneaddata	Spirochaetota	32587	P	141	0	141	0.00002
mgm4538804.3_kneaddata	Campylobacterota	8700	P	104	0	104	0.00002
mgm4538804.3_kneaddata	Firmicutes_I	18140	P	45	0	45	0.00001
mgm4538804.3_kneaddata	Firmicutes_C	17613	P	18	0	18	0.00000
mgm4538804.3_kneaddata	Thermotogota	33086	P	6	0	6	0.00000
mgm4538804.3_kneaddata	Elusimicrobiota	11888	P	5	0	5	0.00000
mgm4538858.3_kneaddata	Firmicutes_A	14608	P	1529887	13700	1543587	0.49544
mgm4538858.3_kneaddata	Bacteroidota	4587	P	1106556	10648	1117204	0.35859
mgm4538858.3_kneaddata	Firmicutes	12188	P	309728	6731	316459	0.10157
mgm4538858.3_kneaddata	Deferribacterota	10822	P	72988	554	73542	0.02360
mgm4538858.3_kneaddata	Proteobacteria	22518	P	19818	137	19955	0.00640
mgm4538858.3_kneaddata	Cyanobacteria	9876	P	19379	267	19646	0.00631
mgm4538858.3_kneaddata	Verrucomicrobiota	33333	P	13802	1565	15367	0.00493
mgm4538858.3_kneaddata	Desulfobacterota_A	11509	P	7975	77	8052	0.00258
mgm4538858.3_kneaddata	Actinobacteriota	615	P	1551	19	1570	0.00050
mgm4538858.3_kneaddata	Spirochaetota	32587	P	56	0	56	0.00002
mgm4538858.3_kneaddata	Firmicutes_B	17289	P	45	3	48	0.00002
mgm4538858.3_kneaddata	Campylobacterota	8700	P	32	0	32	0.00001
mgm4538858.3_kneaddata	Firmicutes_I	18140	P	29	0	29	0.00001
mgm4538858.3_kneaddata	Firmicutes_C	17613	P	26	0	26	0.00001
mgm4538858.3_kneaddata	Elusimicrobiota	11888	P	2	0	2	0.00000
mgm4538858.3_kneaddata	Thermotogota	33086	P	1	0	1	0.00000
mgm4538914.3_kneaddata	Firmicutes_A	14608	P	1507807	16099	1523906	0.49176
mgm4538914.3_kneaddata	Bacteroidota	4587	P	1252759	14518	1267277	0.40895
mgm4538914.3_kneaddata	Deferribacterota	10822	P	200110	1926	202036	0.06520
mgm4538914.3_kneaddata	Firmicutes	12188	P	47978	789	48767	0.01574
mgm4538914.3_kneaddata	Proteobacteria	22518	P	16116	206	16322	0.00527
mgm4538914.3_kneaddata	Desulfobacterota_A	11509	P	13209	157	13366	0.00431
mgm4538914.3_kneaddata	Cyanobacteria	9876	P	13068	705	13773	0.00444
mgm4538914.3_kneaddata	Verrucomicrobiota	33333	P	10384	1485	11869	0.00383
mgm4538914.3_kneaddata	Actinobacteriota	615	P	1120	10	1130	0.00036
mgm4538914.3_kneaddata	Firmicutes_B	17289	P	131	12	143	0.00005
mgm4538914.3_kneaddata	Campylobacterota	8700	P	108	0	108	0.00003
mgm4538914.3_kneaddata	Spirochaetota	32587	P	101	0	101	0.00003
mgm4538914.3_kneaddata	Firmicutes_I	18140	P	26	0	26	0.00001
mgm4538914.3_kneaddata	Firmicutes_C	17613	P	21	0	21	0.00001
mgm4538914.3_kneaddata	Thermotogota	33086	P	2	0	2	0.00000
mgm4538917.3_kneaddata	Bacteroidota	4587	P	928696	9554	938250	0.56538
mgm4538917.3_kneaddata	Firmicutes_A	14608	P	564611	7207	571818	0.34457
mgm4538917.3_kneaddata	Deferribacterota	10822	P	68193	606	68799	0.04146
mgm4538917.3_kneaddata	Verrucomicrobiota	33333	P	22661	2996	25657	0.01546
mgm4538917.3_kneaddata	Firmicutes	12188	P	21233	405	21638	0.01304
mgm4538917.3_kneaddata	Proteobacteria	22518	P	17490	116	17606	0.01061
mgm4538917.3_kneaddata	Desulfobacterota_A	11509	P	7473	60	7533	0.00454
mgm4538917.3_kneaddata	Cyanobacteria	9876	P	6750	182	6932	0.00418
mgm4538917.3_kneaddata	Actinobacteriota	615	P	976	12	988	0.00060
mgm4538917.3_kneaddata	Firmicutes_B	17289	P	141	12	153	0.00009
mgm4538917.3_kneaddata	Campylobacterota	8700	P	50	0	50	0.00003
mgm4538917.3_kneaddata	Spirochaetota	32587	P	37	0	37	0.00002
mgm4538917.3_kneaddata	Firmicutes_I	18140	P	18	0	18	0.00001
mgm4538917.3_kneaddata	Firmicutes_C	17613	P	7	0	7	0.00000
mgm4538917.3_kneaddata	Thermotogota	33086	P	4	0	4	0.00000
mgm4538917.3_kneaddata	Elusimicrobiota	11888	P	1	0	1	0.00000
mgm4539155.3_kneaddata	Firmicutes_A	14608	P	1040741	12577	1053318	0.53516
mgm4539155.3_kneaddata	Bacteroidota	4587	P	644664	6678	651342	0.33093
mgm4539155.3_kneaddata	Firmicutes	12188	P	189507	3988	193495	0.09831
mgm4539155.3_kneaddata	Deferribacterota	10822	P	43619	321	43940	0.02232
mgm4539155.3_kneaddata	Proteobacteria	22518	P	8658	43	8701	0.00442
mgm4539155.3_kneaddata	Cyanobacteria	9876	P	8441	87	8528	0.00433
mgm4539155.3_kneaddata	Desulfobacterota_A	11509	P	6871	56	6927	0.00352
mgm4539155.3_kneaddata	Verrucomicrobiota	33333	P	1085	117	1202	0.00061
mgm4539155.3_kneaddata	Actinobacteriota	615	P	657	9	666	0.00034
mgm4539155.3_kneaddata	Spirochaetota	32587	P	34	0	34	0.00002
mgm4539155.3_kneaddata	Firmicutes_B	17289	P	31	2	33	0.00002
mgm4539155.3_kneaddata	Campylobacterota	8700	P	23	0	23	0.00001
mgm4539155.3_kneaddata	Firmicutes_I	18140	P	12	0	12	0.00001
mgm4539155.3_kneaddata	Firmicutes_C	17613	P	9	0	9	0.00000
mgm4539155.3_kneaddata	Thermotogota	33086	P	2	0	2	0.00000
mgm4539155.3_kneaddata	Elusimicrobiota	11888	P	1	0	1	0.00000
mgm4539386.3_kneaddata	Bacteroidota	4587	P	583721	7741	591462	0.49098
mgm4539386.3_kneaddata	Firmicutes_A	14608	P	490056	4013	494069	0.41014
mgm4539386.3_kneaddata	Deferribacterota	10822	P	46213	316	46529	0.03862
mgm4539386.3_kneaddata	Firmicutes	12188	P	29855	637	30492	0.02531
mgm4539386.3_kneaddata	Actinobacteriota	615	P	20024	108	20132	0.01671
mgm4539386.3_kneaddata	Proteobacteria	22518	P	8003	219	8222	0.00683
mgm4539386.3_kneaddata	Verrucomicrobiota	33333	P	7102	713	7815	0.00649
mgm4539386.3_kneaddata	Cyanobacteria	9876	P	2511	25	2536	0.00211
mgm4539386.3_kneaddata	Desulfobacterota_A	11509	P	2270	21	2291	0.00190
mgm4539386.3_kneaddata	Firmicutes_B	17289	P	967	66	1033	0.00086
mgm4539386.3_kneaddata	Spirochaetota	32587	P	25	0	25	0.00002
mgm4539386.3_kneaddata	Campylobacterota	8700	P	19	0	19	0.00002
mgm4539386.3_kneaddata	Firmicutes_I	18140	P	10	0	10	0.00001
mgm4539386.3_kneaddata	Firmicutes_C	17613	P	4	0	4	0.00000
mgm4539386.3_kneaddata	Thermotogota	33086	P	4	0	4	0.00000
mgm4539386.3_kneaddata	Elusimicrobiota	11888	P	1	0	1	0.00000
mgm4539473.3_kneaddata	Firmicutes_A	14608	P	2673456	23158	2696614	0.49036
mgm4539473.3_kneaddata	Bacteroidota	4587	P	2218848	30416	2249264	0.40901
mgm4539473.3_kneaddata	Deferribacterota	10822	P	291336	2091	293427	0.05336
mgm4539473.3_kneaddata	Firmicutes	12188	P	128057	2947	131004	0.02382
mgm4539473.3_kneaddata	Proteobacteria	22518	P	41510	1154	42664	0.00776
mgm4539473.3_kneaddata	Actinobacteriota	615	P	32320	186	32506	0.00591
mgm4539473.3_kneaddata	Verrucomicrobiota	33333	P	27732	2952	30684	0.00558
mgm4539473.3_kneaddata	Desulfobacterota_A	11509	P	8756	110	8866	0.00161
mgm4539473.3_kneaddata	Cyanobacteria	9876	P	6814	102	6916	0.00126
mgm4539473.3_kneaddata	Firmicutes_B	17289	P	6534	469	7003	0.00127
mgm4539473.3_kneaddata	Spirochaetota	32587	P	134	0	134	0.00002
mgm4539473.3_kneaddata	Campylobacterota	8700	P	101	0	101	0.00002
mgm4539473.3_kneaddata	Firmicutes_I	18140	P	52	0	52	0.00001
mgm4539473.3_kneaddata	Firmicutes_C	17613	P	27	0	27	0.00000
mgm4539473.3_kneaddata	Thermotogota	33086	P	12	0	12	0.00000
mgm4539473.3_kneaddata	Elusimicrobiota	11888	P	3	0	3	0.00000
mgm4539531.3_kneaddata	Bacteroidota	4587	P	1945323	18596	1963919	0.48460
mgm4539531.3_kneaddata	Firmicutes_A	14608	P	1622839	15775	1638614	0.40433
mgm4539531.3_kneaddata	Firmicutes	12188	P	220307	4650	224957	0.05551
mgm4539531.3_kneaddata	Deferribacterota	10822	P	108198	883	109081	0.02692
mgm4539531.3_kneaddata	Verrucomicrobiota	33333	P	42071	5094	47165	0.01164
mgm4539531.3_kneaddata	Desulfobacterota_A	11509	P	26709	200	26909	0.00664
mgm4539531.3_kneaddata	Proteobacteria	22518	P	23867	276	24143	0.00596
mgm4539531.3_kneaddata	Cyanobacteria	9876	P	16013	366	16379	0.00404
mgm4539531.3_kneaddata	Actinobacteriota	615	P	1073	8	1081	0.00027
mgm4539531.3_kneaddata	Firmicutes_B	17289	P	197	16	213	0.00005
mgm4539531.3_kneaddata	Campylobacterota	8700	P	93	0	93	0.00002
mgm4539531.3_kneaddata	Spirochaetota	32587	P	71	0	71	0.00002
mgm4539531.3_kneaddata	Firmicutes_I	18140	P	20	0	20	0.00000
mgm4539531.3_kneaddata	Firmicutes_C	17613	P	18	0	18	0.00000
mgm4539531.3_kneaddata	Thermotogota	33086	P	3	0	3	0.00000
mgm4539531.3_kneaddata	Elusimicrobiota	11888	P	2	0	2	0.00000
mgm4539533.3_kneaddata	Firmicutes_A	14608	P	945138	10793	955931	0.47729
mgm4539533.3_kneaddata	Bacteroidota	4587	P	889983	8432	898415	0.44857
mgm4539533.3_kneaddata	Deferribacterota	10822	P	63208	520	63728	0.03182
mgm4539533.3_kneaddata	Firmicutes	12188	P	26455	678	27133	0.01355
mgm4539533.3_kneaddata	Proteobacteria	22518	P	20381	183	20564	0.01027
mgm4539533.3_kneaddata	Verrucomicrobiota	33333	P	13166	1608	14774	0.00738
mgm4539533.3_kneaddata	Desulfobacterota_A	11509	P	10910	87	10997	0.00549
mgm4539533.3_kneaddata	Cyanobacteria	9876	P	8830	265	9095	0.00454
mgm4539533.3_kneaddata	Actinobacteriota	615	P	1914	17	1931	0.00096
mgm4539533.3_kneaddata	Firmicutes_B	17289	P	86	7	93	0.00005
mgm4539533.3_kneaddata	Campylobacterota	8700	P	63	0	63	0.00003
mgm4539533.3_kneaddata	Spirochaetota	32587	P	55	0	55	0.00003
mgm4539533.3_kneaddata	Firmicutes_I	18140	P	20	0	20	0.00001
mgm4539533.3_kneaddata	Firmicutes_C	17613	P	10	0	10	0.00001
mgm4539533.3_kneaddata	Thermotogota	33086	P	8	0	8	0.00000
mgm4539684.3_kneaddata	Bacteroidota	4587	P	3038547	40256	3078803	0.53659
mgm4539684.3_kneaddata	Firmicutes_A	14608	P	2257760	23798	2281558	0.39764
mgm4539684.3_kneaddata	Deferribacterota	10822	P	92317	791	93108	0.01623
mgm4539684.3_kneaddata	Firmicutes	12188	P	82089	2509	84598	0.01474
mgm4539684.3_kneaddata	Verrucomicrobiota	33333	P	63128	8050	71178	0.01241
mgm4539684.3_kneaddata	Proteobacteria	22518	P	53237	1462	54699	0.00953
mgm4539684.3_kneaddata	Desulfobacterota_A	11509	P	35549	265	35814	0.00624
mgm4539684.3_kneaddata	Actinobacteriota	615	P	27337	193	27530	0.00480
mgm4539684.3_kneaddata	Cyanobacteria	9876	P	9712	273	9985	0.00174
mgm4539684.3_kneaddata	Firmicutes_B	17289	P	144	12	156	0.00003
mgm4539684.3_kneaddata	Campylobacterota	8700	P	96	0	96	0.00002
mgm4539684.3_kneaddata	Spirochaetota	32587	P	92	0	92	0.00002
mgm4539684.3_kneaddata	Firmicutes_I	18140	P	53	0	53	0.00001
mgm4539684.3_kneaddata	Firmicutes_C	17613	P	24	0	24	0.00000
mgm4539684.3_kneaddata	Thermotogota	33086	P	6	0	6	0.00000
mgm4539684.3_kneaddata	Elusimicrobiota	11888	P	5	0	5	0.00000
mgm4539685.3_kneaddata	Bacteroidota	4587	P	2010661	16546	2027207	0.58648
mgm4539685.3_kneaddata	Firmicutes_A	14608	P	924895	8806	933701	0.27012
mgm4539685.3_kneaddata	Deferribacterota	10822	P	231004	1455	232459	0.06725
mgm4539685.3_kneaddata	Verrucomicrobiota	33333	P	129454	12124	141578	0.04096
mgm4539685.3_kneaddata	Proteobacteria	22518	P	46072	881	46953	0.01358
mgm4539685.3_kneaddata	Firmicutes	12188	P	30940	378	31318	0.00906
mgm4539685.3_kneaddata	Actinobacteriota	615	P	22716	115	22831	0.00661
mgm4539685.3_kneaddata	Desulfobacterota_A	11509	P	15611	89	15700	0.00454
mgm4539685.3_kneaddata	Cyanobacteria	9876	P	4123	208	4331	0.00125
mgm4539685.3_kneaddata	Firmicutes_B	17289	P	219	13	232	0.00007
mgm4539685.3_kneaddata	Spirochaetota	32587	P	133	0	133	0.00004
mgm4539685.3_kneaddata	Campylobacterota	8700	P	89	0	89	0.00003
mgm4539685.3_kneaddata	Firmicutes_I	18140	P	29	0	29	0.00001
mgm4539685.3_kneaddata	Firmicutes_C	17613	P	22	0	22	0.00001
mgm4539685.3_kneaddata	Thermotogota	33086	P	1	0	1	0.00000
mgm4539686.3_kneaddata	Bacteroidota	4587	P	5095283	54653	5149936	0.57477
mgm4539686.3_kneaddata	Firmicutes_A	14608	P	2811162	24192	2835354	0.31645
mgm4539686.3_kneaddata	Deferribacterota	10822	P	349654	2425	352079	0.03929
mgm4539686.3_kneaddata	Verrucomicrobiota	33333	P	227232	23412	250644	0.02797
mgm4539686.3_kneaddata	Firmicutes	12188	P	150479	1773	152252	0.01699
mgm4539686.3_kneaddata	Proteobacteria	22518	P	90937	1841	92778	0.01035
mgm4539686.3_kneaddata	Desulfobacterota_A	11509	P	56795	305	57100	0.00637
mgm4539686.3_kneaddata	Actinobacteriota	615	P	40511	228	40739	0.00455
mgm4539686.3_kneaddata	Cyanobacteria	9876	P	24997	711	25708	0.00287
mgm4539686.3_kneaddata	Firmicutes_B	17289	P	2630	182	2812	0.00031
mgm4539686.3_kneaddata	Spirochaetota	32587	P	244	1	245	0.00003
mgm4539686.3_kneaddata	Campylobacterota	8700	P	237	0	237	0.00003
mgm4539686.3_kneaddata	Firmicutes_I	18140	P	72	0	72	0.00001
mgm4539686.3_kneaddata	Firmicutes_C	17613	P	46	0	46	0.00001
mgm4539686.3_kneaddata	Thermotogota	33086	P	9	0	9	0.00000
mgm4539686.3_kneaddata	Elusimicrobiota	11888	P	5	0	5	0.00000
mgm4539799.3_kneaddata	Firmicutes_A	14608	P	1943902	21719	1965621	0.69656
mgm4539799.3_kneaddata	Bacteroidota	4587	P	628439	5533	633972	0.22466
mgm4539799.3_kneaddata	Deferribacterota	10822	P	137359	1136	138495	0.04908
mgm4539799.3_kneaddata	Desulfobacterota_A	11509	P	75478	500	75978	0.02692
mgm4539799.3_kneaddata	Firmicutes	12188	P	4076	160	4236	0.00150
mgm4539799.3_kneaddata	Actinobacteriota	615	P	949	7	956	0.00034
mgm4539799.3_kneaddata	Proteobacteria	22518	P	835	8	843	0.00030
mgm4539799.3_kneaddata	Verrucomicrobiota	33333	P	767	101	868	0.00031
mgm4539799.3_kneaddata	Cyanobacteria	9876	P	580	8	588	0.00021
mgm4539799.3_kneaddata	Firmicutes_B	17289	P	145	12	157	0.00006
mgm4539799.3_kneaddata	Spirochaetota	32587	P	82	0	82	0.00003
mgm4539799.3_kneaddata	Firmicutes_C	17613	P	34	0	34	0.00001
mgm4539799.3_kneaddata	Firmicutes_I	18140	P	29	0	29	0.00001
mgm4539799.3_kneaddata	Campylobacterota	8700	P	22	0	22	0.00001
mgm4539799.3_kneaddata	Elusimicrobiota	11888	P	9	0	9	0.00000
mgm4539799.3_kneaddata	Thermotogota	33086	P	5	0	5	0.00000
mgm4539801.3_kneaddata	Firmicutes_A	14608	P	3927796	38500	3966296	0.71778
mgm4539801.3_kneaddata	Bacteroidota	4587	P	1063232	8623	1071855	0.19397
mgm4539801.3_kneaddata	Deferribacterota	10822	P	298868	1833	300701	0.05442
mgm4539801.3_kneaddata	Desulfobacterota_A	11509	P	168302	811	169113	0.03060
mgm4539801.3_kneaddata	Firmicutes	12188	P	12048	625	12673	0.00229
mgm4539801.3_kneaddata	Verrucomicrobiota	33333	P	1572	156	1728	0.00031
mgm4539801.3_kneaddata	Actinobacteriota	615	P	1349	10	1359	0.00025
mgm4539801.3_kneaddata	Proteobacteria	22518	P	1044	6	1050	0.00019
mgm4539801.3_kneaddata	Cyanobacteria	9876	P	338	6	344	0.00006
mgm4539801.3_kneaddata	Firmicutes_B	17289	P	335	20	355	0.00006
mgm4539801.3_kneaddata	Spirochaetota	32587	P	165	0	165	0.00003
mgm4539801.3_kneaddata	Campylobacterota	8700	P	55	0	55	0.00001
mgm4539801.3_kneaddata	Firmicutes_C	17613	P	53	0	53	0.00001
mgm4539801.3_kneaddata	Firmicutes_I	18140	P	46	0	46	0.00001
mgm4539801.3_kneaddata	Elusimicrobiota	11888	P	5	0	5	0.00000
mgm4539801.3_kneaddata	Thermotogota	33086	P	2	0	2	0.00000
mgm4539802.3_kneaddata	Firmicutes_A	14608	P	3574677	41732	3616409	0.66720
mgm4539802.3_kneaddata	Bacteroidota	4587	P	1242992	8504	1251496	0.23089
mgm4539802.3_kneaddata	Deferribacterota	10822	P	405754	2506	408260	0.07532
mgm4539802.3_kneaddata	Desulfobacterota_A	11509	P	119071	610	119681	0.02208
mgm4539802.3_kneaddata	Firmicutes	12188	P	13088	473	13561	0.00250
mgm4539802.3_kneaddata	Proteobacteria	22518	P	3488	23	3511	0.00065
mgm4539802.3_kneaddata	Cyanobacteria	9876	P	2527	22	2549	0.00047
mgm4539802.3_kneaddata	Verrucomicrobiota	33333	P	2385	238	2623	0.00048
mgm4539802.3_kneaddata	Actinobacteriota	615	P	1542	10	1552	0.00029
mgm4539802.3_kneaddata	Firmicutes_B	17289	P	249	15	264	0.00005
mgm4539802.3_kneaddata	Spirochaetota	32587	P	193	1	194	0.00004
mgm4539802.3_kneaddata	Campylobacterota	8700	P	79	0	79	0.00001
mgm4539802.3_kneaddata	Firmicutes_I	18140	P	49	0	49	0.00001
mgm4539802.3_kneaddata	Firmicutes_C	17613	P	35	0	35	0.00001
mgm4539802.3_kneaddata	Thermotogota	33086	P	6	0	6	0.00000
mgm4539802.3_kneaddata	Elusimicrobiota	11888	P	3	0	3	0.00000
mgm4539917.3_kneaddata	Firmicutes_A	14608	P	2104644	23592	2128236	0.63156
mgm4539917.3_kneaddata	Bacteroidota	4587	P	739208	4863	744071	0.22081
mgm4539917.3_kneaddata	Deferribacterota	10822	P	374166	2365	376531	0.11174
mgm4539917.3_kneaddata	Desulfobacterota_A	11509	P	102665	503	103168	0.03062
mgm4539917.3_kneaddata	Firmicutes	12188	P	8690	226	8916	0.00265
mgm4539917.3_kneaddata	Verrucomicrobiota	33333	P	2767	266	3033	0.00090
mgm4539917.3_kneaddata	Cyanobacteria	9876	P	2285	19	2304	0.00068
mgm4539917.3_kneaddata	Proteobacteria	22518	P	2248	10	2258	0.00067
mgm4539917.3_kneaddata	Actinobacteriota	615	P	799	4	803	0.00024
mgm4539917.3_kneaddata	Spirochaetota	32587	P	175	0	175	0.00005
mgm4539917.3_kneaddata	Firmicutes_B	17289	P	173	10	183	0.00005
mgm4539917.3_kneaddata	Campylobacterota	8700	P	47	0	47	0.00001
mgm4539917.3_kneaddata	Firmicutes_C	17613	P	30	0	30	0.00001
mgm4539917.3_kneaddata	Firmicutes_I	18140	P	26	0	26	0.00001
mgm4539917.3_kneaddata	Elusimicrobiota	11888	P	2	0	2	0.00000
mgm4539917.3_kneaddata	Thermotogota	33086	P	1	0	1	0.00000
mgm4539918.3_kneaddata	Firmicutes_A	14608	P	3787077	40121	3827198	0.57328
mgm4539918.3_kneaddata	Bacteroidota	4587	P	1777568	15543	1793111	0.26859
mgm4539918.3_kneaddata	Deferribacterota	10822	P	856698	5362	862060	0.12913
mgm4539918.3_kneaddata	Desulfobacterota_A	11509	P	158990	793	159783	0.02393
mgm4539918.3_kneaddata	Firmicutes	12188	P	25282	914	26196	0.00392
mgm4539918.3_kneaddata	Proteobacteria	22518	P	2370	15	2385	0.00036
mgm4539918.3_kneaddata	Actinobacteriota	615	P	1959	11	1970	0.00030
mgm4539918.3_kneaddata	Verrucomicrobiota	33333	P	1630	162	1792	0.00027
mgm4539918.3_kneaddata	Cyanobacteria	9876	P	554	13	567	0.00009
mgm4539918.3_kneaddata	Spirochaetota	32587	P	344	1	345	0.00005
mgm4539918.3_kneaddata	Firmicutes_B	17289	P	281	17	298	0.00004
mgm4539918.3_kneaddata	Campylobacterota	8700	P	140	0	140	0.00002
mgm4539918.3_kneaddata	Firmicutes_C	17613	P	87	0	87	0.00001
mgm4539918.3_kneaddata	Firmicutes_I	18140	P	66	0	66	0.00001
mgm4539918.3_kneaddata	Elusimicrobiota	11888	P	10	0	10	0.00000
mgm4539918.3_kneaddata	Thermotogota	33086	P	4	0	4	0.00000
mgm4539994.3_kneaddata	Firmicutes_A	14608	P	2321940	18547	2340487	0.44240
mgm4539994.3_kneaddata	Bacteroidota	4587	P	1836349	19058	1855407	0.35071
mgm4539994.3_kneaddata	Deferribacterota	10822	P	726770	4554	731324	0.13824
mgm4539994.3_kneaddata	Verrucomicrobiota	33333	P	126459	11756	138215	0.02613
mgm4539994.3_kneaddata	Desulfobacterota_A	11509	P	74512	376	74888	0.01416
mgm4539994.3_kneaddata	Firmicutes	12188	P	62118	1167	63285	0.01196
mgm4539994.3_kneaddata	Actinobacteriota	615	P	50107	231	50338	0.00951
mgm4539994.3_kneaddata	Proteobacteria	22518	P	31306	465	31771	0.00601
mgm4539994.3_kneaddata	Cyanobacteria	9876	P	3743	177	3920	0.00074
mgm4539994.3_kneaddata	Spirochaetota	32587	P	308	1	309	0.00006
mgm4539994.3_kneaddata	Firmicutes_B	17289	P	251	15	266	0.00005
mgm4539994.3_kneaddata	Campylobacterota	8700	P	145	0	145	0.00003
mgm4539994.3_kneaddata	Firmicutes_I	18140	P	28	0	28	0.00001
mgm4539994.3_kneaddata	Firmicutes_C	17613	P	22	0	22	0.00000
mgm4539994.3_kneaddata	Elusimicrobiota	11888	P	3	0	3	0.00000
mgm4539994.3_kneaddata	Thermotogota	33086	P	2	0	2	0.00000
mgm4539995.3_kneaddata	Bacteroidota	4587	P	1996065	15641	2011706	0.48157
mgm4539995.3_kneaddata	Firmicutes_A	14608	P	1184010	9384	1193394	0.28568
mgm4539995.3_kneaddata	Proteobacteria	22518	P	262243	2046	264289	0.06327
mgm4539995.3_kneaddata	Deferribacterota	10822	P	217658	892	218550	0.05232
mgm4539995.3_kneaddata	Actinobacteriota	615	P	212863	655	213518	0.05111
mgm4539995.3_kneaddata	Verrucomicrobiota	33333	P	153115	9302	162417	0.03888
mgm4539995.3_kneaddata	Firmicutes	12188	P	75447	1206	76653	0.01835
mgm4539995.3_kneaddata	Desulfobacterota_A	11509	P	20333	146	20479	0.00490
mgm4539995.3_kneaddata	Firmicutes_B	17289	P	14273	587	14860	0.00356
mgm4539995.3_kneaddata	Cyanobacteria	9876	P	987	40	1027	0.00025
mgm4539995.3_kneaddata	Campylobacterota	8700	P	290	0	290	0.00007
mgm4539995.3_kneaddata	Spirochaetota	32587	P	127	0	127	0.00003
mgm4539995.3_kneaddata	Firmicutes_I	18140	P	19	0	19	0.00000
mgm4539995.3_kneaddata	Firmicutes_C	17613	P	16	0	16	0.00000
mgm4539995.3_kneaddata	Elusimicrobiota	11888	P	2	0	2	0.00000
mgm4539995.3_kneaddata	Thermotogota	33086	P	1	0	1	0.00000
mgm4539996.3_kneaddata	Bacteroidota	4587	P	2226744	25260	2252004	0.46501
mgm4539996.3_kneaddata	Firmicutes_A	14608	P	1627689	14760	1642449	0.33914
mgm4539996.3_kneaddata	Deferribacterota	10822	P	467159	2854	470013	0.09705
mgm4539996.3_kneaddata	Actinobacteriota	615	P	189758	906	190664	0.03937
mgm4539996.3_kneaddata	Verrucomicrobiota	33333	P	85663	7791	93454	0.01930
mgm4539996.3_kneaddata	Proteobacteria	22518	P	75760	1215	76975	0.01589
mgm4539996.3_kneaddata	Firmicutes	12188	P	66103	1309	67412	0.01392
mgm4539996.3_kneaddata	Desulfobacterota_A	11509	P	41274	259	41533	0.00858
mgm4539996.3_kneaddata	Cyanobacteria	9876	P	7037	176	7213	0.00149
mgm4539996.3_kneaddata	Firmicutes_B	17289	P	797	48	845	0.00017
mgm4539996.3_kneaddata	Spirochaetota	32587	P	201	1	202	0.00004
mgm4539996.3_kneaddata	Campylobacterota	8700	P	120	0	120	0.00002
mgm4539996.3_kneaddata	Firmicutes_C	17613	P	38	0	38	0.00001
mgm4539996.3_kneaddata	Firmicutes_I	18140	P	30	0	30	0.00001
mgm4539996.3_kneaddata	Elusimicrobiota	11888	P	3	0	3	0.00000
mgm4539997.3_kneaddata	Firmicutes_A	14608	P	2170480	27035	2197515	0.47644
mgm4539997.3_kneaddata	Bacteroidota	4587	P	1769466	20905	1790371	0.38816
mgm4539997.3_kneaddata	Deferribacterota	10822	P	397184	3181	400365	0.08680
mgm4539997.3_kneaddata	Proteobacteria	22518	P	68242	1115	69357	0.01504
mgm4539997.3_kneaddata	Verrucomicrobiota	33333	P	39771	4738	44509	0.00965
mgm4539997.3_kneaddata	Firmicutes	12188	P	38209	1203	39412	0.00854
mgm4539997.3_kneaddata	Actinobacteriota	615	P	26794	164	26958	0.00584
mgm4539997.3_kneaddata	Cyanobacteria	9876	P	25891	251	26142	0.00567
mgm4539997.3_kneaddata	Desulfobacterota_A	11509	P	17012	257	17269	0.00374
mgm4539997.3_kneaddata	Spirochaetota	32587	P	169	1	170	0.00004
mgm4539997.3_kneaddata	Campylobacterota	8700	P	134	0	134	0.00003
mgm4539997.3_kneaddata	Firmicutes_B	17289	P	93	7	100	0.00002
mgm4539997.3_kneaddata	Firmicutes_C	17613	P	49	0	49	0.00001
mgm4539997.3_kneaddata	Firmicutes_I	18140	P	35	0	35	0.00001
mgm4539997.3_kneaddata	Elusimicrobiota	11888	P	7	0	7	0.00000
mgm4539997.3_kneaddata	Thermotogota	33086	P	1	0	1	0.00000
mgm4539998.3_kneaddata	Bacteroidota	4587	P	1674177	15106	1689283	0.43720
mgm4539998.3_kneaddata	Firmicutes_A	14608	P	1605681	16884	1622565	0.41994
mgm4539998.3_kneaddata	Deferribacterota	10822	P	281345	1579	282924	0.07322
mgm4539998.3_kneaddata	Verrucomicrobiota	33333	P	114725	9571	124296	0.03217
mgm4539998.3_kneaddata	Actinobacteriota	615	P	54996	236	55232	0.01429
mgm4539998.3_kneaddata	Desulfobacterota_A	11509	P	38190	197	38387	0.00994
mgm4539998.3_kneaddata	Firmicutes	12188	P	20783	709	21492	0.00556
mgm4539998.3_kneaddata	Proteobacteria	22518	P	17704	245	17949	0.00465
mgm4539998.3_kneaddata	Cyanobacteria	9876	P	11275	93	11368	0.00294
mgm4539998.3_kneaddata	Spirochaetota	32587	P	135	0	135	0.00004
mgm4539998.3_kneaddata	Campylobacterota	8700	P	73	0	73	0.00002
mgm4539998.3_kneaddata	Firmicutes_B	17289	P	62	3	65	0.00002
mgm4539998.3_kneaddata	Firmicutes_C	17613	P	39	0	39	0.00001
mgm4539998.3_kneaddata	Firmicutes_I	18140	P	21	0	21	0.00001
mgm4539998.3_kneaddata	Elusimicrobiota	11888	P	6	0	6	0.00000
mgm4539998.3_kneaddata	Thermotogota	33086	P	1	0	1	0.00000
mgm4540044.3_kneaddata	Bacteroidota	4587	P	510373	4844	515217	0.51827
mgm4540044.3_kneaddata	Firmicutes_A	14608	P	293095	1981	295076	0.29682
mgm4540044.3_kneaddata	Deferribacterota	10822	P	94432	477	94909	0.09547
mgm4540044.3_kneaddata	Verrucomicrobiota	33333	P	50938	3819	54757	0.05508
mgm4540044.3_kneaddata	Firmicutes	12188	P	9450	145	9595	0.00965
mgm4540044.3_kneaddata	Actinobacteriota	615	P	8491	36	8527	0.00858
mgm4540044.3_kneaddata	Desulfobacterota_A	11509	P	7718	44	7762	0.00781
mgm4540044.3_kneaddata	Proteobacteria	22518	P	6260	85	6345	0.00638
mgm4540044.3_kneaddata	Cyanobacteria	9876	P	1750	45	1795	0.00181
mgm4540044.3_kneaddata	Spirochaetota	32587	P	55	0	55	0.00006
mgm4540044.3_kneaddata	Firmicutes_B	17289	P	22	1	23	0.00002
mgm4540044.3_kneaddata	Campylobacterota	8700	P	14	0	14	0.00001
mgm4540044.3_kneaddata	Firmicutes_C	17613	P	14	0	14	0.00001
mgm4540044.3_kneaddata	Firmicutes_I	18140	P	14	0	14	0.00001
mgm4540044.3_kneaddata	Thermotogota	33086	P	1	0	1	0.00000
mgm4540045.3_kneaddata	Bacteroidota	4587	P	1582819	18719	1601538	0.45514
mgm4540045.3_kneaddata	Firmicutes_A	14608	P	1486184	12227	1498411	0.42583
mgm4540045.3_kneaddata	Deferribacterota	10822	P	130929	779	131708	0.03743
mgm4540045.3_kneaddata	Verrucomicrobiota	33333	P	121744	10758	132502	0.03766
mgm4540045.3_kneaddata	Actinobacteriota	615	P	52956	265	53221	0.01513
mgm4540045.3_kneaddata	Firmicutes	12188	P	41703	805	42508	0.01208
mgm4540045.3_kneaddata	Proteobacteria	22518	P	27105	450	27555	0.00783
mgm4540045.3_kneaddata	Desulfobacterota_A	11509	P	26015	137	26152	0.00743
mgm4540045.3_kneaddata	Cyanobacteria	9876	P	4783	145	4928	0.00140
mgm4540045.3_kneaddata	Spirochaetota	32587	P	85	0	85	0.00002
mgm4540045.3_kneaddata	Firmicutes_B	17289	P	56	3	59	0.00002
mgm4540045.3_kneaddata	Campylobacterota	8700	P	43	0	43	0.00001
mgm4540045.3_kneaddata	Firmicutes_I	18140	P	27	0	27	0.00001
mgm4540045.3_kneaddata	Firmicutes_C	17613	P	17	0	17	0.00000
mgm4540045.3_kneaddata	Elusimicrobiota	11888	P	3	0	3	0.00000
mgm4540045.3_kneaddata	Thermotogota	33086	P	2	0	2	0.00000
mgm4540046.3_kneaddata	Bacteroidota	4587	P	1988562	18448	2007010	0.53329
mgm4540046.3_kneaddata	Firmicutes_A	14608	P	902729	7424	910153	0.24184
mgm4540046.3_kneaddata	Deferribacterota	10822	P	465065	2286	467351	0.12418
mgm4540046.3_kneaddata	Verrucomicrobiota	33333	P	199760	14584	214344	0.05695
mgm4540046.3_kneaddata	Firmicutes	12188	P	62885	583	63468	0.01686
mgm4540046.3_kneaddata	Proteobacteria	22518	P	50755	549	51304	0.01363
mgm4540046.3_kneaddata	Actinobacteriota	615	P	32389	132	32521	0.00864
mgm4540046.3_kneaddata	Desulfobacterota_A	11509	P	12030	83	12113	0.00322
mgm4540046.3_kneaddata	Cyanobacteria	9876	P	4445	274	4719	0.00125
mgm4540046.3_kneaddata	Spirochaetota	32587	P	196	0	196	0.00005
mgm4540046.3_kneaddata	Campylobacterota	8700	P	109	0	109	0.00003
mgm4540046.3_kneaddata	Firmicutes_B	17289	P	83	4	87	0.00002
mgm4540046.3_kneaddata	Firmicutes_I	18140	P	24	0	24	0.00001
mgm4540046.3_kneaddata	Firmicutes_C	17613	P	16	0	16	0.00000
mgm4540046.3_kneaddata	Elusimicrobiota	11888	P	3	0	3	0.00000
mgm4540046.3_kneaddata	Thermotogota	33086	P	2	0	2	0.00000
mgm4540052.3_kneaddata	Bacteroidota	4587	P	3038623	29584	3068207	0.55791
mgm4540052.3_kneaddata	Firmicutes_A	14608	P	1326110	9401	1335511	0.24284
mgm4540052.3_kneaddata	Deferribacterota	10822	P	592667	3057	595724	0.10832
mgm4540052.3_kneaddata	Verrucomicrobiota	33333	P	240452	18474	258926	0.04708
mgm4540052.3_kneaddata	Firmicutes	12188	P	106050	1015	107065	0.01947
mgm4540052.3_kneaddata	Actinobacteriota	615	P	51734	226	51960	0.00945
mgm4540052.3_kneaddata	Proteobacteria	22518	P	50815	620	51435	0.00935
mgm4540052.3_kneaddata	Desulfobacterota_A	11509	P	19775	128	19903	0.00362
mgm4540052.3_kneaddata	Cyanobacteria	9876	P	9686	444	10130	0.00184
mgm4540052.3_kneaddata	Spirochaetota	32587	P	262	1	263	0.00005
mgm4540052.3_kneaddata	Campylobacterota	8700	P	142	0	142	0.00003
mgm4540052.3_kneaddata	Firmicutes_B	17289	P	122	6	128	0.00002
mgm4540052.3_kneaddata	Firmicutes_C	17613	P	51	0	51	0.00001
mgm4540052.3_kneaddata	Firmicutes_I	18140	P	44	0	44	0.00001
mgm4540052.3_kneaddata	Elusimicrobiota	11888	P	6	0	6	0.00000
mgm4540053.3_kneaddata	Firmicutes_A	14608	P	2190193	16492	2206685	0.53170
mgm4540053.3_kneaddata	Bacteroidota	4587	P	1312507	14950	1327457	0.31985
mgm4540053.3_kneaddata	Deferribacterota	10822	P	273093	1645	274738	0.06620
mgm4540053.3_kneaddata	Verrucomicrobiota	33333	P	132284	11813	144097	0.03472
mgm4540053.3_kneaddata	Actinobacteriota	615	P	103854	539	104393	0.02515
mgm4540053.3_kneaddata	Firmicutes	12188	P	37187	823	38010	0.00916
mgm4540053.3_kneaddata	Proteobacteria	22518	P	32160	387	32547	0.00784
mgm4540053.3_kneaddata	Desulfobacterota_A	11509	P	18022	121	18143	0.00437
mgm4540053.3_kneaddata	Cyanobacteria	9876	P	3653	112	3765	0.00091
mgm4540053.3_kneaddata	Spirochaetota	32587	P	155	0	155	0.00004
mgm4540053.3_kneaddata	Firmicutes_B	17289	P	130	7	137	0.00003
mgm4540053.3_kneaddata	Campylobacterota	8700	P	64	0	64	0.00002
mgm4540053.3_kneaddata	Firmicutes_I	18140	P	37	0	37	0.00001
mgm4540053.3_kneaddata	Firmicutes_C	17613	P	33	0	33	0.00001
mgm4540053.3_kneaddata	Elusimicrobiota	11888	P	5	0	5	0.00000
mgm4540053.3_kneaddata	Thermotogota	33086	P	1	0	1	0.00000
mgm4540251.3_kneaddata	Firmicutes_A	14608	P	2553722	25256	2578978	0.74741
mgm4540251.3_kneaddata	Bacteroidota	4587	P	450287	3646	453933	0.13155
mgm4540251.3_kneaddata	Deferribacterota	10822	P	338779	2197	340976	0.09882
mgm4540251.3_kneaddata	Desulfobacterota_A	11509	P	59096	454	59550	0.01726
mgm4540251.3_kneaddata	Firmicutes	12188	P	11267	445	11712	0.00339
mgm4540251.3_kneaddata	Proteobacteria	22518	P	2719	23	2742	0.00079
mgm4540251.3_kneaddata	Verrucomicrobiota	33333	P	965	100	1065	0.00031
mgm4540251.3_kneaddata	Actinobacteriota	615	P	954	5	959	0.00028
mgm4540251.3_kneaddata	Cyanobacteria	9876	P	242	3	245	0.00007
mgm4540251.3_kneaddata	Spirochaetota	32587	P	169	0	169	0.00005
mgm4540251.3_kneaddata	Firmicutes_B	17289	P	113	7	120	0.00003
mgm4540251.3_kneaddata	Campylobacterota	8700	P	43	0	43	0.00001
mgm4540251.3_kneaddata	Firmicutes_C	17613	P	41	0	41	0.00001
mgm4540251.3_kneaddata	Firmicutes_I	18140	P	27	0	27	0.00001
mgm4540251.3_kneaddata	Elusimicrobiota	11888	P	3	0	3	0.00000
mgm4540251.3_kneaddata	Thermotogota	33086	P	2	0	2	0.00000
mgm4540252.3_kneaddata	Firmicutes_A	14608	P	2733260	28515	2761775	0.76861
mgm4540252.3_kneaddata	Bacteroidota	4587	P	584409	4481	588890	0.16389
mgm4540252.3_kneaddata	Deferribacterota	10822	P	166711	1017	167728	0.04668
mgm4540252.3_kneaddata	Desulfobacterota_A	11509	P	59792	381	60173	0.01675
mgm4540252.3_kneaddata	Firmicutes	12188	P	8379	274	8653	0.00241
mgm4540252.3_kneaddata	Proteobacteria	22518	P	2872	25	2897	0.00081
mgm4540252.3_kneaddata	Verrucomicrobiota	33333	P	1401	139	1540	0.00043
mgm4540252.3_kneaddata	Actinobacteriota	615	P	805	4	809	0.00023
mgm4540252.3_kneaddata	Cyanobacteria	9876	P	272	3	275	0.00008
mgm4540252.3_kneaddata	Firmicutes_B	17289	P	233	14	247	0.00007
mgm4540252.3_kneaddata	Spirochaetota	32587	P	106	0	106	0.00003
mgm4540252.3_kneaddata	Campylobacterota	8700	P	34	0	34	0.00001
mgm4540252.3_kneaddata	Firmicutes_C	17613	P	29	0	29	0.00001
mgm4540252.3_kneaddata	Firmicutes_I	18140	P	28	0	28	0.00001
mgm4540252.3_kneaddata	Thermotogota	33086	P	3	0	3	0.00000
mgm4540252.3_kneaddata	Elusimicrobiota	11888	P	2	0	2	0.00000
mgm4541194.3_kneaddata	Bacteroidota	4587	P	5133324	52917	5186241	0.63136
mgm4541194.3_kneaddata	Firmicutes_A	14608	P	2142372	20882	2163254	0.26335
mgm4541194.3_kneaddata	Verrucomicrobiota	33333	P	296209	31054	327263	0.03984
mgm4541194.3_kneaddata	Deferribacterota	10822	P	249633	1762	251395	0.03060
mgm4541194.3_kneaddata	Proteobacteria	22518	P	101059	2218	103277	0.01257
mgm4541194.3_kneaddata	Firmicutes	12188	P	89773	2239	92012	0.01120
mgm4541194.3_kneaddata	Desulfobacterota_A	11509	P	57555	297	57852	0.00704
mgm4541194.3_kneaddata	Actinobacteriota	615	P	18839	108	18947	0.00231
mgm4541194.3_kneaddata	Cyanobacteria	9876	P	13104	392	13496	0.00164
mgm4541194.3_kneaddata	Firmicutes_B	17289	P	201	14	215	0.00003
mgm4541194.3_kneaddata	Campylobacterota	8700	P	175	0	175	0.00002
mgm4541194.3_kneaddata	Spirochaetota	32587	P	172	0	172	0.00002
mgm4541194.3_kneaddata	Firmicutes_I	18140	P	51	0	51	0.00001
mgm4541194.3_kneaddata	Firmicutes_C	17613	P	24	0	24	0.00000
mgm4541194.3_kneaddata	Elusimicrobiota	11888	P	7	0	7	0.00000
mgm4541194.3_kneaddata	Thermotogota	33086	P	3	0	3	0.00000
mgm4548364.3_kneaddata	Firmicutes_A	14608	P	3118208	23868	3142076	0.43917
mgm4548364.3_kneaddata	Bacteroidota	4587	P	2941456	30935	2972391	0.41545
mgm4548364.3_kneaddata	Deferribacterota	10822	P	489427	3279	492706	0.06887
mgm4548364.3_kneaddata	Verrucomicrobiota	33333	P	168783	16767	185550	0.02593
mgm4548364.3_kneaddata	Proteobacteria	22518	P	126181	1974	128155	0.01791
mgm4548364.3_kneaddata	Firmicutes	12188	P	121161	2138	123299	0.01723
mgm4548364.3_kneaddata	Actinobacteriota	615	P	62477	336	62813	0.00878
mgm4548364.3_kneaddata	Cyanobacteria	9876	P	30091	1162	31253	0.00437
mgm4548364.3_kneaddata	Firmicutes_B	17289	P	12730	854	13584	0.00190
mgm4548364.3_kneaddata	Desulfobacterota_A	11509	P	1990	71	2061	0.00029
mgm4548364.3_kneaddata	Spirochaetota	32587	P	289	1	290	0.00004
mgm4548364.3_kneaddata	Campylobacterota	8700	P	252	0	252	0.00004
mgm4548364.3_kneaddata	Firmicutes_I	18140	P	93	0	93	0.00001
mgm4548364.3_kneaddata	Firmicutes_C	17613	P	36	0	36	0.00001
mgm4548364.3_kneaddata	Thermotogota	33086	P	22	0	22	0.00000
mgm4548364.3_kneaddata	Elusimicrobiota	11888	P	6	0	6	0.00000
mgm4725857_kneaddata	Firmicutes_A	14608	P	9954329	76704	10031033	0.67504
mgm4725857_kneaddata	Bacteroidota	4587	P	4319664	27110	4346774	0.29252
mgm4725857_kneaddata	Firmicutes	12188	P	430102	20960	451062	0.03035
mgm4725857_kneaddata	Verrucomicrobiota	33333	P	14341	1072	15413	0.00104
mgm4725857_kneaddata	Actinobacteriota	615	P	10234	46	10280	0.00069
mgm4725857_kneaddata	Cyanobacteria	9876	P	1305	32	1337	0.00009
mgm4725857_kneaddata	Desulfobacterota_A	11509	P	1202	222	1424	0.00010
mgm4725857_kneaddata	Firmicutes_B	17289	P	899	45	944	0.00006
mgm4725857_kneaddata	Proteobacteria	22518	P	649	3	652	0.00004
mgm4725857_kneaddata	Campylobacterota	8700	P	334	0	334	0.00002
mgm4725857_kneaddata	Spirochaetota	32587	P	282	1	283	0.00002
mgm4725857_kneaddata	Firmicutes_I	18140	P	193	0	193	0.00001
mgm4725857_kneaddata	Thermotogota	33086	P	131	0	131	0.00001
mgm4725857_kneaddata	Firmicutes_C	17613	P	66	0	66	0.00000
mgm4725857_kneaddata	Deferribacterota	10822	P	59	0	59	0.00000
mgm4725857_kneaddata	Elusimicrobiota	11888	P	4	0	4	0.00000
mgm4725858_kneaddata	Bacteroidota	4587	P	17629751	76687	17706438	0.81528
mgm4725858_kneaddata	Firmicutes_A	14608	P	3237553	23750	3261303	0.15016
mgm4725858_kneaddata	Firmicutes	12188	P	345368	31785	377153	0.01737
mgm4725858_kneaddata	Verrucomicrobiota	33333	P	342146	19261	361407	0.01664
mgm4725858_kneaddata	Actinobacteriota	615	P	7825	34	7859	0.00036
mgm4725858_kneaddata	Cyanobacteria	9876	P	932	21	953	0.00004
mgm4725858_kneaddata	Proteobacteria	22518	P	838	4	842	0.00004
mgm4725858_kneaddata	Firmicutes_B	17289	P	699	25	724	0.00003
mgm4725858_kneaddata	Desulfobacterota_A	11509	P	583	61	644	0.00003
mgm4725858_kneaddata	Firmicutes_I	18140	P	413	0	413	0.00002
mgm4725858_kneaddata	Spirochaetota	32587	P	215	1	216	0.00001
mgm4725858_kneaddata	Campylobacterota	8700	P	135	0	135	0.00001
mgm4725858_kneaddata	Deferribacterota	10822	P	63	0	63	0.00000
mgm4725858_kneaddata	Thermotogota	33086	P	31	0	31	0.00000
mgm4725858_kneaddata	Firmicutes_C	17613	P	24	0	24	0.00000
mgm4725858_kneaddata	Elusimicrobiota	11888	P	5	0	5	0.00000
mgm4725859_kneaddata	Bacteroidota	4587	P	7224458	6726	7231184	0.55053
mgm4725859_kneaddata	Firmicutes	12188	P	3688724	96773	3785497	0.28820
mgm4725859_kneaddata	Firmicutes_A	14608	P	1919438	3948	1923386	0.14643
mgm4725859_kneaddata	Actinobacteriota	615	P	156251	90	156341	0.01190
mgm4725859_kneaddata	Cyanobacteria	9876	P	15703	469	16172	0.00123
mgm4725859_kneaddata	Verrucomicrobiota	33333	P	11879	286	12165	0.00093
mgm4725859_kneaddata	Campylobacterota	8700	P	3288	1	3289	0.00025
mgm4725859_kneaddata	Firmicutes_B	17289	P	2858	45	2903	0.00022
mgm4725859_kneaddata	Firmicutes_I	18140	P	1409	0	1409	0.00011
mgm4725859_kneaddata	Proteobacteria	22518	P	1287	2	1289	0.00010
mgm4725859_kneaddata	Desulfobacterota_A	11509	P	1082	65	1147	0.00009
mgm4725859_kneaddata	Deferribacterota	10822	P	95	0	95	0.00001
mgm4725859_kneaddata	Spirochaetota	32587	P	54	0	54	0.00000
mgm4725859_kneaddata	Firmicutes_C	17613	P	4	0	4	0.00000
mgm4725859_kneaddata	Elusimicrobiota	11888	P	2	0	2	0.00000
mgm4725859_kneaddata	Thermotogota	33086	P	1	0	1	0.00000
mgm4725860_kneaddata	Firmicutes_A	14608	P	11019507	60998	11080505	0.61699
mgm4725860_kneaddata	Bacteroidota	4587	P	6048510	24127	6072637	0.33814
mgm4725860_kneaddata	Firmicutes	12188	P	489699	31283	520982	0.02901
mgm4725860_kneaddata	Firmicutes_B	17289	P	140044	5564	145608	0.00811
mgm4725860_kneaddata	Actinobacteriota	615	P	105411	169	105580	0.00588
mgm4725860_kneaddata	Verrucomicrobiota	33333	P	26254	1528	27782	0.00155
mgm4725860_kneaddata	Desulfobacterota_A	11509	P	2207	196	2403	0.00013
mgm4725860_kneaddata	Proteobacteria	22518	P	1366	25	1391	0.00008
mgm4725860_kneaddata	Cyanobacteria	9876	P	1320	49	1369	0.00008
mgm4725860_kneaddata	Campylobacterota	8700	P	257	0	257	0.00001
mgm4725860_kneaddata	Firmicutes_I	18140	P	147	0	147	0.00001
mgm4725860_kneaddata	Spirochaetota	32587	P	146	0	146	0.00001
mgm4725860_kneaddata	Firmicutes_C	17613	P	63	0	63	0.00000
mgm4725860_kneaddata	Deferribacterota	10822	P	57	0	57	0.00000
mgm4725860_kneaddata	Elusimicrobiota	11888	P	10	0	10	0.00000
mgm4725860_kneaddata	Thermotogota	33086	P	4	0	4	0.00000
mgm4725861_kneaddata	Firmicutes_A	14608	P	10986745	81545	11068290	0.56611
mgm4725861_kneaddata	Bacteroidota	4587	P	7964055	37768	8001823	0.40927
mgm4725861_kneaddata	Firmicutes	12188	P	323263	28948	352211	0.01801
mgm4725861_kneaddata	Verrucomicrobiota	33333	P	107403	6050	113453	0.00580
mgm4725861_kneaddata	Actinobacteriota	615	P	10733	38	10771	0.00055
mgm4725861_kneaddata	Desulfobacterota_A	11509	P	1432	210	1642	0.00008
mgm4725861_kneaddata	Cyanobacteria	9876	P	1106	16	1122	0.00006
mgm4725861_kneaddata	Firmicutes_B	17289	P	785	29	814	0.00004
mgm4725861_kneaddata	Proteobacteria	22518	P	719	3	722	0.00004
mgm4725861_kneaddata	Spirochaetota	32587	P	218	0	218	0.00001
mgm4725861_kneaddata	Campylobacterota	8700	P	209	0	209	0.00001
mgm4725861_kneaddata	Thermotogota	33086	P	149	0	149	0.00001
mgm4725861_kneaddata	Firmicutes_I	18140	P	81	0	81	0.00000
mgm4725861_kneaddata	Firmicutes_C	17613	P	54	0	54	0.00000
mgm4725861_kneaddata	Deferribacterota	10822	P	36	0	36	0.00000
mgm4725861_kneaddata	Elusimicrobiota	11888	P	13	0	13	0.00000
mgm4725862_kneaddata	Bacteroidota	4587	P	5803360	28069	5831429	0.94750
mgm4725862_kneaddata	Firmicutes_A	14608	P	174109	2293	176402	0.02866
mgm4725862_kneaddata	Firmicutes	12188	P	115756	13882	129638	0.02106
mgm4725862_kneaddata	Cyanobacteria	9876	P	9450	35	9485	0.00154
mgm4725862_kneaddata	Verrucomicrobiota	33333	P	5069	312	5381	0.00087
mgm4725862_kneaddata	Actinobacteriota	615	P	1454	5	1459	0.00024
mgm4725862_kneaddata	Proteobacteria	22518	P	350	2	352	0.00006
mgm4725862_kneaddata	Spirochaetota	32587	P	114	0	114	0.00002
mgm4725862_kneaddata	Desulfobacterota_A	11509	P	100	8	108	0.00002
mgm4725862_kneaddata	Campylobacterota	8700	P	94	0	94	0.00002
mgm4725862_kneaddata	Firmicutes_I	18140	P	55	0	55	0.00001
mgm4725862_kneaddata	Deferribacterota	10822	P	16	0	16	0.00000
mgm4725862_kneaddata	Firmicutes_C	17613	P	11	0	11	0.00000
mgm4725862_kneaddata	Firmicutes_B	17289	P	8	0	8	0.00000
mgm4725862_kneaddata	Elusimicrobiota	11888	P	3	0	3	0.00000
mgm4725863_kneaddata	Firmicutes	12188	P	4427353	125827	4553180	0.58503
mgm4725863_kneaddata	Bacteroidota	4587	P	2189995	6395	2196390	0.28221
mgm4725863_kneaddata	Firmicutes_A	14608	P	1010832	7765	1018597	0.13088
mgm4725863_kneaddata	Verrucomicrobiota	33333	P	7098	422	7520	0.00097
mgm4725863_kneaddata	Actinobacteriota	615	P	2642	5	2647	0.00034
mgm4725863_kneaddata	Cyanobacteria	9876	P	2472	10	2482	0.00032
mgm4725863_kneaddata	Proteobacteria	22518	P	609	2	611	0.00008
mgm4725863_kneaddata	Desulfobacterota_A	11509	P	445	65	510	0.00007
mgm4725863_kneaddata	Spirochaetota	32587	P	347	1	348	0.00004
mgm4725863_kneaddata	Firmicutes_B	17289	P	157	6	163	0.00002
mgm4725863_kneaddata	Campylobacterota	8700	P	138	0	138	0.00002
mgm4725863_kneaddata	Deferribacterota	10822	P	136	0	136	0.00002
mgm4725863_kneaddata	Firmicutes_I	18140	P	40	0	40	0.00001
mgm4725863_kneaddata	Firmicutes_C	17613	P	21	0	21	0.00000
mgm4725863_kneaddata	Thermotogota	33086	P	12	0	12	0.00000
mgm4725863_kneaddata	Elusimicrobiota	11888	P	4	0	4	0.00000
mgm4725864_kneaddata	Bacteroidota	4587	P	13470304	41648	13511952	0.65780
mgm4725864_kneaddata	Firmicutes_A	14608	P	5599576	29699	5629275	0.27405
mgm4725864_kneaddata	Firmicutes	12188	P	919652	55010	974662	0.04745
mgm4725864_kneaddata	Actinobacteriota	615	P	177724	274	177998	0.00867
mgm4725864_kneaddata	Firmicutes_B	17289	P	172688	6490	179178	0.00872
mgm4725864_kneaddata	Verrucomicrobiota	33333	P	59439	3360	62799	0.00306
mgm4725864_kneaddata	Desulfobacterota_A	11509	P	1829	159	1988	0.00010
mgm4725864_kneaddata	Cyanobacteria	9876	P	1339	53	1392	0.00007
mgm4725864_kneaddata	Proteobacteria	22518	P	1175	15	1190	0.00006
mgm4725864_kneaddata	Campylobacterota	8700	P	205	0	205	0.00001
mgm4725864_kneaddata	Firmicutes_I	18140	P	138	0	138	0.00001
mgm4725864_kneaddata	Spirochaetota	32587	P	112	0	112	0.00001
mgm4725864_kneaddata	Deferribacterota	10822	P	98	0	98	0.00000
mgm4725864_kneaddata	Firmicutes_C	17613	P	44	0	44	0.00000
mgm4725864_kneaddata	Elusimicrobiota	11888	P	8	0	8	0.00000
mgm4725864_kneaddata	Thermotogota	33086	P	7	0	7	0.00000
mgm4725865_kneaddata	Bacteroidota	4587	P	11922008	59055	11981063	0.61744
mgm4725865_kneaddata	Firmicutes_A	14608	P	4547424	39139	4586563	0.23637
mgm4725865_kneaddata	Firmicutes	12188	P	2552374	100472	2652846	0.13671
mgm4725865_kneaddata	Actinobacteriota	615	P	102181	270	102451	0.00528
mgm4725865_kneaddata	Firmicutes_B	17289	P	40737	1913	42650	0.00220
mgm4725865_kneaddata	Verrucomicrobiota	33333	P	25994	1829	27823	0.00143
mgm4725865_kneaddata	Cyanobacteria	9876	P	4612	367	4979	0.00026
mgm4725865_kneaddata	Campylobacterota	8700	P	1917	1	1918	0.00010
mgm4725865_kneaddata	Proteobacteria	22518	P	1581	28	1609	0.00008
mgm4725865_kneaddata	Desulfobacterota_A	11509	P	985	155	1140	0.00006
mgm4725865_kneaddata	Firmicutes_I	18140	P	836	0	836	0.00004
mgm4725865_kneaddata	Spirochaetota	32587	P	284	1	285	0.00001
mgm4725865_kneaddata	Deferribacterota	10822	P	146	0	146	0.00001
mgm4725865_kneaddata	Firmicutes_C	17613	P	25	0	25	0.00000
mgm4725865_kneaddata	Thermotogota	33086	P	10	0	10	0.00000
mgm4725865_kneaddata	Elusimicrobiota	11888	P	6	0	6	0.00000
mgm4725866_kneaddata	Bacteroidota	4587	P	6304749	40098	6344847	0.89814
mgm4725866_kneaddata	Firmicutes_A	14608	P	447491	5138	452629	0.06407
mgm4725866_kneaddata	Firmicutes	12188	P	228281	8650	236931	0.03354
mgm4725866_kneaddata	Verrucomicrobiota	33333	P	17870	1346	19216	0.00272
mgm4725866_kneaddata	Actinobacteriota	615	P	5465	35	5500	0.00078
mgm4725866_kneaddata	Cyanobacteria	9876	P	3310	42	3352	0.00047
mgm4725866_kneaddata	Campylobacterota	8700	P	663	0	663	0.00009
mgm4725866_kneaddata	Proteobacteria	22518	P	440	3	443	0.00006
mgm4725866_kneaddata	Spirochaetota	32587	P	280	1	281	0.00004
mgm4725866_kneaddata	Firmicutes_I	18140	P	250	0	250	0.00004
mgm4725866_kneaddata	Desulfobacterota_A	11509	P	194	17	211	0.00003
mgm4725866_kneaddata	Firmicutes_B	17289	P	43	2	45	0.00001
mgm4725866_kneaddata	Deferribacterota	10822	P	39	0	39	0.00001
mgm4725866_kneaddata	Firmicutes_C	17613	P	15	0	15	0.00000
mgm4725866_kneaddata	Elusimicrobiota	11888	P	7	0	7	0.00000
mgm4725866_kneaddata	Thermotogota	33086	P	4	0	4	0.00000
mgm4725867_kneaddata	Bacteroidota	4587	P	19449133	83850	19532983	0.96114
mgm4725867_kneaddata	Firmicutes	12188	P	345469	34606	380075	0.01870
mgm4725867_kneaddata	Firmicutes_A	14608	P	278589	4249	282838	0.01392
mgm4725867_kneaddata	Verrucomicrobiota	33333	P	103791	5386	109177	0.00537
mgm4725867_kneaddata	Actinobacteriota	615	P	12956	52	13008	0.00064
mgm4725867_kneaddata	Cyanobacteria	9876	P	2109	23	2132	0.00010
mgm4725867_kneaddata	Proteobacteria	22518	P	1303	6	1309	0.00006
mgm4725867_kneaddata	Desulfobacterota_A	11509	P	317	30	347	0.00002
mgm4725867_kneaddata	Firmicutes_B	17289	P	307	11	318	0.00002
mgm4725867_kneaddata	Spirochaetota	32587	P	212	0	212	0.00001
mgm4725867_kneaddata	Firmicutes_I	18140	P	160	0	160	0.00001
mgm4725867_kneaddata	Campylobacterota	8700	P	77	0	77	0.00000
mgm4725867_kneaddata	Deferribacterota	10822	P	70	0	70	0.00000
mgm4725867_kneaddata	Elusimicrobiota	11888	P	4	0	4	0.00000
mgm4725867_kneaddata	Firmicutes_C	17613	P	3	0	3	0.00000
mgm4725867_kneaddata	Thermotogota	33086	P	3	0	3	0.00000
mgm4725868_kneaddata	Bacteroidota	4587	P	13319637	64758	13384395	0.54860
mgm4725868_kneaddata	Firmicutes_A	14608	P	10154142	81579	10235721	0.41954
mgm4725868_kneaddata	Firmicutes	12188	P	629778	13425	643203	0.02636
mgm4725868_kneaddata	Verrucomicrobiota	33333	P	114262	8155	122417	0.00502
mgm4725868_kneaddata	Actinobacteriota	615	P	5815	35	5850	0.00024
mgm4725868_kneaddata	Firmicutes_B	17289	P	1746	82	1828	0.00007
mgm4725868_kneaddata	Desulfobacterota_A	11509	P	1204	196	1400	0.00006
mgm4725868_kneaddata	Cyanobacteria	9876	P	974	31	1005	0.00004
mgm4725868_kneaddata	Proteobacteria	22518	P	763	4	767	0.00003
mgm4725868_kneaddata	Spirochaetota	32587	P	253	1	254	0.00001
mgm4725868_kneaddata	Firmicutes_I	18140	P	192	0	192	0.00001
mgm4725868_kneaddata	Campylobacterota	8700	P	183	0	183	0.00001
mgm4725868_kneaddata	Deferribacterota	10822	P	92	0	92	0.00000
mgm4725868_kneaddata	Thermotogota	33086	P	86	0	86	0.00000
mgm4725868_kneaddata	Firmicutes_C	17613	P	63	0	63	0.00000
mgm4725868_kneaddata	Elusimicrobiota	11888	P	7	0	7	0.00000
mgm4725869_kneaddata	Bacteroidota	4587	P	11089721	63177	11152898	0.60694
mgm4725869_kneaddata	Firmicutes_A	14608	P	6466448	56158	6522606	0.35496
mgm4725869_kneaddata	Firmicutes	12188	P	472792	39823	512615	0.02790
mgm4725869_kneaddata	Actinobacteriota	615	P	71521	281	71802	0.00391
mgm4725869_kneaddata	Firmicutes_B	17289	P	69581	3144	72725	0.00396
mgm4725869_kneaddata	Verrucomicrobiota	33333	P	35384	2401	37785	0.00206
mgm4725869_kneaddata	Cyanobacteria	9876	P	1934	94	2028	0.00011
mgm4725869_kneaddata	Desulfobacterota_A	11509	P	1073	169	1242	0.00007
mgm4725869_kneaddata	Proteobacteria	22518	P	970	16	986	0.00005
mgm4725869_kneaddata	Campylobacterota	8700	P	328	0	328	0.00002
mgm4725869_kneaddata	Firmicutes_I	18140	P	161	0	161	0.00001
mgm4725869_kneaddata	Spirochaetota	32587	P	156	0	156	0.00001
mgm4725869_kneaddata	Deferribacterota	10822	P	96	0	96	0.00001
mgm4725869_kneaddata	Firmicutes_C	17613	P	45	0	45	0.00000
mgm4725869_kneaddata	Elusimicrobiota	11888	P	9	0	9	0.00000
mgm4725869_kneaddata	Thermotogota	33086	P	2	0	2	0.00000
mgm4725870_kneaddata	Firmicutes_A	14608	P	14186761	110287	14297048	0.72511
mgm4725870_kneaddata	Bacteroidota	4587	P	5153160	34133	5187293	0.26309
mgm4725870_kneaddata	Firmicutes	12188	P	167679	14346	182025	0.00923
mgm4725870_kneaddata	Verrucomicrobiota	33333	P	33663	2489	36152	0.00183
mgm4725870_kneaddata	Actinobacteriota	615	P	8554	42	8596	0.00044
mgm4725870_kneaddata	Desulfobacterota_A	11509	P	1657	321	1978	0.00010
mgm4725870_kneaddata	Cyanobacteria	9876	P	1353	25	1378	0.00007
mgm4725870_kneaddata	Firmicutes_B	17289	P	835	40	875	0.00004
mgm4725870_kneaddata	Proteobacteria	22518	P	762	5	767	0.00004
mgm4725870_kneaddata	Campylobacterota	8700	P	225	0	225	0.00001
mgm4725870_kneaddata	Spirochaetota	32587	P	208	1	209	0.00001
mgm4725870_kneaddata	Thermotogota	33086	P	204	0	204	0.00001
mgm4725870_kneaddata	Firmicutes_C	17613	P	121	0	121	0.00001
mgm4725870_kneaddata	Firmicutes_I	18140	P	110	0	110	0.00001
mgm4725870_kneaddata	Deferribacterota	10822	P	53	0	53	0.00000
mgm4725870_kneaddata	Elusimicrobiota	11888	P	6	0	6	0.00000
mgm4725871_kneaddata	Firmicutes_A	14608	P	15521685	109928	15631613	0.68401
mgm4725871_kneaddata	Bacteroidota	4587	P	6709049	35524	6744573	0.29513
mgm4725871_kneaddata	Firmicutes	12188	P	281348	28658	310006	0.01357
mgm4725871_kneaddata	Verrucomicrobiota	33333	P	142357	9170	151527	0.00663
mgm4725871_kneaddata	Actinobacteriota	615	P	8637	38	8675	0.00038
mgm4725871_kneaddata	Desulfobacterota_A	11509	P	1798	298	2096	0.00009
mgm4725871_kneaddata	Cyanobacteria	9876	P	1508	26	1534	0.00007
mgm4725871_kneaddata	Firmicutes_B	17289	P	1261	53	1314	0.00006
mgm4725871_kneaddata	Proteobacteria	22518	P	788	4	792	0.00003
mgm4725871_kneaddata	Spirochaetota	32587	P	341	1	342	0.00002
mgm4725871_kneaddata	Campylobacterota	8700	P	197	0	197	0.00001
mgm4725871_kneaddata	Thermotogota	33086	P	131	0	131	0.00001
mgm4725871_kneaddata	Firmicutes_I	18140	P	108	0	108	0.00000
mgm4725871_kneaddata	Firmicutes_C	17613	P	73	0	73	0.00000
mgm4725871_kneaddata	Deferribacterota	10822	P	69	0	69	0.00000
mgm4725871_kneaddata	Elusimicrobiota	11888	P	6	0	6	0.00000
mgm4725872_kneaddata	Bacteroidota	4587	P	17660855	83134	17743989	0.68564
mgm4725872_kneaddata	Firmicutes_A	14608	P	6783037	45828	6828865	0.26387
mgm4725872_kneaddata	Firmicutes	12188	P	711909	60570	772479	0.02985
mgm4725872_kneaddata	Verrucomicrobiota	33333	P	487982	24741	512723	0.01981
mgm4725872_kneaddata	Actinobacteriota	615	P	15262	58	15320	0.00059
mgm4725872_kneaddata	Proteobacteria	22518	P	1339	7	1346	0.00005
mgm4725872_kneaddata	Desulfobacterota_A	11509	P	1165	128	1293	0.00005
mgm4725872_kneaddata	Firmicutes_B	17289	P	1006	33	1039	0.00004
mgm4725872_kneaddata	Cyanobacteria	9876	P	883	20	903	0.00003
mgm4725872_kneaddata	Spirochaetota	32587	P	548	2	550	0.00002
mgm4725872_kneaddata	Firmicutes_I	18140	P	409	0	409	0.00002
mgm4725872_kneaddata	Campylobacterota	8700	P	221	0	221	0.00001
mgm4725872_kneaddata	Deferribacterota	10822	P	74	0	74	0.00000
mgm4725872_kneaddata	Firmicutes_C	17613	P	60	0	60	0.00000
mgm4725872_kneaddata	Thermotogota	33086	P	60	0	60	0.00000
mgm4725872_kneaddata	Elusimicrobiota	11888	P	5	0	5	0.00000
mgm4725873_kneaddata	Bacteroidota	4587	P	22207847	142223	22350070	0.92473
mgm4725873_kneaddata	Firmicutes	12188	P	1072967	65282	1138249	0.04709
mgm4725873_kneaddata	Firmicutes_A	14608	P	504579	12728	517307	0.02140
mgm4725873_kneaddata	Actinobacteriota	615	P	128026	1022	129048	0.00534
mgm4725873_kneaddata	Verrucomicrobiota	33333	P	19700	1869	21569	0.00089
mgm4725873_kneaddata	Cyanobacteria	9876	P	6242	517	6759	0.00028
mgm4725873_kneaddata	Campylobacterota	8700	P	2826	3	2829	0.00012
mgm4725873_kneaddata	Firmicutes_I	18140	P	1209	0	1209	0.00005
mgm4725873_kneaddata	Firmicutes_B	17289	P	848	53	901	0.00004
mgm4725873_kneaddata	Proteobacteria	22518	P	809	5	814	0.00003
mgm4725873_kneaddata	Desulfobacterota_A	11509	P	350	58	408	0.00002
mgm4725873_kneaddata	Spirochaetota	32587	P	46	0	46	0.00000
mgm4725873_kneaddata	Deferribacterota	10822	P	22	0	22	0.00000
mgm4725873_kneaddata	Elusimicrobiota	11888	P	6	0	6	0.00000
mgm4725873_kneaddata	Thermotogota	33086	P	1	0	1	0.00000
mgm4725874_kneaddata	Bacteroidota	4587	P	21218663	142332	21360995	0.73816
mgm4725874_kneaddata	Firmicutes_A	14608	P	6725403	65969	6791372	0.23469
mgm4725874_kneaddata	Firmicutes	12188	P	513981	38391	552372	0.01909
mgm4725874_kneaddata	Firmicutes_B	17289	P	97824	6098	103922	0.00359
mgm4725874_kneaddata	Verrucomicrobiota	33333	P	61044	5705	66749	0.00231
mgm4725874_kneaddata	Actinobacteriota	615	P	55875	200	56075	0.00194
mgm4725874_kneaddata	Cyanobacteria	9876	P	2215	182	2397	0.00008
mgm4725874_kneaddata	Desulfobacterota_A	11509	P	1276	254	1530	0.00005
mgm4725874_kneaddata	Proteobacteria	22518	P	1124	17	1141	0.00004
mgm4725874_kneaddata	Campylobacterota	8700	P	537	0	537	0.00002
mgm4725874_kneaddata	Firmicutes_I	18140	P	526	0	526	0.00002
mgm4725874_kneaddata	Deferribacterota	10822	P	155	0	155	0.00001
mgm4725874_kneaddata	Spirochaetota	32587	P	149	0	149	0.00001
mgm4725874_kneaddata	Firmicutes_C	17613	P	38	0	38	0.00000
mgm4725874_kneaddata	Elusimicrobiota	11888	P	10	0	10	0.00000
mgm4725874_kneaddata	Thermotogota	33086	P	3	0	3	0.00000
mgm4725875_kneaddata	Bacteroidota	4587	P	14286569	79013	14365582	0.73004
mgm4725875_kneaddata	Firmicutes_A	14608	P	4870811	40607	4911418	0.24959
mgm4725875_kneaddata	Firmicutes	12188	P	255891	17140	273031	0.01388
mgm4725875_kneaddata	Verrucomicrobiota	33333	P	108067	6792	114859	0.00584
mgm4725875_kneaddata	Actinobacteriota	615	P	9187	45	9232	0.00047
mgm4725875_kneaddata	Cyanobacteria	9876	P	780	23	803	0.00004
mgm4725875_kneaddata	Proteobacteria	22518	P	759	5	764	0.00004
mgm4725875_kneaddata	Desulfobacterota_A	11509	P	696	99	795	0.00004
mgm4725875_kneaddata	Firmicutes_B	17289	P	497	21	518	0.00003
mgm4725875_kneaddata	Campylobacterota	8700	P	289	0	289	0.00001
mgm4725875_kneaddata	Spirochaetota	32587	P	229	1	230	0.00001
mgm4725875_kneaddata	Firmicutes_I	18140	P	149	0	149	0.00001
mgm4725875_kneaddata	Deferribacterota	10822	P	60	0	60	0.00000
mgm4725875_kneaddata	Thermotogota	33086	P	53	0	53	0.00000
mgm4725875_kneaddata	Firmicutes_C	17613	P	49	0	49	0.00000
mgm4725875_kneaddata	Elusimicrobiota	11888	P	7	0	7	0.00000
mgm4725876_kneaddata	Bacteroidota	4587	P	8969706	21565	8991271	0.81759
mgm4725876_kneaddata	Firmicutes	12188	P	988062	50353	1038415	0.09443
mgm4725876_kneaddata	Firmicutes_A	14608	P	781484	2866	784350	0.07132
mgm4725876_kneaddata	Actinobacteriota	615	P	164033	268	164301	0.01494
mgm4725876_kneaddata	Verrucomicrobiota	33333	P	10063	473	10536	0.00096
mgm4725876_kneaddata	Cyanobacteria	9876	P	5684	84	5768	0.00052
mgm4725876_kneaddata	Campylobacterota	8700	P	671	0	671	0.00006
mgm4725876_kneaddata	Proteobacteria	22518	P	640	2	642	0.00006
mgm4725876_kneaddata	Firmicutes_B	17289	P	526	16	542	0.00005
mgm4725876_kneaddata	Firmicutes_I	18140	P	327	0	327	0.00003
mgm4725876_kneaddata	Desulfobacterota_A	11509	P	284	31	315	0.00003
mgm4725876_kneaddata	Spirochaetota	32587	P	48	0	48	0.00000
mgm4725876_kneaddata	Deferribacterota	10822	P	42	0	42	0.00000
mgm4725876_kneaddata	Firmicutes_C	17613	P	1	0	1	0.00000
Sample_H2OW0M8_kneaddata	Bacteroidota	4587	P	6948305	99557	7047862	0.55069
Sample_H2OW0M8_kneaddata	Firmicutes_A	14608	P	3944853	79980	4024833	0.31448
Sample_H2OW0M8_kneaddata	Firmicutes	12188	P	1028295	10852	1039147	0.08119
Sample_H2OW0M8_kneaddata	Verrucomicrobiota	33333	P	229727	38965	268692	0.02099
Sample_H2OW0M8_kneaddata	Actinobacteriota	615	P	211557	1381	212938	0.01664
Sample_H2OW0M8_kneaddata	Proteobacteria	22518	P	126628	2384	129012	0.01008
Sample_H2OW0M8_kneaddata	Cyanobacteria	9876	P	32666	442	33108	0.00259
Sample_H2OW0M8_kneaddata	Desulfobacterota_A	11509	P	30761	242	31003	0.00242
Sample_H2OW0M8_kneaddata	Deferribacterota	10822	P	9031	112	9143	0.00071
Sample_H2OW0M8_kneaddata	Firmicutes_B	17289	P	1746	225	1971	0.00015
Sample_H2OW0M8_kneaddata	Spirochaetota	32587	P	217	1	218	0.00002
Sample_H2OW0M8_kneaddata	Campylobacterota	8700	P	150	0	150	0.00001
Sample_H2OW0M8_kneaddata	Firmicutes_I	18140	P	55	0	55	0.00000
Sample_H2OW0M8_kneaddata	Firmicutes_C	17613	P	41	0	41	0.00000
Sample_H2OW0M8_kneaddata	Thermotogota	33086	P	14	0	14	0.00000
Sample_H2OW0M8_kneaddata	Elusimicrobiota	11888	P	9	0	9	0.00000
SRR10103340_1_kneaddata_paired	Firmicutes_A	14608	P	16937899	63625	17001524	0.75131
SRR10103340_1_kneaddata_paired	Bacteroidota	4587	P	2691049	23512	2714561	0.11996
SRR10103340_1_kneaddata_paired	Desulfobacterota_A	11509	P	1532128	13124	1545252	0.06829
SRR10103340_1_kneaddata_paired	Campylobacterota	8700	P	1052004	61	1052065	0.04649
SRR10103340_1_kneaddata_paired	Deferribacterota	10822	P	184431	7	184438	0.00815
SRR10103340_1_kneaddata_paired	Proteobacteria	22518	P	54257	87	54344	0.00240
SRR10103340_1_kneaddata_paired	Firmicutes	12188	P	29152	1113	30265	0.00134
SRR10103340_1_kneaddata_paired	Actinobacteriota	615	P	17365	42	17407	0.00077
SRR10103340_1_kneaddata_paired	Spirochaetota	32587	P	12205	6	12211	0.00054
SRR10103340_1_kneaddata_paired	Cyanobacteria	9876	P	11148	46	11194	0.00049
SRR10103340_1_kneaddata_paired	Firmicutes_B	17289	P	3075	96	3171	0.00014
SRR10103340_1_kneaddata_paired	Verrucomicrobiota	33333	P	1894	87	1981	0.00009
SRR10103340_1_kneaddata_paired	Firmicutes_C	17613	P	478	0	478	0.00002
SRR10103340_1_kneaddata_paired	Firmicutes_I	18140	P	264	0	264	0.00001
SRR10103340_1_kneaddata_paired	Elusimicrobiota	11888	P	83	0	83	0.00000
SRR10103340_1_kneaddata_paired	Thermotogota	33086	P	70	0	70	0.00000
SRR10103341_1_kneaddata_paired	Firmicutes_A	14608	P	21403663	71317	21474980	0.71717
SRR10103341_1_kneaddata_paired	Bacteroidota	4587	P	4033544	28698	4062242	0.13566
SRR10103341_1_kneaddata_paired	Desulfobacterota_A	11509	P	1919694	13156	1932850	0.06455
SRR10103341_1_kneaddata_paired	Campylobacterota	8700	P	1841199	81	1841280	0.06149
SRR10103341_1_kneaddata_paired	Deferribacterota	10822	P	368785	16	368801	0.01232
SRR10103341_1_kneaddata_paired	Proteobacteria	22518	P	98514	128	98642	0.00329
SRR10103341_1_kneaddata_paired	Spirochaetota	32587	P	58916	20	58936	0.00197
SRR10103341_1_kneaddata_paired	Firmicutes	12188	P	57482	1550	59032	0.00197
SRR10103341_1_kneaddata_paired	Actinobacteriota	615	P	26805	68	26873	0.00090
SRR10103341_1_kneaddata_paired	Cyanobacteria	9876	P	14011	81	14092	0.00047
SRR10103341_1_kneaddata_paired	Verrucomicrobiota	33333	P	2895	93	2988	0.00010
SRR10103341_1_kneaddata_paired	Firmicutes_B	17289	P	2280	53	2333	0.00008
SRR10103341_1_kneaddata_paired	Firmicutes_C	17613	P	534	0	534	0.00002
SRR10103341_1_kneaddata_paired	Firmicutes_I	18140	P	380	0	380	0.00001
SRR10103341_1_kneaddata_paired	Thermotogota	33086	P	92	0	92	0.00000
SRR10103341_1_kneaddata_paired	Elusimicrobiota	11888	P	68	0	68	0.00000
SRR10103342_1_kneaddata_paired	Firmicutes_A	14608	P	15601091	48594	15649685	0.65888
SRR10103342_1_kneaddata_paired	Bacteroidota	4587	P	4963548	47807	5011355	0.21099
SRR10103342_1_kneaddata_paired	Desulfobacterota_A	11509	P	1506619	10449	1517068	0.06387
SRR10103342_1_kneaddata_paired	Campylobacterota	8700	P	1263781	57	1263838	0.05321
SRR10103342_1_kneaddata_paired	Deferribacterota	10822	P	93388	2	93390	0.00393
SRR10103342_1_kneaddata_paired	Proteobacteria	22518	P	85390	112	85502	0.00360
SRR10103342_1_kneaddata_paired	Firmicutes	12188	P	64212	1453	65665	0.00276
SRR10103342_1_kneaddata_paired	Actinobacteriota	615	P	28403	103	28506	0.00120
SRR10103342_1_kneaddata_paired	Cyanobacteria	9876	P	19967	86	20053	0.00084
SRR10103342_1_kneaddata_paired	Verrucomicrobiota	33333	P	12600	478	13078	0.00055
SRR10103342_1_kneaddata_paired	Firmicutes_B	17289	P	1793	43	1836	0.00008
SRR10103342_1_kneaddata_paired	Spirochaetota	32587	P	896	0	896	0.00004
SRR10103342_1_kneaddata_paired	Firmicutes_C	17613	P	614	0	614	0.00003
SRR10103342_1_kneaddata_paired	Firmicutes_I	18140	P	306	0	306	0.00001
SRR10103342_1_kneaddata_paired	Thermotogota	33086	P	50	0	50	0.00000
SRR10103342_1_kneaddata_paired	Elusimicrobiota	11888	P	47	0	47	0.00000
SRR10103343_1_kneaddata_paired	Firmicutes_A	14608	P	18416156	61954	18478110	0.74192
SRR10103343_1_kneaddata_paired	Bacteroidota	4587	P	3230896	28626	3259522	0.13087
SRR10103343_1_kneaddata_paired	Desulfobacterota_A	11509	P	1599616	12569	1612185	0.06473
SRR10103343_1_kneaddata_paired	Campylobacterota	8700	P	1296065	69	1296134	0.05204
SRR10103343_1_kneaddata_paired	Deferribacterota	10822	P	120019	3	120022	0.00482
SRR10103343_1_kneaddata_paired	Proteobacteria	22518	P	62111	89	62200	0.00250
SRR10103343_1_kneaddata_paired	Firmicutes	12188	P	42469	1455	43924	0.00176
SRR10103343_1_kneaddata_paired	Cyanobacteria	9876	P	13128	50	13178	0.00053
SRR10103343_1_kneaddata_paired	Actinobacteriota	615	P	12160	36	12196	0.00049
SRR10103343_1_kneaddata_paired	Verrucomicrobiota	33333	P	4489	199	4688	0.00019
SRR10103343_1_kneaddata_paired	Firmicutes_B	17289	P	1484	42	1526	0.00006
SRR10103343_1_kneaddata_paired	Spirochaetota	32587	P	1006	0	1006	0.00004
SRR10103343_1_kneaddata_paired	Firmicutes_C	17613	P	663	1	664	0.00003
SRR10103343_1_kneaddata_paired	Firmicutes_I	18140	P	344	0	344	0.00001
SRR10103343_1_kneaddata_paired	Thermotogota	33086	P	56	0	56	0.00000
SRR10103343_1_kneaddata_paired	Elusimicrobiota	11888	P	43	0	43	0.00000
SRR10120756_1_kneaddata_paired	Firmicutes_A	14608	P	9773762	62046	9835808	0.53232
SRR10120756_1_kneaddata_paired	Bacteroidota	4587	P	5798112	18583	5816695	0.31480
SRR10120756_1_kneaddata_paired	Verrucomicrobiota	33333	P	1726253	103131	1829384	0.09901
SRR10120756_1_kneaddata_paired	Firmicutes	12188	P	767542	9145	776687	0.04203
SRR10120756_1_kneaddata_paired	Actinobacteriota	615	P	198690	281	198971	0.01077
SRR10120756_1_kneaddata_paired	Cyanobacteria	9876	P	6925	163	7088	0.00038
SRR10120756_1_kneaddata_paired	Proteobacteria	22518	P	6269	60	6329	0.00034
SRR10120756_1_kneaddata_paired	Desulfobacterota_A	11509	P	4387	215	4602	0.00025
SRR10120756_1_kneaddata_paired	Spirochaetota	32587	P	578	0	578	0.00003
SRR10120756_1_kneaddata_paired	Firmicutes_B	17289	P	503	19	522	0.00003
SRR10120756_1_kneaddata_paired	Firmicutes_C	17613	P	174	0	174	0.00001
SRR10120756_1_kneaddata_paired	Campylobacterota	8700	P	160	0	160	0.00001
SRR10120756_1_kneaddata_paired	Deferribacterota	10822	P	143	0	143	0.00001
SRR10120756_1_kneaddata_paired	Firmicutes_I	18140	P	58	0	58	0.00000
SRR10120756_1_kneaddata_paired	Thermotogota	33086	P	19	0	19	0.00000
SRR10120756_1_kneaddata_paired	Elusimicrobiota	11888	P	8	0	8	0.00000
SRR10120757_1_kneaddata_paired	Firmicutes_A	14608	P	3701588	22934	3724522	0.61139
SRR10120757_1_kneaddata_paired	Bacteroidota	4587	P	1552140	5719	1557859	0.25573
SRR10120757_1_kneaddata_paired	Verrucomicrobiota	33333	P	635589	40316	675905	0.11095
SRR10120757_1_kneaddata_paired	Firmicutes	12188	P	78730	1409	80139	0.01316
SRR10120757_1_kneaddata_paired	Actinobacteriota	615	P	47868	75	47943	0.00787
SRR10120757_1_kneaddata_paired	Cyanobacteria	9876	P	2109	46	2155	0.00035
SRR10120757_1_kneaddata_paired	Proteobacteria	22518	P	1667	17	1684	0.00028
SRR10120757_1_kneaddata_paired	Desulfobacterota_A	11509	P	1049	63	1112	0.00018
SRR10120757_1_kneaddata_paired	Spirochaetota	32587	P	205	0	205	0.00003
SRR10120757_1_kneaddata_paired	Firmicutes_B	17289	P	169	6	175	0.00003
SRR10120757_1_kneaddata_paired	Campylobacterota	8700	P	65	0	65	0.00001
SRR10120757_1_kneaddata_paired	Firmicutes_C	17613	P	54	0	54	0.00001
SRR10120757_1_kneaddata_paired	Deferribacterota	10822	P	25	0	25	0.00000
SRR10120757_1_kneaddata_paired	Firmicutes_I	18140	P	12	0	12	0.00000
SRR10120757_1_kneaddata_paired	Elusimicrobiota	11888	P	11	0	11	0.00000
SRR10120757_1_kneaddata_paired	Thermotogota	33086	P	4	0	4	0.00000
SRR10120758_1_kneaddata_paired	Firmicutes_A	14608	P	7763457	43935	7807392	0.42663
SRR10120758_1_kneaddata_paired	Bacteroidota	4587	P	7477866	25527	7503393	0.41002
SRR10120758_1_kneaddata_paired	Verrucomicrobiota	33333	P	1633062	104745	1737807	0.09496
SRR10120758_1_kneaddata_paired	Firmicutes	12188	P	752466	23809	776275	0.04242
SRR10120758_1_kneaddata_paired	Actinobacteriota	615	P	452047	610	452657	0.02474
SRR10120758_1_kneaddata_paired	Proteobacteria	22518	P	10695	75	10770	0.00059
SRR10120758_1_kneaddata_paired	Cyanobacteria	9876	P	7065	284	7349	0.00040
SRR10120758_1_kneaddata_paired	Desulfobacterota_A	11509	P	3015	164	3179	0.00017
SRR10120758_1_kneaddata_paired	Spirochaetota	32587	P	398	0	398	0.00002
SRR10120758_1_kneaddata_paired	Firmicutes_B	17289	P	393	16	409	0.00002
SRR10120758_1_kneaddata_paired	Firmicutes_C	17613	P	176	0	176	0.00001
SRR10120758_1_kneaddata_paired	Campylobacterota	8700	P	154	0	154	0.00001
SRR10120758_1_kneaddata_paired	Deferribacterota	10822	P	131	0	131	0.00001
SRR10120758_1_kneaddata_paired	Firmicutes_I	18140	P	85	0	85	0.00000
SRR10120758_1_kneaddata_paired	Elusimicrobiota	11888	P	33	0	33	0.00000
SRR10120758_1_kneaddata_paired	Thermotogota	33086	P	6	0	6	0.00000
SRR10120760_1_kneaddata_paired	Firmicutes_A	14608	P	6734259	58454	6792713	0.51012
SRR10120760_1_kneaddata_paired	Bacteroidota	4587	P	4127646	27484	4155130	0.31204
SRR10120760_1_kneaddata_paired	Firmicutes	12188	P	1459888	45998	1505886	0.11309
SRR10120760_1_kneaddata_paired	Actinobacteriota	615	P	520368	7626	527994	0.03965
SRR10120760_1_kneaddata_paired	Verrucomicrobiota	33333	P	295020	25681	320701	0.02408
SRR10120760_1_kneaddata_paired	Proteobacteria	22518	P	6743	65	6808	0.00051
SRR10120760_1_kneaddata_paired	Cyanobacteria	9876	P	3483	186	3669	0.00028
SRR10120760_1_kneaddata_paired	Desulfobacterota_A	11509	P	1988	262	2250	0.00017
SRR10120760_1_kneaddata_paired	Spirochaetota	32587	P	204	0	204	0.00002
SRR10120760_1_kneaddata_paired	Campylobacterota	8700	P	171	0	171	0.00001
SRR10120760_1_kneaddata_paired	Firmicutes_B	17289	P	168	9	177	0.00001
SRR10120760_1_kneaddata_paired	Firmicutes_I	18140	P	109	0	109	0.00001
SRR10120760_1_kneaddata_paired	Deferribacterota	10822	P	84	0	84	0.00001
SRR10120760_1_kneaddata_paired	Firmicutes_C	17613	P	70	0	70	0.00001
SRR10120760_1_kneaddata_paired	Elusimicrobiota	11888	P	56	0	56	0.00000
SRR10120760_1_kneaddata_paired	Thermotogota	33086	P	3	0	3	0.00000
SRR10120761_1_kneaddata_paired	Firmicutes_A	14608	P	4670776	37661	4708437	0.48895
SRR10120761_1_kneaddata_paired	Bacteroidota	4587	P	3101234	17559	3118793	0.32387
SRR10120761_1_kneaddata_paired	Firmicutes	12188	P	991244	33371	1024615	0.10640
SRR10120761_1_kneaddata_paired	Actinobacteriota	615	P	379897	3636	383533	0.03983
SRR10120761_1_kneaddata_paired	Verrucomicrobiota	33333	P	348359	27378	375737	0.03902
SRR10120761_1_kneaddata_paired	Proteobacteria	22518	P	12033	105	12138	0.00126
SRR10120761_1_kneaddata_paired	Cyanobacteria	9876	P	4025	107	4132	0.00043
SRR10120761_1_kneaddata_paired	Desulfobacterota_A	11509	P	1342	141	1483	0.00015
SRR10120761_1_kneaddata_paired	Spirochaetota	32587	P	323	0	323	0.00003
SRR10120761_1_kneaddata_paired	Campylobacterota	8700	P	148	0	148	0.00002
SRR10120761_1_kneaddata_paired	Firmicutes_B	17289	P	133	6	139	0.00001
SRR10120761_1_kneaddata_paired	Deferribacterota	10822	P	81	0	81	0.00001
SRR10120761_1_kneaddata_paired	Firmicutes_I	18140	P	73	0	73	0.00001
SRR10120761_1_kneaddata_paired	Firmicutes_C	17613	P	59	0	59	0.00001
SRR10120761_1_kneaddata_paired	Elusimicrobiota	11888	P	40	0	40	0.00000
SRR10120762_1_kneaddata_paired	Firmicutes_A	14608	P	6781532	44084	6825616	0.57285
SRR10120762_1_kneaddata_paired	Bacteroidota	4587	P	2796086	14946	2811032	0.23592
SRR10120762_1_kneaddata_paired	Firmicutes	12188	P	1253185	33955	1287140	0.10803
SRR10120762_1_kneaddata_paired	Actinobacteriota	615	P	474404	5035	479439	0.04024
SRR10120762_1_kneaddata_paired	Verrucomicrobiota	33333	P	465214	31017	496231	0.04165
SRR10120762_1_kneaddata_paired	Proteobacteria	22518	P	8621	63	8684	0.00073
SRR10120762_1_kneaddata_paired	Cyanobacteria	9876	P	3706	110	3816	0.00032
SRR10120762_1_kneaddata_paired	Desulfobacterota_A	11509	P	1917	177	2094	0.00018
SRR10120762_1_kneaddata_paired	Spirochaetota	32587	P	277	0	277	0.00002
SRR10120762_1_kneaddata_paired	Firmicutes_B	17289	P	233	10	243	0.00002
SRR10120762_1_kneaddata_paired	Campylobacterota	8700	P	178	0	178	0.00001
SRR10120762_1_kneaddata_paired	Firmicutes_I	18140	P	124	0	124	0.00001
SRR10120762_1_kneaddata_paired	Deferribacterota	10822	P	101	0	101	0.00001
SRR10120762_1_kneaddata_paired	Firmicutes_C	17613	P	86	0	86	0.00001
SRR10120762_1_kneaddata_paired	Elusimicrobiota	11888	P	32	0	32	0.00000
SRR10120762_1_kneaddata_paired	Thermotogota	33086	P	2	0	2	0.00000
SRR10120763_1_kneaddata_paired	Bacteroidota	4587	P	7899742	52644	7952386	0.71237
SRR10120763_1_kneaddata_paired	Firmicutes_A	14608	P	3014238	30365	3044603	0.27273
SRR10120763_1_kneaddata_paired	Firmicutes	12188	P	116722	1728	118450	0.01061
SRR10120763_1_kneaddata_paired	Actinobacteriota	615	P	22364	355	22719	0.00204
SRR10120763_1_kneaddata_paired	Cyanobacteria	9876	P	17810	2672	20482	0.00183
SRR10120763_1_kneaddata_paired	Verrucomicrobiota	33333	P	1574	16	1590	0.00014
SRR10120763_1_kneaddata_paired	Proteobacteria	22518	P	1424	30	1454	0.00013
SRR10120763_1_kneaddata_paired	Spirochaetota	32587	P	576	1	577	0.00005
SRR10120763_1_kneaddata_paired	Desulfobacterota_A	11509	P	359	64	423	0.00004
SRR10120763_1_kneaddata_paired	Firmicutes_B	17289	P	355	28	383	0.00003
SRR10120763_1_kneaddata_paired	Deferribacterota	10822	P	68	0	68	0.00001
SRR10120763_1_kneaddata_paired	Campylobacterota	8700	P	63	0	63	0.00001
SRR10120763_1_kneaddata_paired	Firmicutes_I	18140	P	47	0	47	0.00000
SRR10120763_1_kneaddata_paired	Firmicutes_C	17613	P	21	0	21	0.00000
SRR10120763_1_kneaddata_paired	Elusimicrobiota	11888	P	20	0	20	0.00000
SRR10120763_1_kneaddata_paired	Thermotogota	33086	P	8	0	8	0.00000
SRR10120764_1_kneaddata_paired	Bacteroidota	4587	P	4726695	38336	4765031	0.56964
SRR10120764_1_kneaddata_paired	Firmicutes_A	14608	P	3329523	26758	3356281	0.40123
SRR10120764_1_kneaddata_paired	Firmicutes	12188	P	173296	2534	175830	0.02102
SRR10120764_1_kneaddata_paired	Cyanobacteria	9876	P	29478	4957	34435	0.00412
SRR10120764_1_kneaddata_paired	Actinobacteriota	615	P	29100	632	29732	0.00355
SRR10120764_1_kneaddata_paired	Proteobacteria	22518	P	1772	40	1812	0.00022
SRR10120764_1_kneaddata_paired	Spirochaetota	32587	P	593	1	594	0.00007
SRR10120764_1_kneaddata_paired	Desulfobacterota_A	11509	P	494	127	621	0.00007
SRR10120764_1_kneaddata_paired	Firmicutes_B	17289	P	363	31	394	0.00005
SRR10120764_1_kneaddata_paired	Verrucomicrobiota	33333	P	75	3	78	0.00001
SRR10120764_1_kneaddata_paired	Campylobacterota	8700	P	42	0	42	0.00001
SRR10120764_1_kneaddata_paired	Firmicutes_I	18140	P	42	0	42	0.00001
SRR10120764_1_kneaddata_paired	Deferribacterota	10822	P	29	0	29	0.00000
SRR10120764_1_kneaddata_paired	Firmicutes_C	17613	P	13	0	13	0.00000
SRR10120764_1_kneaddata_paired	Thermotogota	33086	P	2	0	2	0.00000
SRR10120765_1_kneaddata_paired	Bacteroidota	4587	P	11180479	108618	11289097	0.63094
SRR10120765_1_kneaddata_paired	Firmicutes_A	14608	P	5938095	62746	6000841	0.33539
SRR10120765_1_kneaddata_paired	Firmicutes	12188	P	426860	3430	430290	0.02405
SRR10120765_1_kneaddata_paired	Actinobacteriota	615	P	83939	2522	86461	0.00483
SRR10120765_1_kneaddata_paired	Cyanobacteria	9876	P	61602	14362	75964	0.00425
SRR10120765_1_kneaddata_paired	Proteobacteria	22518	P	4836	131	4967	0.00028
SRR10120765_1_kneaddata_paired	Spirochaetota	32587	P	2466	7	2473	0.00014
SRR10120765_1_kneaddata_paired	Firmicutes_B	17289	P	934	120	1054	0.00006
SRR10120765_1_kneaddata_paired	Desulfobacterota_A	11509	P	569	151	720	0.00004
SRR10120765_1_kneaddata_paired	Verrucomicrobiota	33333	P	262	45	307	0.00002
SRR10120765_1_kneaddata_paired	Firmicutes_I	18140	P	79	0	79	0.00000
SRR10120765_1_kneaddata_paired	Campylobacterota	8700	P	78	0	78	0.00000
SRR10120765_1_kneaddata_paired	Deferribacterota	10822	P	26	0	26	0.00000
SRR10120765_1_kneaddata_paired	Firmicutes_C	17613	P	22	0	22	0.00000
SRR10120765_1_kneaddata_paired	Thermotogota	33086	P	3	0	3	0.00000
SRR10120765_1_kneaddata_paired	Elusimicrobiota	11888	P	2	0	2	0.00000
SRR10125071_1_kneaddata_paired	Firmicutes_A	14608	P	1106320	2076	1108396	0.99455
SRR10125071_1_kneaddata_paired	Bacteroidota	4587	P	3225	44	3269	0.00293
SRR10125071_1_kneaddata_paired	Actinobacteriota	615	P	725	0	725	0.00065
SRR10125071_1_kneaddata_paired	Firmicutes	12188	P	671	4	675	0.00061
SRR10125071_1_kneaddata_paired	Firmicutes_I	18140	P	467	0	467	0.00042
SRR10125071_1_kneaddata_paired	Spirochaetota	32587	P	455	0	455	0.00041
SRR10125071_1_kneaddata_paired	Proteobacteria	22518	P	391	0	391	0.00035
SRR10125071_1_kneaddata_paired	Verrucomicrobiota	33333	P	42	0	42	0.00004
SRR10125071_1_kneaddata_paired	Cyanobacteria	9876	P	33	0	33	0.00003
SRR10125071_1_kneaddata_paired	Desulfobacterota_A	11509	P	9	0	9	0.00001
SRR10125071_1_kneaddata_paired	Campylobacterota	8700	P	6	0	6	0.00001
SRR10125071_1_kneaddata_paired	Firmicutes_B	17289	P	3	0	3	0.00000
SRR10125071_1_kneaddata_paired	Elusimicrobiota	11888	P	1	0	1	0.00000
SRR10125072_1_kneaddata_paired	Firmicutes_A	14608	P	1213327	1988	1215315	0.99584
SRR10125072_1_kneaddata_paired	Bacteroidota	4587	P	2627	32	2659	0.00218
SRR10125072_1_kneaddata_paired	Firmicutes	12188	P	629	3	632	0.00052
SRR10125072_1_kneaddata_paired	Spirochaetota	32587	P	586	0	586	0.00048
SRR10125072_1_kneaddata_paired	Firmicutes_I	18140	P	527	0	527	0.00043
SRR10125072_1_kneaddata_paired	Actinobacteriota	615	P	366	0	366	0.00030
SRR10125072_1_kneaddata_paired	Proteobacteria	22518	P	221	0	221	0.00018
SRR10125072_1_kneaddata_paired	Cyanobacteria	9876	P	39	0	39	0.00003
SRR10125072_1_kneaddata_paired	Verrucomicrobiota	33333	P	28	0	28	0.00002
SRR10125072_1_kneaddata_paired	Campylobacterota	8700	P	7	0	7	0.00001
SRR10125072_1_kneaddata_paired	Desulfobacterota_A	11509	P	2	0	2	0.00000
SRR10125072_1_kneaddata_paired	Deferribacterota	10822	P	1	0	1	0.00000
SRR10127609_1_kneaddata_paired	Firmicutes_A	14608	P	120533	9095	129628	0.68365
SRR10127609_1_kneaddata_paired	Bacteroidota	4587	P	34055	1814	35869	0.18918
SRR10127609_1_kneaddata_paired	Cyanobacteria	9876	P	14763	307	15070	0.07948
SRR10127609_1_kneaddata_paired	Firmicutes	12188	P	4147	1342	5489	0.02895
SRR10127609_1_kneaddata_paired	Actinobacteriota	615	P	1522	8	1530	0.00807
SRR10127609_1_kneaddata_paired	Proteobacteria	22518	P	1027	61	1088	0.00574
SRR10127609_1_kneaddata_paired	Verrucomicrobiota	33333	P	427	154	581	0.00307
SRR10127609_1_kneaddata_paired	Spirochaetota	32587	P	284	1	285	0.00151
SRR10127609_1_kneaddata_paired	Firmicutes_B	17289	P	40	11	51	0.00027
SRR10127609_1_kneaddata_paired	Campylobacterota	8700	P	7	0	7	0.00004
SRR10127609_1_kneaddata_paired	Desulfobacterota_A	11509	P	4	0	4	0.00002
SRR10127609_1_kneaddata_paired	Deferribacterota	10822	P	2	0	2	0.00001
SRR10127609_1_kneaddata_paired	Firmicutes_I	18140	P	2	0	2	0.00001
SRR10127609_1_kneaddata_paired	Thermotogota	33086	P	1	0	1	0.00001
SRR10127610_1_kneaddata_paired	Firmicutes_A	14608	P	81341	17494	98835	0.58125
SRR10127610_1_kneaddata_paired	Bacteroidota	4587	P	28036	2036	30072	0.17686
SRR10127610_1_kneaddata_paired	Proteobacteria	22518	P	15092	368	15460	0.09092
SRR10127610_1_kneaddata_paired	Cyanobacteria	9876	P	8489	436	8925	0.05249
SRR10127610_1_kneaddata_paired	Firmicutes	12188	P	6234	5082	11316	0.06655
SRR10127610_1_kneaddata_paired	Actinobacteriota	615	P	3885	73	3958	0.02328
SRR10127610_1_kneaddata_paired	Spirochaetota	32587	P	553	6	559	0.00329
SRR10127610_1_kneaddata_paired	Verrucomicrobiota	33333	P	390	282	672	0.00395
SRR10127610_1_kneaddata_paired	Firmicutes_B	17289	P	126	72	198	0.00116
SRR10127610_1_kneaddata_paired	Campylobacterota	8700	P	11	0	11	0.00007
SRR10127610_1_kneaddata_paired	Desulfobacterota_A	11509	P	10	8	18	0.00011
SRR10127610_1_kneaddata_paired	Deferribacterota	10822	P	7	0	7	0.00004
SRR10127610_1_kneaddata_paired	Firmicutes_I	18140	P	4	0	4	0.00002
SRR10127611_1_kneaddata_paired	Firmicutes_A	14608	P	116634	3880	120514	0.41259
SRR10127611_1_kneaddata_paired	Bacteroidota	4587	P	67099	1419	68518	0.23458
SRR10127611_1_kneaddata_paired	Proteobacteria	22518	P	45022	196	45218	0.15481
SRR10127611_1_kneaddata_paired	Firmicutes	12188	P	26807	5145	31952	0.10939
SRR10127611_1_kneaddata_paired	Cyanobacteria	9876	P	9472	81	9553	0.03271
SRR10127611_1_kneaddata_paired	Verrucomicrobiota	33333	P	7756	1174	8930	0.03057
SRR10127611_1_kneaddata_paired	Actinobacteriota	615	P	6964	32	6996	0.02395
SRR10127611_1_kneaddata_paired	Spirochaetota	32587	P	288	0	288	0.00099
SRR10127611_1_kneaddata_paired	Firmicutes_B	17289	P	48	5	53	0.00018
SRR10127611_1_kneaddata_paired	Desulfobacterota_A	11509	P	25	0	25	0.00009
SRR10127611_1_kneaddata_paired	Campylobacterota	8700	P	16	0	16	0.00005
SRR10127611_1_kneaddata_paired	Firmicutes_I	18140	P	16	0	16	0.00005
SRR10127611_1_kneaddata_paired	Deferribacterota	10822	P	8	0	8	0.00003
SRR10127611_1_kneaddata_paired	Elusimicrobiota	11888	P	2	0	2	0.00001
SRR10127611_1_kneaddata_paired	Firmicutes_C	17613	P	2	0	2	0.00001
SRR10127612_1_kneaddata_paired	Proteobacteria	22518	P	102053	265	102318	0.25830
SRR10127612_1_kneaddata_paired	Firmicutes_A	14608	P	98059	2303	100362	0.25336
SRR10127612_1_kneaddata_paired	Bacteroidota	4587	P	90369	899	91268	0.23040
SRR10127612_1_kneaddata_paired	Firmicutes	12188	P	53392	8252	61644	0.15562
SRR10127612_1_kneaddata_paired	Verrucomicrobiota	33333	P	20931	1849	22780	0.05751
SRR10127612_1_kneaddata_paired	Actinobacteriota	615	P	7906	29	7935	0.02003
SRR10127612_1_kneaddata_paired	Cyanobacteria	9876	P	7264	36	7300	0.01843
SRR10127612_1_kneaddata_paired	Firmicutes_B	17289	P	1947	130	2077	0.00525
SRR10127612_1_kneaddata_paired	Spirochaetota	32587	P	275	0	275	0.00070
SRR10127612_1_kneaddata_paired	Desulfobacterota_A	11509	P	84	10	94	0.00024
SRR10127612_1_kneaddata_paired	Campylobacterota	8700	P	40	0	40	0.00010
SRR10127612_1_kneaddata_paired	Deferribacterota	10822	P	12	0	12	0.00003
SRR10127612_1_kneaddata_paired	Firmicutes_I	18140	P	12	0	12	0.00003
SRR10127612_1_kneaddata_paired	Elusimicrobiota	11888	P	4	0	4	0.00001
SRR10127612_1_kneaddata_paired	Firmicutes_C	17613	P	1	0	1	0.00000
SRR10127614_1_kneaddata_paired	Firmicutes_A	14608	P	134178	11899	146077	0.39609
SRR10127614_1_kneaddata_paired	Bacteroidota	4587	P	76811	3492	80303	0.21774
SRR10127614_1_kneaddata_paired	Firmicutes	12188	P	38558	23528	62086	0.16835
SRR10127614_1_kneaddata_paired	Proteobacteria	22518	P	29343	1399	30742	0.08336
SRR10127614_1_kneaddata_paired	Verrucomicrobiota	33333	P	18130	6546	24676	0.06691
SRR10127614_1_kneaddata_paired	Cyanobacteria	9876	P	13799	302	14101	0.03824
SRR10127614_1_kneaddata_paired	Actinobacteriota	615	P	9237	93	9330	0.02530
SRR10127614_1_kneaddata_paired	Spirochaetota	32587	P	899	5	904	0.00245
SRR10127614_1_kneaddata_paired	Firmicutes_B	17289	P	388	107	495	0.00134
SRR10127614_1_kneaddata_paired	Desulfobacterota_A	11509	P	30	11	41	0.00011
SRR10127614_1_kneaddata_paired	Campylobacterota	8700	P	13	0	13	0.00004
SRR10127614_1_kneaddata_paired	Deferribacterota	10822	P	13	0	13	0.00004
SRR10127614_1_kneaddata_paired	Firmicutes_I	18140	P	7	0	7	0.00002
SRR10127614_1_kneaddata_paired	Elusimicrobiota	11888	P	1	0	1	0.00000
SRR10127614_1_kneaddata_paired	Firmicutes_C	17613	P	1	0	1	0.00000
SRR10127614_1_kneaddata_paired	Thermotogota	33086	P	1	0	1	0.00000
SRR10127615_1_kneaddata_paired	Firmicutes_A	14608	P	100430	16183	116613	0.47913
SRR10127615_1_kneaddata_paired	Bacteroidota	4587	P	41920	3306	45226	0.18582
SRR10127615_1_kneaddata_paired	Proteobacteria	22518	P	38818	321	39139	0.16081
SRR10127615_1_kneaddata_paired	Cyanobacteria	9876	P	12791	410	13201	0.05424
SRR10127615_1_kneaddata_paired	Firmicutes	12188	P	11266	8458	19724	0.08104
SRR10127615_1_kneaddata_paired	Actinobacteriota	615	P	8472	114	8586	0.03528
SRR10127615_1_kneaddata_paired	Spirochaetota	32587	P	584	5	589	0.00242
SRR10127615_1_kneaddata_paired	Firmicutes_B	17289	P	134	56	190	0.00078
SRR10127615_1_kneaddata_paired	Verrucomicrobiota	33333	P	30	14	44	0.00018
SRR10127615_1_kneaddata_paired	Desulfobacterota_A	11509	P	20	10	30	0.00012
SRR10127615_1_kneaddata_paired	Campylobacterota	8700	P	16	0	16	0.00007
SRR10127615_1_kneaddata_paired	Firmicutes_I	18140	P	10	0	10	0.00004
SRR10127615_1_kneaddata_paired	Deferribacterota	10822	P	5	0	5	0.00002
SRR10127615_1_kneaddata_paired	Thermotogota	33086	P	3	0	3	0.00001
SRR10127615_1_kneaddata_paired	Elusimicrobiota	11888	P	1	0	1	0.00000
SRR10127615_1_kneaddata_paired	Firmicutes_C	17613	P	1	0	1	0.00000
SRR10127616_1_kneaddata_paired	Firmicutes_A	14608	P	80347	3326	83673	0.64056
SRR10127616_1_kneaddata_paired	Bacteroidota	4587	P	18506	446	18952	0.14509
SRR10127616_1_kneaddata_paired	Firmicutes	12188	P	5989	2080	8069	0.06178
SRR10127616_1_kneaddata_paired	Cyanobacteria	9876	P	5762	57	5819	0.04455
SRR10127616_1_kneaddata_paired	Proteobacteria	22518	P	5013	185	5198	0.03980
SRR10127616_1_kneaddata_paired	Verrucomicrobiota	33333	P	3896	678	4574	0.03502
SRR10127616_1_kneaddata_paired	Actinobacteriota	615	P	3820	19	3839	0.02939
SRR10127616_1_kneaddata_paired	Spirochaetota	32587	P	233	0	233	0.00179
SRR10127616_1_kneaddata_paired	Firmicutes_B	17289	P	205	27	232	0.00178
SRR10127616_1_kneaddata_paired	Desulfobacterota_A	11509	P	13	3	16	0.00012
SRR10127616_1_kneaddata_paired	Firmicutes_I	18140	P	7	0	7	0.00005
SRR10127616_1_kneaddata_paired	Deferribacterota	10822	P	5	0	5	0.00004
SRR10127616_1_kneaddata_paired	Campylobacterota	8700	P	4	0	4	0.00003
SRR10127617_1_kneaddata_paired	Proteobacteria	22518	P	183708	1746	185454	0.33732
SRR10127617_1_kneaddata_paired	Firmicutes_A	14608	P	129387	15583	144970	0.26368
SRR10127617_1_kneaddata_paired	Bacteroidota	4587	P	107489	3017	110506	0.20100
SRR10127617_1_kneaddata_paired	Firmicutes	12188	P	41752	21918	63670	0.11581
SRR10127617_1_kneaddata_paired	Actinobacteriota	615	P	22539	247	22786	0.04145
SRR10127617_1_kneaddata_paired	Cyanobacteria	9876	P	14991	723	15714	0.02858
SRR10127617_1_kneaddata_paired	Verrucomicrobiota	33333	P	3677	1706	5383	0.00979
SRR10127617_1_kneaddata_paired	Spirochaetota	32587	P	794	6	800	0.00146
SRR10127617_1_kneaddata_paired	Firmicutes_B	17289	P	180	64	244	0.00044
SRR10127617_1_kneaddata_paired	Desulfobacterota_A	11509	P	118	18	136	0.00025
SRR10127617_1_kneaddata_paired	Campylobacterota	8700	P	62	0	62	0.00011
SRR10127617_1_kneaddata_paired	Firmicutes_I	18140	P	32	0	32	0.00006
SRR10127617_1_kneaddata_paired	Deferribacterota	10822	P	16	0	16	0.00003
SRR10127617_1_kneaddata_paired	Elusimicrobiota	11888	P	4	0	4	0.00001
SRR10127617_1_kneaddata_paired	Firmicutes_C	17613	P	2	0	2	0.00000
SRR10127617_1_kneaddata_paired	Thermotogota	33086	P	2	0	2	0.00000
SRR10127618_1_kneaddata_paired	Firmicutes_A	14608	P	65718	7743	73461	0.48793
SRR10127618_1_kneaddata_paired	Bacteroidota	4587	P	40050	1590	41640	0.27657
SRR10127618_1_kneaddata_paired	Firmicutes	12188	P	8151	5812	13963	0.09274
SRR10127618_1_kneaddata_paired	Cyanobacteria	9876	P	7714	151	7865	0.05224
SRR10127618_1_kneaddata_paired	Actinobacteriota	615	P	4929	50	4979	0.03307
SRR10127618_1_kneaddata_paired	Proteobacteria	22518	P	3610	380	3990	0.02650
SRR10127618_1_kneaddata_paired	Verrucomicrobiota	33333	P	3165	1109	4274	0.02839
SRR10127618_1_kneaddata_paired	Spirochaetota	32587	P	311	1	312	0.00208
SRR10127618_1_kneaddata_paired	Firmicutes_B	17289	P	40	10	50	0.00034
SRR10127618_1_kneaddata_paired	Deferribacterota	10822	P	8	0	8	0.00005
SRR10127618_1_kneaddata_paired	Firmicutes_I	18140	P	5	0	5	0.00003
SRR10127618_1_kneaddata_paired	Desulfobacterota_A	11509	P	3	0	3	0.00002
SRR10127618_1_kneaddata_paired	Campylobacterota	8700	P	2	0	2	0.00001
SRR10127618_1_kneaddata_paired	Thermotogota	33086	P	1	0	1	0.00001
SRR10127619_1_kneaddata_paired	Firmicutes_A	14608	P	96148	16735	112883	0.63432
SRR10127619_1_kneaddata_paired	Bacteroidota	4587	P	27279	2170	29449	0.16548
SRR10127619_1_kneaddata_paired	Cyanobacteria	9876	P	12368	411	12779	0.07181
SRR10127619_1_kneaddata_paired	Firmicutes	12188	P	6420	5268	11688	0.06568
SRR10127619_1_kneaddata_paired	Actinobacteriota	615	P	4309	59	4368	0.02455
SRR10127619_1_kneaddata_paired	Verrucomicrobiota	33333	P	2445	1425	3870	0.02175
SRR10127619_1_kneaddata_paired	Proteobacteria	22518	P	1850	228	2078	0.01168
SRR10127619_1_kneaddata_paired	Spirochaetota	32587	P	620	6	626	0.00352
SRR10127619_1_kneaddata_paired	Firmicutes_B	17289	P	130	58	188	0.00106
SRR10127619_1_kneaddata_paired	Deferribacterota	10822	P	6	0	6	0.00004
SRR10127619_1_kneaddata_paired	Desulfobacterota_A	11509	P	6	4	10	0.00006
SRR10127619_1_kneaddata_paired	Firmicutes_I	18140	P	6	0	6	0.00003
SRR10127619_1_kneaddata_paired	Campylobacterota	8700	P	5	0	5	0.00003
SRR10127619_1_kneaddata_paired	Firmicutes_C	17613	P	1	0	1	0.00001
SRR10127619_1_kneaddata_paired	Thermotogota	33086	P	1	0	1	0.00001
SRR10127620_1_kneaddata_paired	Bacteroidota	4587	P	87327	1120	88447	0.40794
SRR10127620_1_kneaddata_paired	Firmicutes_A	14608	P	76127	5381	81508	0.37593
SRR10127620_1_kneaddata_paired	Firmicutes	12188	P	18800	7420	26220	0.12093
SRR10127620_1_kneaddata_paired	Cyanobacteria	9876	P	11780	160	11940	0.05507
SRR10127620_1_kneaddata_paired	Actinobacteriota	615	P	3394	26	3420	0.01578
SRR10127620_1_kneaddata_paired	Proteobacteria	22518	P	3170	256	3426	0.01581
SRR10127620_1_kneaddata_paired	Verrucomicrobiota	33333	P	1081	257	1338	0.00617
SRR10127620_1_kneaddata_paired	Spirochaetota	32587	P	378	1	379	0.00175
SRR10127620_1_kneaddata_paired	Firmicutes_B	17289	P	65	11	76	0.00035
SRR10127620_1_kneaddata_paired	Campylobacterota	8700	P	36	0	36	0.00017
SRR10127620_1_kneaddata_paired	Desulfobacterota_A	11509	P	11	4	15	0.00007
SRR10127620_1_kneaddata_paired	Firmicutes_I	18140	P	4	0	4	0.00002
SRR10127620_1_kneaddata_paired	Deferribacterota	10822	P	2	0	2	0.00001
SRR10127621_1_kneaddata_paired	Firmicutes_A	14608	P	99561	17628	117189	0.64217
SRR10127621_1_kneaddata_paired	Bacteroidota	4587	P	27716	2483	30199	0.16548
SRR10127621_1_kneaddata_paired	Cyanobacteria	9876	P	12224	442	12666	0.06941
SRR10127621_1_kneaddata_paired	Firmicutes	12188	P	7834	6640	14474	0.07932
SRR10127621_1_kneaddata_paired	Actinobacteriota	615	P	4066	53	4119	0.02258
SRR10127621_1_kneaddata_paired	Proteobacteria	22518	P	2391	511	2902	0.01591
SRR10127621_1_kneaddata_paired	Spirochaetota	32587	P	638	6	644	0.00353
SRR10127621_1_kneaddata_paired	Firmicutes_B	17289	P	152	74	226	0.00124
SRR10127621_1_kneaddata_paired	Verrucomicrobiota	33333	P	22	12	34	0.00019
SRR10127621_1_kneaddata_paired	Desulfobacterota_A	11509	P	10	4	14	0.00008
SRR10127621_1_kneaddata_paired	Campylobacterota	8700	P	7	0	7	0.00004
SRR10127621_1_kneaddata_paired	Deferribacterota	10822	P	7	0	7	0.00004
SRR10127621_1_kneaddata_paired	Firmicutes_I	18140	P	4	0	4	0.00002
SRR10127622_1_kneaddata_paired	Firmicutes_A	14608	P	106028	22008	128036	0.63556
SRR10127622_1_kneaddata_paired	Bacteroidota	4587	P	33088	3435	36523	0.18130
SRR10127622_1_kneaddata_paired	Cyanobacteria	9876	P	14192	613	14805	0.07349
SRR10127622_1_kneaddata_paired	Firmicutes	12188	P	7032	5137	12169	0.06041
SRR10127622_1_kneaddata_paired	Actinobacteriota	615	P	4282	63	4345	0.02157
SRR10127622_1_kneaddata_paired	Proteobacteria	22518	P	3546	928	4474	0.02221
SRR10127622_1_kneaddata_paired	Spirochaetota	32587	P	743	9	752	0.00374
SRR10127622_1_kneaddata_paired	Firmicutes_B	17289	P	178	103	281	0.00140
SRR10127622_1_kneaddata_paired	Verrucomicrobiota	33333	P	25	21	46	0.00023
SRR10127622_1_kneaddata_paired	Campylobacterota	8700	P	7	0	7	0.00004
SRR10127622_1_kneaddata_paired	Desulfobacterota_A	11509	P	6	0	6	0.00003
SRR10127622_1_kneaddata_paired	Deferribacterota	10822	P	3	0	3	0.00002
SRR10127622_1_kneaddata_paired	Firmicutes_I	18140	P	2	0	2	0.00001
SRR10127623_1_kneaddata_paired	Firmicutes_A	14608	P	99128	5319	104447	0.37425
SRR10127623_1_kneaddata_paired	Bacteroidota	4587	P	62435	1610	64045	0.22948
SRR10127623_1_kneaddata_paired	Firmicutes	12188	P	60220	10900	71120	0.25483
SRR10127623_1_kneaddata_paired	Cyanobacteria	9876	P	10785	115	10900	0.03906
SRR10127623_1_kneaddata_paired	Actinobacteriota	615	P	9381	102	9483	0.03398
SRR10127623_1_kneaddata_paired	Proteobacteria	22518	P	7917	552	8469	0.03035
SRR10127623_1_kneaddata_paired	Verrucomicrobiota	33333	P	7849	1484	9333	0.03344
SRR10127623_1_kneaddata_paired	Firmicutes_B	17289	P	729	105	834	0.00299
SRR10127623_1_kneaddata_paired	Spirochaetota	32587	P	404	1	405	0.00145
SRR10127623_1_kneaddata_paired	Desulfobacterota_A	11509	P	19	7	26	0.00009
SRR10127623_1_kneaddata_paired	Firmicutes_I	18140	P	8	0	8	0.00003
SRR10127623_1_kneaddata_paired	Deferribacterota	10822	P	4	0	4	0.00001
SRR10127623_1_kneaddata_paired	Campylobacterota	8700	P	3	0	3	0.00001
SRR10127623_1_kneaddata_paired	Firmicutes_C	17613	P	2	0	2	0.00001
SRR10127624_1_kneaddata_paired	Firmicutes_A	14608	P	84101	10586	94687	0.44335
SRR10127624_1_kneaddata_paired	Bacteroidota	4587	P	37519	2306	39825	0.18648
SRR10127624_1_kneaddata_paired	Proteobacteria	22518	P	30183	326	30509	0.14285
SRR10127624_1_kneaddata_paired	Firmicutes	12188	P	16873	9232	26105	0.12223
SRR10127624_1_kneaddata_paired	Cyanobacteria	9876	P	11663	313	11976	0.05608
SRR10127624_1_kneaddata_paired	Actinobacteriota	615	P	9458	94	9552	0.04473
SRR10127624_1_kneaddata_paired	Spirochaetota	32587	P	523	4	527	0.00247
SRR10127624_1_kneaddata_paired	Firmicutes_B	17289	P	153	51	204	0.00096
SRR10127624_1_kneaddata_paired	Verrucomicrobiota	33333	P	43	21	64	0.00030
SRR10127624_1_kneaddata_paired	Campylobacterota	8700	P	40	0	40	0.00019
SRR10127624_1_kneaddata_paired	Desulfobacterota_A	11509	P	36	3	39	0.00019
SRR10127624_1_kneaddata_paired	Firmicutes_I	18140	P	24	0	24	0.00011
SRR10127624_1_kneaddata_paired	Deferribacterota	10822	P	10	0	10	0.00005
SRR10127624_1_kneaddata_paired	Elusimicrobiota	11888	P	2	0	2	0.00001
SRR10127624_1_kneaddata_paired	Thermotogota	33086	P	1	0	1	0.00000
SRR10127625_1_kneaddata_paired	Firmicutes_A	14608	P	117274	13716	130990	0.35417
SRR10127625_1_kneaddata_paired	Proteobacteria	22518	P	107340	430	107770	0.29138
SRR10127625_1_kneaddata_paired	Bacteroidota	4587	P	63131	3615	66746	0.18047
SRR10127625_1_kneaddata_paired	Firmicutes	12188	P	23158	13009	36167	0.09779
SRR10127625_1_kneaddata_paired	Cyanobacteria	9876	P	14382	356	14738	0.03985
SRR10127625_1_kneaddata_paired	Actinobacteriota	615	P	12091	136	12227	0.03306
SRR10127625_1_kneaddata_paired	Spirochaetota	32587	P	660	4	664	0.00180
SRR10127625_1_kneaddata_paired	Firmicutes_B	17289	P	241	76	317	0.00086
SRR10127625_1_kneaddata_paired	Campylobacterota	8700	P	58	0	58	0.00016
SRR10127625_1_kneaddata_paired	Verrucomicrobiota	33333	P	52	22	74	0.00020
SRR10127625_1_kneaddata_paired	Desulfobacterota_A	11509	P	45	13	58	0.00016
SRR10127625_1_kneaddata_paired	Firmicutes_I	18140	P	26	0	26	0.00007
SRR10127625_1_kneaddata_paired	Deferribacterota	10822	P	7	0	7	0.00002
SRR10127625_1_kneaddata_paired	Elusimicrobiota	11888	P	7	0	7	0.00002
SRR10127625_1_kneaddata_paired	Thermotogota	33086	P	1	0	1	0.00000
SRR10127626_1_kneaddata_paired	Firmicutes_A	14608	P	108886	11693	120579	0.44942
SRR10127626_1_kneaddata_paired	Bacteroidota	4587	P	44312	2554	46866	0.17468
SRR10127626_1_kneaddata_paired	Firmicutes	12188	P	41757	21369	63126	0.23528
SRR10127626_1_kneaddata_paired	Actinobacteriota	615	P	17642	157	17799	0.06634
SRR10127626_1_kneaddata_paired	Cyanobacteria	9876	P	13573	375	13948	0.05199
SRR10127626_1_kneaddata_paired	Proteobacteria	22518	P	4512	188	4700	0.01752
SRR10127626_1_kneaddata_paired	Spirochaetota	32587	P	774	5	779	0.00290
SRR10127626_1_kneaddata_paired	Firmicutes_B	17289	P	169	53	222	0.00083
SRR10127626_1_kneaddata_paired	Campylobacterota	8700	P	88	0	88	0.00033
SRR10127626_1_kneaddata_paired	Verrucomicrobiota	33333	P	82	40	122	0.00046
SRR10127626_1_kneaddata_paired	Desulfobacterota_A	11509	P	25	14	39	0.00015
SRR10127626_1_kneaddata_paired	Firmicutes_I	18140	P	21	0	21	0.00008
SRR10127626_1_kneaddata_paired	Deferribacterota	10822	P	4	0	4	0.00002
SRR10127626_1_kneaddata_paired	Thermotogota	33086	P	1	0	1	0.00000
SRR10127627_1_kneaddata_paired	Firmicutes_A	14608	P	121691	3089	124780	0.51669
SRR10127627_1_kneaddata_paired	Bacteroidota	4587	P	40280	625	40905	0.16938
SRR10127627_1_kneaddata_paired	Firmicutes	12188	P	24517	6209	30726	0.12723
SRR10127627_1_kneaddata_paired	Actinobacteriota	615	P	13353	56	13409	0.05553
SRR10127627_1_kneaddata_paired	Verrucomicrobiota	33333	P	11206	1215	12421	0.05144
SRR10127627_1_kneaddata_paired	Cyanobacteria	9876	P	11161	68	11229	0.04650
SRR10127627_1_kneaddata_paired	Proteobacteria	22518	P	7410	189	7599	0.03147
SRR10127627_1_kneaddata_paired	Spirochaetota	32587	P	313	0	313	0.00130
SRR10127627_1_kneaddata_paired	Firmicutes_B	17289	P	45	3	48	0.00020
SRR10127627_1_kneaddata_paired	Desulfobacterota_A	11509	P	34	6	40	0.00017
SRR10127627_1_kneaddata_paired	Campylobacterota	8700	P	12	0	12	0.00005
SRR10127627_1_kneaddata_paired	Deferribacterota	10822	P	6	0	6	0.00003
SRR10127627_1_kneaddata_paired	Firmicutes_I	18140	P	5	0	5	0.00002
SRR10127628_1_kneaddata_paired	Firmicutes_A	14608	P	106658	7555	114213	0.44757
SRR10127628_1_kneaddata_paired	Bacteroidota	4587	P	45139	1623	46762	0.18325
SRR10127628_1_kneaddata_paired	Firmicutes	12188	P	45090	19449	64539	0.25291
SRR10127628_1_kneaddata_paired	Cyanobacteria	9876	P	14625	226	14851	0.05820
SRR10127628_1_kneaddata_paired	Actinobacteriota	615	P	9117	57	9174	0.03595
SRR10127628_1_kneaddata_paired	Verrucomicrobiota	33333	P	2153	555	2708	0.01061
SRR10127628_1_kneaddata_paired	Proteobacteria	22518	P	1988	136	2124	0.00833
SRR10127628_1_kneaddata_paired	Spirochaetota	32587	P	572	2	574	0.00225
SRR10127628_1_kneaddata_paired	Firmicutes_B	17289	P	113	21	134	0.00053
SRR10127628_1_kneaddata_paired	Campylobacterota	8700	P	62	0	62	0.00024
SRR10127628_1_kneaddata_paired	Firmicutes_I	18140	P	14	0	14	0.00005
SRR10127628_1_kneaddata_paired	Deferribacterota	10822	P	11	0	11	0.00004
SRR10127628_1_kneaddata_paired	Desulfobacterota_A	11509	P	9	5	14	0.00006
SRR10127628_1_kneaddata_paired	Thermotogota	33086	P	1	0	1	0.00000
SRR10127629_1_kneaddata_paired	Firmicutes_A	14608	P	111604	13397	125001	0.51760
SRR10127629_1_kneaddata_paired	Bacteroidota	4587	P	47903	2868	50771	0.21023
SRR10127629_1_kneaddata_paired	Firmicutes	12188	P	16697	12813	29510	0.12220
SRR10127629_1_kneaddata_paired	Cyanobacteria	9876	P	13806	343	14149	0.05859
SRR10127629_1_kneaddata_paired	Proteobacteria	22518	P	11482	1844	13326	0.05518
SRR10127629_1_kneaddata_paired	Actinobacteriota	615	P	7316	111	7427	0.03076
SRR10127629_1_kneaddata_paired	Spirochaetota	32587	P	649	5	654	0.00271
SRR10127629_1_kneaddata_paired	Verrucomicrobiota	33333	P	221	97	318	0.00132
SRR10127629_1_kneaddata_paired	Firmicutes_B	17289	P	216	71	287	0.00119
SRR10127629_1_kneaddata_paired	Campylobacterota	8700	P	15	0	15	0.00006
SRR10127629_1_kneaddata_paired	Deferribacterota	10822	P	14	0	14	0.00006
SRR10127629_1_kneaddata_paired	Desulfobacterota_A	11509	P	12	9	21	0.00009
SRR10127629_1_kneaddata_paired	Firmicutes_I	18140	P	2	0	2	0.00001
SRR10127629_1_kneaddata_paired	Thermotogota	33086	P	1	0	1	0.00000
SRR10127630_1_kneaddata_paired	Firmicutes_A	14608	P	72864	2105	74969	0.32486
SRR10127630_1_kneaddata_paired	Actinobacteriota	615	P	50384	20	50404	0.21842
SRR10127630_1_kneaddata_paired	Firmicutes	12188	P	41574	10470	52044	0.22552
SRR10127630_1_kneaddata_paired	Bacteroidota	4587	P	33430	456	33886	0.14684
SRR10127630_1_kneaddata_paired	Cyanobacteria	9876	P	10900	58	10958	0.04748
SRR10127630_1_kneaddata_paired	Proteobacteria	22518	P	4770	166	4936	0.02139
SRR10127630_1_kneaddata_paired	Verrucomicrobiota	33333	P	2913	271	3184	0.01380
SRR10127630_1_kneaddata_paired	Spirochaetota	32587	P	259	0	259	0.00112
SRR10127630_1_kneaddata_paired	Firmicutes_B	17289	P	55	3	58	0.00026
SRR10127630_1_kneaddata_paired	Desulfobacterota_A	11509	P	31	9	40	0.00017
SRR10127630_1_kneaddata_paired	Campylobacterota	8700	P	13	0	13	0.00006
SRR10127630_1_kneaddata_paired	Deferribacterota	10822	P	13	0	13	0.00006
SRR10127630_1_kneaddata_paired	Firmicutes_I	18140	P	4	0	4	0.00002
SRR10127631_1_kneaddata_paired	Firmicutes_A	14608	P	103797	6435	110232	0.48847
SRR10127631_1_kneaddata_paired	Firmicutes	12188	P	34759	20838	55597	0.24637
SRR10127631_1_kneaddata_paired	Bacteroidota	4587	P	29650	1000	30650	0.13582
SRR10127631_1_kneaddata_paired	Actinobacteriota	615	P	12076	98	12174	0.05395
SRR10127631_1_kneaddata_paired	Cyanobacteria	9876	P	10530	143	10673	0.04730
SRR10127631_1_kneaddata_paired	Verrucomicrobiota	33333	P	3085	742	3827	0.01696
SRR10127631_1_kneaddata_paired	Proteobacteria	22518	P	1582	101	1683	0.00746
SRR10127631_1_kneaddata_paired	Spirochaetota	32587	P	652	2	654	0.00290
SRR10127631_1_kneaddata_paired	Firmicutes_B	17289	P	102	18	120	0.00054
SRR10127631_1_kneaddata_paired	Desulfobacterota_A	11509	P	22	17	39	0.00017
SRR10127631_1_kneaddata_paired	Deferribacterota	10822	P	10	0	10	0.00005
SRR10127631_1_kneaddata_paired	Campylobacterota	8700	P	4	0	4	0.00002
SRR10127631_1_kneaddata_paired	Firmicutes_I	18140	P	3	0	3	0.00001
SRR10127633_1_kneaddata_paired	Firmicutes_A	14608	P	190114	13331	203445	0.50306
SRR10127633_1_kneaddata_paired	Bacteroidota	4587	P	99382	3445	102827	0.25426
SRR10127633_1_kneaddata_paired	Firmicutes	12188	P	30900	17873	48773	0.12060
SRR10127633_1_kneaddata_paired	Actinobacteriota	615	P	14124	285	14409	0.03563
SRR10127633_1_kneaddata_paired	Cyanobacteria	9876	P	12686	226	12912	0.03193
SRR10127633_1_kneaddata_paired	Verrucomicrobiota	33333	P	10274	3245	13519	0.03343
SRR10127633_1_kneaddata_paired	Proteobacteria	22518	P	5309	539	5848	0.01446
SRR10127633_1_kneaddata_paired	Firmicutes_B	17289	P	1395	334	1729	0.00428
SRR10127633_1_kneaddata_paired	Spirochaetota	32587	P	852	5	857	0.00212
SRR10127633_1_kneaddata_paired	Desulfobacterota_A	11509	P	28	24	52	0.00013
SRR10127633_1_kneaddata_paired	Campylobacterota	8700	P	18	0	18	0.00004
SRR10127633_1_kneaddata_paired	Firmicutes_I	18140	P	11	0	11	0.00003
SRR10127633_1_kneaddata_paired	Deferribacterota	10822	P	5	0	5	0.00001
SRR10127633_1_kneaddata_paired	Firmicutes_C	17613	P	3	0	3	0.00001
SRR10127633_1_kneaddata_paired	Thermotogota	33086	P	2	0	2	0.00000
SRR10127633_1_kneaddata_paired	Elusimicrobiota	11888	P	1	0	1	0.00000
SRR10127634_1_kneaddata_paired	Firmicutes_A	14608	P	198088	3893	201981	0.54784
SRR10127634_1_kneaddata_paired	Bacteroidota	4587	P	76012	958	76970	0.20877
SRR10127634_1_kneaddata_paired	Firmicutes	12188	P	24094	4494	28588	0.07754
SRR10127634_1_kneaddata_paired	Verrucomicrobiota	33333	P	23599	2483	26082	0.07074
SRR10127634_1_kneaddata_paired	Actinobacteriota	615	P	12869	88	12957	0.03515
SRR10127634_1_kneaddata_paired	Cyanobacteria	9876	P	10677	62	10739	0.02913
SRR10127634_1_kneaddata_paired	Proteobacteria	22518	P	8595	335	8930	0.02422
SRR10127634_1_kneaddata_paired	Firmicutes_B	17289	P	1894	150	2044	0.00555
SRR10127634_1_kneaddata_paired	Spirochaetota	32587	P	317	0	317	0.00086
SRR10127634_1_kneaddata_paired	Desulfobacterota_A	11509	P	25	7	32	0.00009
SRR10127634_1_kneaddata_paired	Deferribacterota	10822	P	20	0	20	0.00005
SRR10127634_1_kneaddata_paired	Campylobacterota	8700	P	11	0	11	0.00003
SRR10127634_1_kneaddata_paired	Firmicutes_I	18140	P	4	0	4	0.00001
SRR10127634_1_kneaddata_paired	Firmicutes_C	17613	P	3	0	3	0.00001
SRR10127635_1_kneaddata_paired	Firmicutes_A	14608	P	86259	7001	93260	0.46854
SRR10127635_1_kneaddata_paired	Bacteroidota	4587	P	53854	1666	55520	0.27893
SRR10127635_1_kneaddata_paired	Firmicutes	12188	P	15191	6647	21838	0.10972
SRR10127635_1_kneaddata_paired	Cyanobacteria	9876	P	9092	149	9241	0.04643
SRR10127635_1_kneaddata_paired	Actinobacteriota	615	P	7446	174	7620	0.03829
SRR10127635_1_kneaddata_paired	Verrucomicrobiota	33333	P	4864	1405	6269	0.03150
SRR10127635_1_kneaddata_paired	Proteobacteria	22518	P	4053	381	4434	0.02228
SRR10127635_1_kneaddata_paired	Spirochaetota	32587	P	528	2	530	0.00267
SRR10127635_1_kneaddata_paired	Firmicutes_I	18140	P	182	0	182	0.00092
SRR10127635_1_kneaddata_paired	Firmicutes_B	17289	P	78	17	95	0.00048
SRR10127635_1_kneaddata_paired	Desulfobacterota_A	11509	P	21	13	34	0.00017
SRR10127635_1_kneaddata_paired	Campylobacterota	8700	P	13	0	13	0.00007
SRR10127635_1_kneaddata_paired	Deferribacterota	10822	P	3	0	3	0.00002
SRR10127636_1_kneaddata_paired	Firmicutes_A	14608	P	60982	7195	68177	0.59800
SRR10127636_1_kneaddata_paired	Bacteroidota	4587	P	17386	797	18183	0.15949
SRR10127636_1_kneaddata_paired	Actinobacteriota	615	P	10170	22	10192	0.08940
SRR10127636_1_kneaddata_paired	Cyanobacteria	9876	P	7045	134	7179	0.06298
SRR10127636_1_kneaddata_paired	Firmicutes	12188	P	3556	1565	5121	0.04492
SRR10127636_1_kneaddata_paired	Proteobacteria	22518	P	2184	261	2445	0.02145
SRR10127636_1_kneaddata_paired	Verrucomicrobiota	33333	P	1757	587	2344	0.02056
SRR10127636_1_kneaddata_paired	Spirochaetota	32587	P	296	1	297	0.00261
SRR10127636_1_kneaddata_paired	Firmicutes_B	17289	P	42	10	52	0.00046
SRR10127636_1_kneaddata_paired	Deferribacterota	10822	P	9	0	9	0.00008
SRR10127636_1_kneaddata_paired	Firmicutes_I	18140	P	3	0	3	0.00003
SRR10127636_1_kneaddata_paired	Campylobacterota	8700	P	2	0	2	0.00002
SRR10127637_1_kneaddata_paired	Firmicutes_A	14608	P	82208	1111	83319	0.45612
SRR10127637_1_kneaddata_paired	Bacteroidota	4587	P	36082	243	36325	0.19886
SRR10127637_1_kneaddata_paired	Firmicutes	12188	P	22746	2681	25427	0.13920
SRR10127637_1_kneaddata_paired	Verrucomicrobiota	33333	P	15307	791	16098	0.08813
SRR10127637_1_kneaddata_paired	Actinobacteriota	615	P	10739	38	10777	0.05900
SRR10127637_1_kneaddata_paired	Cyanobacteria	9876	P	6040	17	6057	0.03316
SRR10127637_1_kneaddata_paired	Proteobacteria	22518	P	4233	79	4312	0.02361
SRR10127637_1_kneaddata_paired	Firmicutes_B	17289	P	163	6	169	0.00093
SRR10127637_1_kneaddata_paired	Spirochaetota	32587	P	138	0	138	0.00076
SRR10127637_1_kneaddata_paired	Desulfobacterota_A	11509	P	21	3	24	0.00013
SRR10127637_1_kneaddata_paired	Deferribacterota	10822	P	11	0	11	0.00006
SRR10127637_1_kneaddata_paired	Campylobacterota	8700	P	5	0	5	0.00003
SRR10127637_1_kneaddata_paired	Firmicutes_I	18140	P	3	0	3	0.00002
SRR10127638_1_kneaddata_paired	Firmicutes_A	14608	P	56398	11300	67698	0.65025
SRR10127638_1_kneaddata_paired	Bacteroidota	4587	P	17474	1587	19061	0.18309
SRR10127638_1_kneaddata_paired	Cyanobacteria	9876	P	7917	302	8219	0.07895
SRR10127638_1_kneaddata_paired	Firmicutes	12188	P	3553	2574	6127	0.05886
SRR10127638_1_kneaddata_paired	Actinobacteriota	615	P	1957	16	1973	0.01895
SRR10127638_1_kneaddata_paired	Proteobacteria	22518	P	472	54	526	0.00505
SRR10127638_1_kneaddata_paired	Spirochaetota	32587	P	343	4	347	0.00333
SRR10127638_1_kneaddata_paired	Firmicutes_B	17289	P	70	36	106	0.00102
SRR10127638_1_kneaddata_paired	Verrucomicrobiota	33333	P	25	17	42	0.00041
SRR10127638_1_kneaddata_paired	Campylobacterota	8700	P	5	0	5	0.00005
SRR10127638_1_kneaddata_paired	Deferribacterota	10822	P	4	0	4	0.00004
SRR10127639_1_kneaddata_paired	Firmicutes_A	14608	P	135380	23073	158453	0.35702
SRR10127639_1_kneaddata_paired	Proteobacteria	22518	P	133686	1046	134732	0.30357
SRR10127639_1_kneaddata_paired	Bacteroidota	4587	P	78961	4400	83361	0.18783
SRR10127639_1_kneaddata_paired	Firmicutes	12188	P	22046	13365	35411	0.07979
SRR10127639_1_kneaddata_paired	Cyanobacteria	9876	P	17569	936	18505	0.04170
SRR10127639_1_kneaddata_paired	Actinobacteriota	615	P	9410	121	9531	0.02148
SRR10127639_1_kneaddata_paired	Verrucomicrobiota	33333	P	1417	958	2375	0.00535
SRR10127639_1_kneaddata_paired	Spirochaetota	32587	P	952	10	962	0.00217
SRR10127639_1_kneaddata_paired	Firmicutes_B	17289	P	203	103	306	0.00069
SRR10127639_1_kneaddata_paired	Desulfobacterota_A	11509	P	80	16	96	0.00022
SRR10127639_1_kneaddata_paired	Campylobacterota	8700	P	43	0	43	0.00010
SRR10127639_1_kneaddata_paired	Firmicutes_I	18140	P	25	0	25	0.00006
SRR10127639_1_kneaddata_paired	Deferribacterota	10822	P	12	0	12	0.00003
SRR10127639_1_kneaddata_paired	Elusimicrobiota	11888	P	4	0	4	0.00001
SRR10127640_1_kneaddata_paired	Firmicutes_A	14608	P	88987	12488	101475	0.44531
SRR10127640_1_kneaddata_paired	Bacteroidota	4587	P	51999	1694	53693	0.23562
SRR10127640_1_kneaddata_paired	Proteobacteria	22518	P	21136	367	21503	0.09436
SRR10127640_1_kneaddata_paired	Firmicutes	12188	P	18055	8513	26568	0.11659
SRR10127640_1_kneaddata_paired	Cyanobacteria	9876	P	9868	424	10292	0.04517
SRR10127640_1_kneaddata_paired	Actinobacteriota	615	P	9792	137	9929	0.04358
SRR10127640_1_kneaddata_paired	Verrucomicrobiota	33333	P	3133	447	3580	0.01571
SRR10127640_1_kneaddata_paired	Spirochaetota	32587	P	631	4	635	0.00279
SRR10127640_1_kneaddata_paired	Firmicutes_B	17289	P	111	38	149	0.00066
SRR10127640_1_kneaddata_paired	Desulfobacterota_A	11509	P	16	9	25	0.00011
SRR10127640_1_kneaddata_paired	Deferribacterota	10822	P	9	0	9	0.00004
SRR10127640_1_kneaddata_paired	Campylobacterota	8700	P	8	0	8	0.00004
SRR10127640_1_kneaddata_paired	Firmicutes_I	18140	P	4	0	4	0.00002
SRR10127640_1_kneaddata_paired	Elusimicrobiota	11888	P	1	0	1	0.00000
SRR10380305_1_kneaddata_paired	Bacteroidota	4587	P	25102117	159981	25262098	0.55768
SRR10380305_1_kneaddata_paired	Firmicutes_A	14608	P	18716612	169451	18886063	0.41693
SRR10380305_1_kneaddata_paired	Firmicutes	12188	P	602677	8205	610882	0.01349
SRR10380305_1_kneaddata_paired	Actinobacteriota	615	P	185706	1501	187207	0.00413
SRR10380305_1_kneaddata_paired	Proteobacteria	22518	P	174116	1076	175192	0.00387
SRR10380305_1_kneaddata_paired	Desulfobacterota_A	11509	P	89914	813	90727	0.00200
SRR10380305_1_kneaddata_paired	Deferribacterota	10822	P	44897	255	45152	0.00100
SRR10380305_1_kneaddata_paired	Cyanobacteria	9876	P	32338	497	32835	0.00072
SRR10380305_1_kneaddata_paired	Verrucomicrobiota	33333	P	4768	254	5022	0.00011
SRR10380305_1_kneaddata_paired	Firmicutes_B	17289	P	1113	61	1174	0.00003
SRR10380305_1_kneaddata_paired	Spirochaetota	32587	P	755	1	756	0.00002
SRR10380305_1_kneaddata_paired	Campylobacterota	8700	P	560	0	560	0.00001
SRR10380305_1_kneaddata_paired	Firmicutes_I	18140	P	330	0	330	0.00001
SRR10380305_1_kneaddata_paired	Firmicutes_C	17613	P	232	0	232	0.00001
SRR10380305_1_kneaddata_paired	Thermotogota	33086	P	156	0	156	0.00000
SRR10380305_1_kneaddata_paired	Elusimicrobiota	11888	P	41	0	41	0.00000
SRR10380306_1_kneaddata_paired	Firmicutes_A	14608	P	23084381	20694	23105075	0.52397
SRR10380306_1_kneaddata_paired	Bacteroidota	4587	P	14775173	40511	14815684	0.33599
SRR10380306_1_kneaddata_paired	Verrucomicrobiota	33333	P	3289077	109474	3398551	0.07707
SRR10380306_1_kneaddata_paired	Proteobacteria	22518	P	2323370	2656	2326026	0.05275
SRR10380306_1_kneaddata_paired	Firmicutes	12188	P	291576	919	292495	0.00663
SRR10380306_1_kneaddata_paired	Desulfobacterota_A	11509	P	138763	786	139549	0.00316
SRR10380306_1_kneaddata_paired	Cyanobacteria	9876	P	13533	422	13955	0.00032
SRR10380306_1_kneaddata_paired	Actinobacteriota	615	P	1626	2	1628	0.00004
SRR10380306_1_kneaddata_paired	Spirochaetota	32587	P	1606	3	1609	0.00004
SRR10380306_1_kneaddata_paired	Campylobacterota	8700	P	1149	0	1149	0.00003
SRR10380306_1_kneaddata_paired	Deferribacterota	10822	P	191	0	191	0.00000
SRR10380306_1_kneaddata_paired	Thermotogota	33086	P	95	0	95	0.00000
SRR10380306_1_kneaddata_paired	Firmicutes_B	17289	P	69	1	70	0.00000
SRR10380306_1_kneaddata_paired	Firmicutes_I	18140	P	13	0	13	0.00000
SRR10380306_1_kneaddata_paired	Firmicutes_C	17613	P	1	0	1	0.00000
SRR10380307_1_kneaddata_paired	Firmicutes_A	14608	P	39355163	212626	39567789	0.73388
SRR10380307_1_kneaddata_paired	Bacteroidota	4587	P	13180863	66738	13247601	0.24571
SRR10380307_1_kneaddata_paired	Firmicutes	12188	P	401985	4979	406964	0.00755
SRR10380307_1_kneaddata_paired	Actinobacteriota	615	P	314302	2379	316681	0.00587
SRR10380307_1_kneaddata_paired	Proteobacteria	22518	P	157798	657	158455	0.00294
SRR10380307_1_kneaddata_paired	Desulfobacterota_A	11509	P	151207	2265	153472	0.00285
SRR10380307_1_kneaddata_paired	Cyanobacteria	9876	P	52795	295	53090	0.00098
SRR10380307_1_kneaddata_paired	Verrucomicrobiota	33333	P	7740	353	8093	0.00015
SRR10380307_1_kneaddata_paired	Firmicutes_B	17289	P	1210	48	1258	0.00002
SRR10380307_1_kneaddata_paired	Campylobacterota	8700	P	720	0	720	0.00001
SRR10380307_1_kneaddata_paired	Spirochaetota	32587	P	526	1	527	0.00001
SRR10380307_1_kneaddata_paired	Firmicutes_I	18140	P	443	0	443	0.00001
SRR10380307_1_kneaddata_paired	Firmicutes_C	17613	P	319	0	319	0.00001
SRR10380307_1_kneaddata_paired	Deferribacterota	10822	P	226	0	226	0.00000
SRR10380307_1_kneaddata_paired	Thermotogota	33086	P	140	0	140	0.00000
SRR10380307_1_kneaddata_paired	Elusimicrobiota	11888	P	31	0	31	0.00000
SRR10430066_1_kneaddata_paired	Bacteroidota	4587	P	29945993	167160	30113153	0.52966
SRR10430066_1_kneaddata_paired	Firmicutes_A	14608	P	21935074	150423	22085497	0.38846
SRR10430066_1_kneaddata_paired	Verrucomicrobiota	33333	P	2810803	32393	2843196	0.05001
SRR10430066_1_kneaddata_paired	Proteobacteria	22518	P	934360	2959	937319	0.01649
SRR10430066_1_kneaddata_paired	Desulfobacterota_A	11509	P	581064	3807	584871	0.01029
SRR10430066_1_kneaddata_paired	Firmicutes	12188	P	216836	1239	218075	0.00384
SRR10430066_1_kneaddata_paired	Cyanobacteria	9876	P	60951	3109	64060	0.00113
SRR10430066_1_kneaddata_paired	Actinobacteriota	615	P	2835	11	2846	0.00005
SRR10430066_1_kneaddata_paired	Campylobacterota	8700	P	2393	1	2394	0.00004
SRR10430066_1_kneaddata_paired	Deferribacterota	10822	P	1082	0	1082	0.00002
SRR10430066_1_kneaddata_paired	Spirochaetota	32587	P	725	1	726	0.00001
SRR10430066_1_kneaddata_paired	Firmicutes_B	17289	P	396	13	409	0.00001
SRR10430066_1_kneaddata_paired	Firmicutes_I	18140	P	53	0	53	0.00000
SRR10430066_1_kneaddata_paired	Thermotogota	33086	P	5	0	5	0.00000
SRR10430066_1_kneaddata_paired	Firmicutes_C	17613	P	2	0	2	0.00000
SRR10594853_1_kneaddata_paired	Firmicutes_A	14608	P	3142596	22023	3164619	0.47821
SRR10594853_1_kneaddata_paired	Firmicutes	12188	P	2578561	38750	2617311	0.39551
SRR10594853_1_kneaddata_paired	Actinobacteriota	615	P	435339	3507	438846	0.06632
SRR10594853_1_kneaddata_paired	Bacteroidota	4587	P	344016	3301	347317	0.05248
SRR10594853_1_kneaddata_paired	Deferribacterota	10822	P	25955	156	26111	0.00395
SRR10594853_1_kneaddata_paired	Cyanobacteria	9876	P	7877	612	8489	0.00128
SRR10594853_1_kneaddata_paired	Proteobacteria	22518	P	4080	24	4104	0.00062
SRR10594853_1_kneaddata_paired	Firmicutes_B	17289	P	3473	208	3681	0.00056
SRR10594853_1_kneaddata_paired	Campylobacterota	8700	P	2222	2	2224	0.00034
SRR10594853_1_kneaddata_paired	Desulfobacterota_A	11509	P	2116	98	2214	0.00033
SRR10594853_1_kneaddata_paired	Firmicutes_I	18140	P	895	0	895	0.00014
SRR10594853_1_kneaddata_paired	Spirochaetota	32587	P	845	2	847	0.00013
SRR10594853_1_kneaddata_paired	Verrucomicrobiota	33333	P	750	63	813	0.00012
SRR10594853_1_kneaddata_paired	Firmicutes_C	17613	P	63	0	63	0.00001
SRR10594853_1_kneaddata_paired	Thermotogota	33086	P	23	0	23	0.00000
SRR10594853_1_kneaddata_paired	Elusimicrobiota	11888	P	20	0	20	0.00000
SRR10594855_1_kneaddata_paired	Bacteroidota	4587	P	162621	72571	235192	0.41498
SRR10594855_1_kneaddata_paired	Firmicutes_A	14608	P	151777	45410	197187	0.34792
SRR10594855_1_kneaddata_paired	Cyanobacteria	9876	P	65790	10795	76585	0.13513
SRR10594855_1_kneaddata_paired	Actinobacteriota	615	P	29823	970	30793	0.05433
SRR10594855_1_kneaddata_paired	Deferribacterota	10822	P	9065	2028	11093	0.01957
SRR10594855_1_kneaddata_paired	Firmicutes	12188	P	7166	3027	10193	0.01799
SRR10594855_1_kneaddata_paired	Proteobacteria	22518	P	3648	414	4062	0.00717
SRR10594855_1_kneaddata_paired	Spirochaetota	32587	P	830	40	870	0.00154
SRR10594855_1_kneaddata_paired	Desulfobacterota_A	11509	P	165	42	207	0.00037
SRR10594855_1_kneaddata_paired	Firmicutes_B	17289	P	143	316	459	0.00081
SRR10594855_1_kneaddata_paired	Verrucomicrobiota	33333	P	39	33	72	0.00013
SRR10594855_1_kneaddata_paired	Campylobacterota	8700	P	17	0	17	0.00003
SRR10594855_1_kneaddata_paired	Firmicutes_I	18140	P	16	0	16	0.00003
SRR10594855_1_kneaddata_paired	Elusimicrobiota	11888	P	2	0	2	0.00000
SRR10594855_1_kneaddata_paired	Firmicutes_C	17613	P	2	0	2	0.00000
SRR10594855_1_kneaddata_paired	Thermotogota	33086	P	2	0	2	0.00000
SRR10728393_1_kneaddata_paired	Firmicutes_A	14608	P	1702576	8474	1711050	0.53055
SRR10728393_1_kneaddata_paired	Bacteroidota	4587	P	1313321	8400	1321721	0.40983
SRR10728393_1_kneaddata_paired	Firmicutes	12188	P	184015	2247	186262	0.05776
SRR10728393_1_kneaddata_paired	Actinobacteriota	615	P	3077	2	3079	0.00095
SRR10728393_1_kneaddata_paired	Cyanobacteria	9876	P	1159	18	1177	0.00037
SRR10728393_1_kneaddata_paired	Firmicutes_B	17289	P	720	25	745	0.00023
SRR10728393_1_kneaddata_paired	Desulfobacterota_A	11509	P	203	26	229	0.00007
SRR10728393_1_kneaddata_paired	Proteobacteria	22518	P	191	0	191	0.00006
SRR10728393_1_kneaddata_paired	Spirochaetota	32587	P	179	0	179	0.00006
SRR10728393_1_kneaddata_paired	Campylobacterota	8700	P	145	0	145	0.00004
SRR10728393_1_kneaddata_paired	Deferribacterota	10822	P	114	0	114	0.00004
SRR10728393_1_kneaddata_paired	Verrucomicrobiota	33333	P	75	2	77	0.00002
SRR10728393_1_kneaddata_paired	Firmicutes_I	18140	P	40	0	40	0.00001
SRR10728393_1_kneaddata_paired	Thermotogota	33086	P	13	0	13	0.00000
SRR10728393_1_kneaddata_paired	Firmicutes_C	17613	P	6	0	6	0.00000
SRR10728393_1_kneaddata_paired	Elusimicrobiota	11888	P	3	0	3	0.00000
SRR10728394_1_kneaddata_paired	Bacteroidota	4587	P	1484542	4977	1489519	0.67910
SRR10728394_1_kneaddata_paired	Firmicutes_A	14608	P	665466	3302	668768	0.30491
SRR10728394_1_kneaddata_paired	Firmicutes	12188	P	29195	341	29536	0.01347
SRR10728394_1_kneaddata_paired	Actinobacteriota	615	P	4651	1	4652	0.00212
SRR10728394_1_kneaddata_paired	Firmicutes_B	17289	P	455	13	468	0.00021
SRR10728394_1_kneaddata_paired	Cyanobacteria	9876	P	122	1	123	0.00006
SRR10728394_1_kneaddata_paired	Proteobacteria	22518	P	95	0	95	0.00004
SRR10728394_1_kneaddata_paired	Desulfobacterota_A	11509	P	92	4	96	0.00004
SRR10728394_1_kneaddata_paired	Verrucomicrobiota	33333	P	53	2	55	0.00003
SRR10728394_1_kneaddata_paired	Spirochaetota	32587	P	18	0	18	0.00001
SRR10728394_1_kneaddata_paired	Firmicutes_I	18140	P	13	0	13	0.00001
SRR10728394_1_kneaddata_paired	Campylobacterota	8700	P	7	0	7	0.00000
SRR10728394_1_kneaddata_paired	Firmicutes_C	17613	P	4	0	4	0.00000
SRR10728394_1_kneaddata_paired	Deferribacterota	10822	P	1	0	1	0.00000
SRR10728394_1_kneaddata_paired	Elusimicrobiota	11888	P	1	0	1	0.00000
SRR10728395_1_kneaddata_paired	Bacteroidota	4587	P	728744	3945	732689	0.52904
SRR10728395_1_kneaddata_paired	Firmicutes_A	14608	P	580544	2523	583067	0.42100
SRR10728395_1_kneaddata_paired	Firmicutes	12188	P	66556	646	67202	0.04852
SRR10728395_1_kneaddata_paired	Actinobacteriota	615	P	885	0	885	0.00064
SRR10728395_1_kneaddata_paired	Cyanobacteria	9876	P	370	7	377	0.00027
SRR10728395_1_kneaddata_paired	Firmicutes_B	17289	P	337	11	348	0.00025
SRR10728395_1_kneaddata_paired	Desulfobacterota_A	11509	P	94	8	102	0.00007
SRR10728395_1_kneaddata_paired	Proteobacteria	22518	P	86	0	86	0.00006
SRR10728395_1_kneaddata_paired	Spirochaetota	32587	P	57	0	57	0.00004
SRR10728395_1_kneaddata_paired	Campylobacterota	8700	P	48	0	48	0.00003
SRR10728395_1_kneaddata_paired	Deferribacterota	10822	P	34	0	34	0.00002
SRR10728395_1_kneaddata_paired	Verrucomicrobiota	33333	P	29	1	30	0.00002
SRR10728395_1_kneaddata_paired	Firmicutes_I	18140	P	13	0	13	0.00001
SRR10728395_1_kneaddata_paired	Thermotogota	33086	P	3	0	3	0.00000
SRR10728395_1_kneaddata_paired	Firmicutes_C	17613	P	2	0	2	0.00000
SRR10728400_1_kneaddata_paired	Bacteroidota	4587	P	2268725	24704	2293429	0.52955
SRR10728400_1_kneaddata_paired	Firmicutes_A	14608	P	1847451	10303	1857754	0.42896
SRR10728400_1_kneaddata_paired	Firmicutes	12188	P	170152	2058	172210	0.03976
SRR10728400_1_kneaddata_paired	Actinobacteriota	615	P	4401	4	4405	0.00102
SRR10728400_1_kneaddata_paired	Firmicutes_B	17289	P	935	38	973	0.00022
SRR10728400_1_kneaddata_paired	Cyanobacteria	9876	P	858	20	878	0.00020
SRR10728400_1_kneaddata_paired	Spirochaetota	32587	P	269	1	270	0.00006
SRR10728400_1_kneaddata_paired	Proteobacteria	22518	P	232	1	233	0.00005
SRR10728400_1_kneaddata_paired	Campylobacterota	8700	P	204	0	204	0.00005
SRR10728400_1_kneaddata_paired	Deferribacterota	10822	P	165	0	165	0.00004
SRR10728400_1_kneaddata_paired	Desulfobacterota_A	11509	P	148	18	166	0.00004
SRR10728400_1_kneaddata_paired	Verrucomicrobiota	33333	P	91	5	96	0.00002
SRR10728400_1_kneaddata_paired	Firmicutes_I	18140	P	63	0	63	0.00001
SRR10728400_1_kneaddata_paired	Elusimicrobiota	11888	P	7	0	7	0.00000
SRR10728400_1_kneaddata_paired	Firmicutes_C	17613	P	7	0	7	0.00000
SRR10728403_1_kneaddata_paired	Bacteroidota	4587	P	2044070	25358	2069428	0.56418
SRR10728403_1_kneaddata_paired	Firmicutes_A	14608	P	1424454	6408	1430862	0.39009
SRR10728403_1_kneaddata_paired	Firmicutes	12188	P	135822	1114	136936	0.03733
SRR10728403_1_kneaddata_paired	Proteobacteria	22518	P	15607	261	15868	0.00433
SRR10728403_1_kneaddata_paired	Verrucomicrobiota	33333	P	6897	295	7192	0.00196
SRR10728403_1_kneaddata_paired	Actinobacteriota	615	P	6254	0	6254	0.00171
SRR10728403_1_kneaddata_paired	Cyanobacteria	9876	P	657	13	670	0.00018
SRR10728403_1_kneaddata_paired	Firmicutes_B	17289	P	276	7	283	0.00008
SRR10728403_1_kneaddata_paired	Desulfobacterota_A	11509	P	159	15	174	0.00005
SRR10728403_1_kneaddata_paired	Spirochaetota	32587	P	111	0	111	0.00003
SRR10728403_1_kneaddata_paired	Campylobacterota	8700	P	93	0	93	0.00003
SRR10728403_1_kneaddata_paired	Deferribacterota	10822	P	78	0	78	0.00002
SRR10728403_1_kneaddata_paired	Firmicutes_I	18140	P	31	0	31	0.00001
SRR10728403_1_kneaddata_paired	Firmicutes_C	17613	P	19	0	19	0.00001
SRR10728403_1_kneaddata_paired	Thermotogota	33086	P	4	0	4	0.00000
SRR10728404_1_kneaddata_paired	Bacteroidota	4587	P	2355544	40011	2395555	0.68309
SRR10728404_1_kneaddata_paired	Firmicutes_A	14608	P	960568	5206	965774	0.27539
SRR10728404_1_kneaddata_paired	Firmicutes	12188	P	92136	1022	93158	0.02656
SRR10728404_1_kneaddata_paired	Verrucomicrobiota	33333	P	22658	1043	23701	0.00676
SRR10728404_1_kneaddata_paired	Proteobacteria	22518	P	18148	323	18471	0.00527
SRR10728404_1_kneaddata_paired	Actinobacteriota	615	P	9355	1	9356	0.00267
SRR10728404_1_kneaddata_paired	Cyanobacteria	9876	P	471	17	488	0.00014
SRR10728404_1_kneaddata_paired	Firmicutes_B	17289	P	142	4	146	0.00004
SRR10728404_1_kneaddata_paired	Desulfobacterota_A	11509	P	115	9	124	0.00004
SRR10728404_1_kneaddata_paired	Spirochaetota	32587	P	47	0	47	0.00001
SRR10728404_1_kneaddata_paired	Deferribacterota	10822	P	39	0	39	0.00001
SRR10728404_1_kneaddata_paired	Campylobacterota	8700	P	35	0	35	0.00001
SRR10728404_1_kneaddata_paired	Firmicutes_I	18140	P	24	0	24	0.00001
SRR10728404_1_kneaddata_paired	Firmicutes_C	17613	P	6	0	6	0.00000
SRR10728404_1_kneaddata_paired	Thermotogota	33086	P	2	0	2	0.00000
SRR10728405_1_kneaddata_paired	Bacteroidota	4587	P	1734784	28418	1763202	0.62835
SRR10728405_1_kneaddata_paired	Firmicutes_A	14608	P	862792	3937	866729	0.30888
SRR10728405_1_kneaddata_paired	Firmicutes	12188	P	113724	907	114631	0.04085
SRR10728405_1_kneaddata_paired	Verrucomicrobiota	33333	P	33581	1467	35048	0.01249
SRR10728405_1_kneaddata_paired	Proteobacteria	22518	P	19956	342	20298	0.00723
SRR10728405_1_kneaddata_paired	Actinobacteriota	615	P	5324	0	5324	0.00190
SRR10728405_1_kneaddata_paired	Cyanobacteria	9876	P	389	12	401	0.00014
SRR10728405_1_kneaddata_paired	Firmicutes_B	17289	P	168	4	172	0.00006
SRR10728405_1_kneaddata_paired	Desulfobacterota_A	11509	P	97	7	104	0.00004
SRR10728405_1_kneaddata_paired	Deferribacterota	10822	P	53	0	53	0.00002
SRR10728405_1_kneaddata_paired	Spirochaetota	32587	P	44	0	44	0.00002
SRR10728405_1_kneaddata_paired	Campylobacterota	8700	P	39	0	39	0.00001
SRR10728405_1_kneaddata_paired	Firmicutes_I	18140	P	17	0	17	0.00001
SRR10728405_1_kneaddata_paired	Firmicutes_C	17613	P	9	0	9	0.00000
SRR10728405_1_kneaddata_paired	Elusimicrobiota	11888	P	1	0	1	0.00000
SRR10728406_1_kneaddata_paired	Firmicutes_A	14608	P	1419402	5798	1425200	0.53283
SRR10728406_1_kneaddata_paired	Bacteroidota	4587	P	1101522	17320	1118842	0.41829
SRR10728406_1_kneaddata_paired	Firmicutes	12188	P	82628	695	83323	0.03115
SRR10728406_1_kneaddata_paired	Verrucomicrobiota	33333	P	33543	1411	34954	0.01307
SRR10728406_1_kneaddata_paired	Proteobacteria	22518	P	8432	140	8572	0.00321
SRR10728406_1_kneaddata_paired	Actinobacteriota	615	P	3046	0	3046	0.00114
SRR10728406_1_kneaddata_paired	Cyanobacteria	9876	P	355	8	363	0.00014
SRR10728406_1_kneaddata_paired	Desulfobacterota_A	11509	P	167	15	182	0.00007
SRR10728406_1_kneaddata_paired	Firmicutes_B	17289	P	148	3	151	0.00006
SRR10728406_1_kneaddata_paired	Deferribacterota	10822	P	40	0	40	0.00001
SRR10728406_1_kneaddata_paired	Spirochaetota	32587	P	31	0	31	0.00001
SRR10728406_1_kneaddata_paired	Campylobacterota	8700	P	28	0	28	0.00001
SRR10728406_1_kneaddata_paired	Firmicutes_I	18140	P	17	0	17	0.00001
SRR10728406_1_kneaddata_paired	Firmicutes_C	17613	P	11	0	11	0.00000
SRR10728406_1_kneaddata_paired	Elusimicrobiota	11888	P	5	0	5	0.00000
SRR10728406_1_kneaddata_paired	Thermotogota	33086	P	1	0	1	0.00000
SRR10728407_1_kneaddata_paired	Bacteroidota	4587	P	2030512	33061	2063573	0.73887
SRR10728407_1_kneaddata_paired	Firmicutes_A	14608	P	606192	3483	609675	0.21830
SRR10728407_1_kneaddata_paired	Firmicutes	12188	P	47346	599	47945	0.01717
SRR10728407_1_kneaddata_paired	Verrucomicrobiota	33333	P	41379	1860	43239	0.01548
SRR10728407_1_kneaddata_paired	Proteobacteria	22518	P	20718	356	21074	0.00755
SRR10728407_1_kneaddata_paired	Actinobacteriota	615	P	6895	0	6895	0.00247
SRR10728407_1_kneaddata_paired	Cyanobacteria	9876	P	279	13	292	0.00010
SRR10728407_1_kneaddata_paired	Firmicutes_B	17289	P	104	3	107	0.00004
SRR10728407_1_kneaddata_paired	Desulfobacterota_A	11509	P	44	3	47	0.00002
SRR10728407_1_kneaddata_paired	Firmicutes_I	18140	P	12	0	12	0.00000
SRR10728407_1_kneaddata_paired	Spirochaetota	32587	P	10	0	10	0.00000
SRR10728407_1_kneaddata_paired	Campylobacterota	8700	P	6	0	6	0.00000
SRR10728407_1_kneaddata_paired	Deferribacterota	10822	P	3	0	3	0.00000
SRR10728407_1_kneaddata_paired	Firmicutes_C	17613	P	2	0	2	0.00000
SRR10728408_1_kneaddata_paired	Firmicutes_A	14608	P	1223316	3222	1226538	0.70092
SRR10728408_1_kneaddata_paired	Bacteroidota	4587	P	469014	3712	472726	0.27015
SRR10728408_1_kneaddata_paired	Verrucomicrobiota	33333	P	25088	815	25903	0.01480
SRR10728408_1_kneaddata_paired	Actinobacteriota	615	P	12034	1	12035	0.00688
SRR10728408_1_kneaddata_paired	Firmicutes	12188	P	6909	69	6978	0.00399
SRR10728408_1_kneaddata_paired	Proteobacteria	22518	P	5379	64	5443	0.00311
SRR10728408_1_kneaddata_paired	Desulfobacterota_A	11509	P	96	4	100	0.00006
SRR10728408_1_kneaddata_paired	Firmicutes_B	17289	P	84	1	85	0.00005
SRR10728408_1_kneaddata_paired	Cyanobacteria	9876	P	44	0	44	0.00003
SRR10728408_1_kneaddata_paired	Firmicutes_C	17613	P	10	0	10	0.00001
SRR10728408_1_kneaddata_paired	Spirochaetota	32587	P	7	0	7	0.00000
SRR10728408_1_kneaddata_paired	Firmicutes_I	18140	P	6	0	6	0.00000
SRR10728408_1_kneaddata_paired	Elusimicrobiota	11888	P	5	0	5	0.00000
SRR10728408_1_kneaddata_paired	Campylobacterota	8700	P	4	0	4	0.00000
SRR10728408_1_kneaddata_paired	Deferribacterota	10822	P	4	0	4	0.00000
SRR10728408_1_kneaddata_paired	Thermotogota	33086	P	1	0	1	0.00000
SRR10728411_1_kneaddata_paired	Bacteroidota	4587	P	1841190	15898	1857088	0.50041
SRR10728411_1_kneaddata_paired	Firmicutes_A	14608	P	1635725	9210	1644935	0.44324
SRR10728411_1_kneaddata_paired	Firmicutes	12188	P	200517	2754	203271	0.05477
SRR10728411_1_kneaddata_paired	Actinobacteriota	615	P	2345	2	2347	0.00063
SRR10728411_1_kneaddata_paired	Firmicutes_B	17289	P	1209	46	1255	0.00034
SRR10728411_1_kneaddata_paired	Cyanobacteria	9876	P	1026	24	1050	0.00028
SRR10728411_1_kneaddata_paired	Proteobacteria	22518	P	271	3	274	0.00007
SRR10728411_1_kneaddata_paired	Desulfobacterota_A	11509	P	217	17	234	0.00006
SRR10728411_1_kneaddata_paired	Campylobacterota	8700	P	176	0	176	0.00005
SRR10728411_1_kneaddata_paired	Deferribacterota	10822	P	168	0	168	0.00005
SRR10728411_1_kneaddata_paired	Spirochaetota	32587	P	134	0	134	0.00004
SRR10728411_1_kneaddata_paired	Verrucomicrobiota	33333	P	109	6	115	0.00003
SRR10728411_1_kneaddata_paired	Firmicutes_I	18140	P	57	0	57	0.00002
SRR10728411_1_kneaddata_paired	Firmicutes_C	17613	P	16	0	16	0.00000
SRR10728411_1_kneaddata_paired	Thermotogota	33086	P	10	0	10	0.00000
SRR10728411_1_kneaddata_paired	Elusimicrobiota	11888	P	2	0	2	0.00000
SRR10728416_1_kneaddata_paired	Bacteroidota	4587	P	1816570	14441	1831011	0.63267
SRR10728416_1_kneaddata_paired	Firmicutes_A	14608	P	850180	4752	854932	0.29541
SRR10728416_1_kneaddata_paired	Firmicutes	12188	P	200923	2596	203519	0.07032
SRR10728416_1_kneaddata_paired	Actinobacteriota	615	P	2406	2	2408	0.00083
SRR10728416_1_kneaddata_paired	Firmicutes_B	17289	P	906	38	944	0.00033
SRR10728416_1_kneaddata_paired	Cyanobacteria	9876	P	706	14	720	0.00025
SRR10728416_1_kneaddata_paired	Proteobacteria	22518	P	133	0	133	0.00005
SRR10728416_1_kneaddata_paired	Spirochaetota	32587	P	83	0	83	0.00003
SRR10728416_1_kneaddata_paired	Desulfobacterota_A	11509	P	82	8	90	0.00003
SRR10728416_1_kneaddata_paired	Deferribacterota	10822	P	78	0	78	0.00003
SRR10728416_1_kneaddata_paired	Campylobacterota	8700	P	69	0	69	0.00002
SRR10728416_1_kneaddata_paired	Verrucomicrobiota	33333	P	45	2	47	0.00002
SRR10728416_1_kneaddata_paired	Firmicutes_I	18140	P	29	0	29	0.00001
SRR10728416_1_kneaddata_paired	Firmicutes_C	17613	P	14	0	14	0.00000
SRR10728416_1_kneaddata_paired	Thermotogota	33086	P	6	0	6	0.00000
SRR10728416_1_kneaddata_paired	Elusimicrobiota	11888	P	1	0	1	0.00000
SRR10728417_1_kneaddata_paired	Bacteroidota	4587	P	718040	2467	720507	0.50113
SRR10728417_1_kneaddata_paired	Firmicutes_A	14608	P	704859	3352	708211	0.49257
SRR10728417_1_kneaddata_paired	Firmicutes	12188	P	6709	92	6801	0.00473
SRR10728417_1_kneaddata_paired	Actinobacteriota	615	P	1670	0	1670	0.00116
SRR10728417_1_kneaddata_paired	Firmicutes_B	17289	P	256	8	264	0.00018
SRR10728417_1_kneaddata_paired	Cyanobacteria	9876	P	99	1	100	0.00007
SRR10728417_1_kneaddata_paired	Desulfobacterota_A	11509	P	77	5	82	0.00006
SRR10728417_1_kneaddata_paired	Verrucomicrobiota	33333	P	59	2	61	0.00004
SRR10728417_1_kneaddata_paired	Proteobacteria	22518	P	49	0	49	0.00003
SRR10728417_1_kneaddata_paired	Firmicutes_I	18140	P	9	0	9	0.00001
SRR10728417_1_kneaddata_paired	Firmicutes_C	17613	P	6	0	6	0.00000
SRR10728417_1_kneaddata_paired	Spirochaetota	32587	P	5	0	5	0.00000
SRR10728417_1_kneaddata_paired	Deferribacterota	10822	P	4	0	4	0.00000
SRR10728417_1_kneaddata_paired	Campylobacterota	8700	P	3	0	3	0.00000
SRR10728417_1_kneaddata_paired	Elusimicrobiota	11888	P	1	0	1	0.00000
SRR10728417_1_kneaddata_paired	Thermotogota	33086	P	1	0	1	0.00000
SRR10728418_1_kneaddata_paired	Bacteroidota	4587	P	1126314	9063	1135377	0.51472
SRR10728418_1_kneaddata_paired	Firmicutes_A	14608	P	965134	4975	970109	0.43979
SRR10728418_1_kneaddata_paired	Firmicutes	12188	P	95057	1441	96498	0.04375
SRR10728418_1_kneaddata_paired	Actinobacteriota	615	P	2415	1	2416	0.00110
SRR10728418_1_kneaddata_paired	Cyanobacteria	9876	P	563	13	576	0.00026
SRR10728418_1_kneaddata_paired	Firmicutes_B	17289	P	340	12	352	0.00016
SRR10728418_1_kneaddata_paired	Desulfobacterota_A	11509	P	118	16	134	0.00006
SRR10728418_1_kneaddata_paired	Proteobacteria	22518	P	90	0	90	0.00004
SRR10728418_1_kneaddata_paired	Campylobacterota	8700	P	74	0	74	0.00003
SRR10728418_1_kneaddata_paired	Spirochaetota	32587	P	71	0	71	0.00003
SRR10728418_1_kneaddata_paired	Verrucomicrobiota	33333	P	61	2	63	0.00003
SRR10728418_1_kneaddata_paired	Deferribacterota	10822	P	41	0	41	0.00002
SRR10728418_1_kneaddata_paired	Firmicutes_I	18140	P	10	0	10	0.00000
SRR10728418_1_kneaddata_paired	Thermotogota	33086	P	8	0	8	0.00000
SRR10728418_1_kneaddata_paired	Firmicutes_C	17613	P	7	0	7	0.00000
SRR10728418_1_kneaddata_paired	Elusimicrobiota	11888	P	2	0	2	0.00000
SRR10728419_1_kneaddata_paired	Firmicutes_A	14608	P	1557745	8028	1565773	0.52802
SRR10728419_1_kneaddata_paired	Bacteroidota	4587	P	1263233	7461	1270694	0.42851
SRR10728419_1_kneaddata_paired	Firmicutes	12188	P	122634	1829	124463	0.04197
SRR10728419_1_kneaddata_paired	Actinobacteriota	615	P	2509	1	2510	0.00085
SRR10728419_1_kneaddata_paired	Firmicutes_B	17289	P	615	24	639	0.00022
SRR10728419_1_kneaddata_paired	Cyanobacteria	9876	P	609	12	621	0.00021
SRR10728419_1_kneaddata_paired	Desulfobacterota_A	11509	P	217	33	250	0.00008
SRR10728419_1_kneaddata_paired	Proteobacteria	22518	P	126	0	126	0.00004
SRR10728419_1_kneaddata_paired	Verrucomicrobiota	33333	P	77	3	80	0.00003
SRR10728419_1_kneaddata_paired	Spirochaetota	32587	P	69	0	69	0.00002
SRR10728419_1_kneaddata_paired	Deferribacterota	10822	P	65	0	65	0.00002
SRR10728419_1_kneaddata_paired	Campylobacterota	8700	P	49	0	49	0.00002
SRR10728419_1_kneaddata_paired	Firmicutes_I	18140	P	13	0	13	0.00000
SRR10728419_1_kneaddata_paired	Firmicutes_C	17613	P	12	0	12	0.00000
SRR10728419_1_kneaddata_paired	Elusimicrobiota	11888	P	5	0	5	0.00000
SRR10728419_1_kneaddata_paired	Thermotogota	33086	P	4	0	4	0.00000
SRR10728420_1_kneaddata_paired	Bacteroidota	4587	P	1242385	6361	1248746	0.52441
SRR10728420_1_kneaddata_paired	Firmicutes_A	14608	P	1064241	4598	1068839	0.44886
SRR10728420_1_kneaddata_paired	Firmicutes	12188	P	59414	803	60217	0.02529
SRR10728420_1_kneaddata_paired	Actinobacteriota	615	P	2289	1	2290	0.00096
SRR10728420_1_kneaddata_paired	Firmicutes_B	17289	P	430	13	443	0.00019
SRR10728420_1_kneaddata_paired	Cyanobacteria	9876	P	282	5	287	0.00012
SRR10728420_1_kneaddata_paired	Desulfobacterota_A	11509	P	159	12	171	0.00007
SRR10728420_1_kneaddata_paired	Proteobacteria	22518	P	87	0	87	0.00004
SRR10728420_1_kneaddata_paired	Verrucomicrobiota	33333	P	35	1	36	0.00002
SRR10728420_1_kneaddata_paired	Deferribacterota	10822	P	33	0	33	0.00001
SRR10728420_1_kneaddata_paired	Campylobacterota	8700	P	27	0	27	0.00001
SRR10728420_1_kneaddata_paired	Spirochaetota	32587	P	18	0	18	0.00001
SRR10728420_1_kneaddata_paired	Firmicutes_I	18140	P	10	0	10	0.00000
SRR10728420_1_kneaddata_paired	Firmicutes_C	17613	P	9	0	9	0.00000
SRR10728420_1_kneaddata_paired	Thermotogota	33086	P	2	0	2	0.00000
SRR10728421_1_kneaddata_paired	Firmicutes_A	14608	P	688571	3129	691700	0.47120
SRR10728421_1_kneaddata_paired	Bacteroidota	4587	P	686476	3712	690188	0.47017
SRR10728421_1_kneaddata_paired	Firmicutes	12188	P	82624	999	83623	0.05697
SRR10728421_1_kneaddata_paired	Actinobacteriota	615	P	1324	0	1324	0.00090
SRR10728421_1_kneaddata_paired	Cyanobacteria	9876	P	416	10	426	0.00029
SRR10728421_1_kneaddata_paired	Firmicutes_B	17289	P	339	12	351	0.00024
SRR10728421_1_kneaddata_paired	Desulfobacterota_A	11509	P	86	8	94	0.00006
SRR10728421_1_kneaddata_paired	Proteobacteria	22518	P	74	0	74	0.00005
SRR10728421_1_kneaddata_paired	Deferribacterota	10822	P	58	0	58	0.00004
SRR10728421_1_kneaddata_paired	Spirochaetota	32587	P	45	0	45	0.00003
SRR10728421_1_kneaddata_paired	Campylobacterota	8700	P	35	0	35	0.00002
SRR10728421_1_kneaddata_paired	Verrucomicrobiota	33333	P	16	0	16	0.00001
SRR10728421_1_kneaddata_paired	Firmicutes_I	18140	P	9	0	9	0.00001
SRR10728421_1_kneaddata_paired	Firmicutes_C	17613	P	4	0	4	0.00000
SRR10728421_1_kneaddata_paired	Elusimicrobiota	11888	P	2	0	2	0.00000
SRR10728421_1_kneaddata_paired	Thermotogota	33086	P	1	0	1	0.00000
SRR10728422_1_kneaddata_paired	Bacteroidota	4587	P	2018174	14761	2032935	0.62999
SRR10728422_1_kneaddata_paired	Firmicutes_A	14608	P	999279	4356	1003635	0.31102
SRR10728422_1_kneaddata_paired	Firmicutes	12188	P	182637	2119	184756	0.05725
SRR10728422_1_kneaddata_paired	Actinobacteriota	615	P	3687	2	3689	0.00114
SRR10728422_1_kneaddata_paired	Cyanobacteria	9876	P	682	18	700	0.00022
SRR10728422_1_kneaddata_paired	Firmicutes_B	17289	P	570	22	592	0.00018
SRR10728422_1_kneaddata_paired	Desulfobacterota_A	11509	P	134	17	151	0.00005
SRR10728422_1_kneaddata_paired	Spirochaetota	32587	P	124	0	124	0.00004
SRR10728422_1_kneaddata_paired	Deferribacterota	10822	P	104	0	104	0.00003
SRR10728422_1_kneaddata_paired	Proteobacteria	22518	P	96	0	96	0.00003
SRR10728422_1_kneaddata_paired	Verrucomicrobiota	33333	P	72	4	76	0.00002
SRR10728422_1_kneaddata_paired	Campylobacterota	8700	P	62	0	62	0.00002
SRR10728422_1_kneaddata_paired	Firmicutes_I	18140	P	20	0	20	0.00001
SRR10728422_1_kneaddata_paired	Firmicutes_C	17613	P	5	0	5	0.00000
SRR10728422_1_kneaddata_paired	Thermotogota	33086	P	5	0	5	0.00000
SRR10728429_1_kneaddata_paired	Bacteroidota	4587	P	3060520	44740	3105260	0.69742
SRR10728429_1_kneaddata_paired	Firmicutes_A	14608	P	1176576	4824	1181400	0.26533
SRR10728429_1_kneaddata_paired	Firmicutes	12188	P	63378	643	64021	0.01438
SRR10728429_1_kneaddata_paired	Verrucomicrobiota	33333	P	62051	2574	64625	0.01451
SRR10728429_1_kneaddata_paired	Proteobacteria	22518	P	26021	418	26439	0.00594
SRR10728429_1_kneaddata_paired	Actinobacteriota	615	P	9775	1	9776	0.00220
SRR10728429_1_kneaddata_paired	Cyanobacteria	9876	P	514	19	533	0.00012
SRR10728429_1_kneaddata_paired	Desulfobacterota_A	11509	P	182	18	200	0.00004
SRR10728429_1_kneaddata_paired	Firmicutes_B	17289	P	99	2	101	0.00002
SRR10728429_1_kneaddata_paired	Spirochaetota	32587	P	38	0	38	0.00001
SRR10728429_1_kneaddata_paired	Campylobacterota	8700	P	31	0	31	0.00001
SRR10728429_1_kneaddata_paired	Deferribacterota	10822	P	30	0	30	0.00001
SRR10728429_1_kneaddata_paired	Firmicutes_I	18140	P	23	0	23	0.00001
SRR10728429_1_kneaddata_paired	Firmicutes_C	17613	P	11	0	11	0.00000
SRR10728429_1_kneaddata_paired	Elusimicrobiota	11888	P	1	0	1	0.00000
SRR10728430_1_kneaddata_paired	Bacteroidota	4587	P	3231394	49458	3280852	0.55638
SRR10728430_1_kneaddata_paired	Firmicutes_A	14608	P	2198843	8188	2207031	0.37428
SRR10728430_1_kneaddata_paired	Firmicutes	12188	P	210931	1719	212650	0.03606
SRR10728430_1_kneaddata_paired	Verrucomicrobiota	33333	P	160288	6927	167215	0.02836
SRR10728430_1_kneaddata_paired	Proteobacteria	22518	P	17720	295	18015	0.00306
SRR10728430_1_kneaddata_paired	Actinobacteriota	615	P	9379	1	9380	0.00159
SRR10728430_1_kneaddata_paired	Cyanobacteria	9876	P	735	25	760	0.00013
SRR10728430_1_kneaddata_paired	Desulfobacterota_A	11509	P	249	20	269	0.00005
SRR10728430_1_kneaddata_paired	Firmicutes_B	17289	P	246	6	252	0.00004
SRR10728430_1_kneaddata_paired	Spirochaetota	32587	P	101	0	101	0.00002
SRR10728430_1_kneaddata_paired	Campylobacterota	8700	P	74	0	74	0.00001
SRR10728430_1_kneaddata_paired	Deferribacterota	10822	P	73	0	73	0.00001
SRR10728430_1_kneaddata_paired	Firmicutes_I	18140	P	33	0	33	0.00001
SRR10728430_1_kneaddata_paired	Firmicutes_C	17613	P	20	0	20	0.00000
SRR10728430_1_kneaddata_paired	Thermotogota	33086	P	4	0	4	0.00000
SRR10728431_1_kneaddata_paired	Bacteroidota	4587	P	2470011	24759	2494770	0.61018
SRR10728431_1_kneaddata_paired	Firmicutes_A	14608	P	1113834	4472	1118306	0.27352
SRR10728431_1_kneaddata_paired	Verrucomicrobiota	33333	P	288839	10005	298844	0.07309
SRR10728431_1_kneaddata_paired	Firmicutes	12188	P	140482	950	141432	0.03459
SRR10728431_1_kneaddata_paired	Proteobacteria	22518	P	26768	362	27130	0.00664
SRR10728431_1_kneaddata_paired	Actinobacteriota	615	P	5873	0	5873	0.00144
SRR10728431_1_kneaddata_paired	Cyanobacteria	9876	P	1169	17	1186	0.00029
SRR10728431_1_kneaddata_paired	Campylobacterota	8700	P	245	0	245	0.00006
SRR10728431_1_kneaddata_paired	Firmicutes_B	17289	P	218	4	222	0.00005
SRR10728431_1_kneaddata_paired	Deferribacterota	10822	P	172	0	172	0.00004
SRR10728431_1_kneaddata_paired	Desulfobacterota_A	11509	P	166	11	177	0.00004
SRR10728431_1_kneaddata_paired	Spirochaetota	32587	P	142	0	142	0.00003
SRR10728431_1_kneaddata_paired	Firmicutes_I	18140	P	51	0	51	0.00001
SRR10728431_1_kneaddata_paired	Firmicutes_C	17613	P	12	0	12	0.00000
SRR10728431_1_kneaddata_paired	Elusimicrobiota	11888	P	5	0	5	0.00000
SRR10728431_1_kneaddata_paired	Thermotogota	33086	P	2	0	2	0.00000
SRR10728432_1_kneaddata_paired	Bacteroidota	4587	P	3202824	45112	3247936	0.64214
SRR10728432_1_kneaddata_paired	Firmicutes_A	14608	P	1349297	6143	1355440	0.26798
SRR10728432_1_kneaddata_paired	Firmicutes	12188	P	279015	2472	281487	0.05565
SRR10728432_1_kneaddata_paired	Verrucomicrobiota	33333	P	114404	4802	119206	0.02357
SRR10728432_1_kneaddata_paired	Proteobacteria	22518	P	36680	600	37280	0.00737
SRR10728432_1_kneaddata_paired	Actinobacteriota	615	P	14831	1	14832	0.00293
SRR10728432_1_kneaddata_paired	Cyanobacteria	9876	P	881	20	901	0.00018
SRR10728432_1_kneaddata_paired	Firmicutes_B	17289	P	269	7	276	0.00005
SRR10728432_1_kneaddata_paired	Desulfobacterota_A	11509	P	206	21	227	0.00004
SRR10728432_1_kneaddata_paired	Spirochaetota	32587	P	148	0	148	0.00003
SRR10728432_1_kneaddata_paired	Deferribacterota	10822	P	104	0	104	0.00002
SRR10728432_1_kneaddata_paired	Campylobacterota	8700	P	96	0	96	0.00002
SRR10728432_1_kneaddata_paired	Firmicutes_I	18140	P	41	0	41	0.00001
SRR10728432_1_kneaddata_paired	Firmicutes_C	17613	P	27	0	27	0.00001
SRR10728432_1_kneaddata_paired	Thermotogota	33086	P	8	0	8	0.00000
SRR10728432_1_kneaddata_paired	Elusimicrobiota	11888	P	1	0	1	0.00000
SRR10728433_1_kneaddata_paired	Firmicutes_A	14608	P	1173192	6365	1179557	0.51004
SRR10728433_1_kneaddata_paired	Bacteroidota	4587	P	983894	6222	990116	0.42812
SRR10728433_1_kneaddata_paired	Firmicutes	12188	P	138380	1579	139959	0.06052
SRR10728433_1_kneaddata_paired	Actinobacteriota	615	P	1638	0	1638	0.00071
SRR10728433_1_kneaddata_paired	Cyanobacteria	9876	P	532	9	541	0.00023
SRR10728433_1_kneaddata_paired	Firmicutes_B	17289	P	425	15	440	0.00019
SRR10728433_1_kneaddata_paired	Desulfobacterota_A	11509	P	122	14	136	0.00006
SRR10728433_1_kneaddata_paired	Proteobacteria	22518	P	80	0	80	0.00003
SRR10728433_1_kneaddata_paired	Campylobacterota	8700	P	59	0	59	0.00003
SRR10728433_1_kneaddata_paired	Spirochaetota	32587	P	59	0	59	0.00003
SRR10728433_1_kneaddata_paired	Verrucomicrobiota	33333	P	39	1	40	0.00002
SRR10728433_1_kneaddata_paired	Deferribacterota	10822	P	30	0	30	0.00001
SRR10728433_1_kneaddata_paired	Firmicutes_I	18140	P	19	0	19	0.00001
SRR10728433_1_kneaddata_paired	Firmicutes_C	17613	P	11	0	11	0.00000
SRR10728433_1_kneaddata_paired	Elusimicrobiota	11888	P	3	0	3	0.00000
SRR10728433_1_kneaddata_paired	Thermotogota	33086	P	3	0	3	0.00000
SRR10728434_1_kneaddata_paired	Bacteroidota	4587	P	3889753	52642	3942395	0.67785
SRR10728434_1_kneaddata_paired	Firmicutes_A	14608	P	1316791	6892	1323683	0.22759
SRR10728434_1_kneaddata_paired	Firmicutes	12188	P	265705	1704	267409	0.04598
SRR10728434_1_kneaddata_paired	Verrucomicrobiota	33333	P	231332	9821	241153	0.04146
SRR10728434_1_kneaddata_paired	Proteobacteria	22518	P	23344	381	23725	0.00408
SRR10728434_1_kneaddata_paired	Actinobacteriota	615	P	15959	1	15960	0.00274
SRR10728434_1_kneaddata_paired	Cyanobacteria	9876	P	799	24	823	0.00014
SRR10728434_1_kneaddata_paired	Firmicutes_B	17289	P	281	7	288	0.00005
SRR10728434_1_kneaddata_paired	Desulfobacterota_A	11509	P	163	12	175	0.00003
SRR10728434_1_kneaddata_paired	Spirochaetota	32587	P	158	0	158	0.00003
SRR10728434_1_kneaddata_paired	Campylobacterota	8700	P	113	0	113	0.00002
SRR10728434_1_kneaddata_paired	Deferribacterota	10822	P	73	0	73	0.00001
SRR10728434_1_kneaddata_paired	Firmicutes_I	18140	P	38	0	38	0.00001
SRR10728434_1_kneaddata_paired	Firmicutes_C	17613	P	18	0	18	0.00000
SRR10728434_1_kneaddata_paired	Thermotogota	33086	P	5	0	5	0.00000
SRR10728434_1_kneaddata_paired	Elusimicrobiota	11888	P	4	0	4	0.00000
SRR10728435_1_kneaddata_paired	Bacteroidota	4587	P	2564936	35927	2600863	0.69127
SRR10728435_1_kneaddata_paired	Firmicutes_A	14608	P	901127	4228	905355	0.24063
SRR10728435_1_kneaddata_paired	Firmicutes	12188	P	151319	1366	152685	0.04058
SRR10728435_1_kneaddata_paired	Verrucomicrobiota	33333	P	72218	3118	75336	0.02002
SRR10728435_1_kneaddata_paired	Proteobacteria	22518	P	15450	259	15709	0.00418
SRR10728435_1_kneaddata_paired	Actinobacteriota	615	P	11302	1	11303	0.00300
SRR10728435_1_kneaddata_paired	Cyanobacteria	9876	P	580	16	596	0.00016
SRR10728435_1_kneaddata_paired	Firmicutes_B	17289	P	183	5	188	0.00005
SRR10728435_1_kneaddata_paired	Desulfobacterota_A	11509	P	145	12	157	0.00004
SRR10728435_1_kneaddata_paired	Campylobacterota	8700	P	79	0	79	0.00002
SRR10728435_1_kneaddata_paired	Spirochaetota	32587	P	55	0	55	0.00001
SRR10728435_1_kneaddata_paired	Deferribacterota	10822	P	53	0	53	0.00001
SRR10728435_1_kneaddata_paired	Firmicutes_I	18140	P	30	0	30	0.00001
SRR10728435_1_kneaddata_paired	Firmicutes_C	17613	P	12	0	12	0.00000
SRR10728435_1_kneaddata_paired	Thermotogota	33086	P	3	0	3	0.00000
SRR10728435_1_kneaddata_paired	Elusimicrobiota	11888	P	1	0	1	0.00000
SRR10728436_1_kneaddata_paired	Bacteroidota	4587	P	773526	5085	778611	0.59411
SRR10728436_1_kneaddata_paired	Firmicutes_A	14608	P	478385	1609	479994	0.36626
SRR10728436_1_kneaddata_paired	Firmicutes	12188	P	44843	285	45128	0.03444
SRR10728436_1_kneaddata_paired	Actinobacteriota	615	P	5546	0	5546	0.00423
SRR10728436_1_kneaddata_paired	Proteobacteria	22518	P	708	9	717	0.00055
SRR10728436_1_kneaddata_paired	Cyanobacteria	9876	P	237	2	239	0.00018
SRR10728436_1_kneaddata_paired	Desulfobacterota_A	11509	P	85	6	91	0.00007
SRR10728436_1_kneaddata_paired	Firmicutes_B	17289	P	53	1	54	0.00004
SRR10728436_1_kneaddata_paired	Spirochaetota	32587	P	42	0	42	0.00003
SRR10728436_1_kneaddata_paired	Campylobacterota	8700	P	38	0	38	0.00003
SRR10728436_1_kneaddata_paired	Deferribacterota	10822	P	33	0	33	0.00003
SRR10728436_1_kneaddata_paired	Verrucomicrobiota	33333	P	17	0	17	0.00001
SRR10728436_1_kneaddata_paired	Firmicutes_I	18140	P	11	0	11	0.00001
SRR10728436_1_kneaddata_paired	Firmicutes_C	17613	P	9	0	9	0.00001
SRR10728436_1_kneaddata_paired	Thermotogota	33086	P	6	0	6	0.00000
SRR10728436_1_kneaddata_paired	Elusimicrobiota	11888	P	1	0	1	0.00000
SRR10728437_1_kneaddata_paired	Firmicutes_A	14608	P	1435669	9066	1444735	0.89692
SRR10728437_1_kneaddata_paired	Bacteroidota	4587	P	131681	3297	134978	0.08380
SRR10728437_1_kneaddata_paired	Firmicutes	12188	P	19956	517	20473	0.01271
SRR10728437_1_kneaddata_paired	Actinobacteriota	615	P	7998	1	7999	0.00497
SRR10728437_1_kneaddata_paired	Verrucomicrobiota	33333	P	1603	103	1706	0.00106
SRR10728437_1_kneaddata_paired	Proteobacteria	22518	P	504	11	515	0.00032
SRR10728437_1_kneaddata_paired	Desulfobacterota_A	11509	P	135	17	152	0.00009
SRR10728437_1_kneaddata_paired	Cyanobacteria	9876	P	91	2	93	0.00006
SRR10728437_1_kneaddata_paired	Firmicutes_B	17289	P	49	1	50	0.00003
SRR10728437_1_kneaddata_paired	Spirochaetota	32587	P	21	0	21	0.00001
SRR10728437_1_kneaddata_paired	Campylobacterota	8700	P	20	0	20	0.00001
SRR10728437_1_kneaddata_paired	Deferribacterota	10822	P	18	0	18	0.00001
SRR10728437_1_kneaddata_paired	Firmicutes_C	17613	P	8	0	8	0.00000
SRR10728437_1_kneaddata_paired	Firmicutes_I	18140	P	7	0	7	0.00000
SRR10728437_1_kneaddata_paired	Elusimicrobiota	11888	P	1	0	1	0.00000
SRR10728438_1_kneaddata_paired	Bacteroidota	4587	P	2818357	42495	2860852	0.63892
SRR10728438_1_kneaddata_paired	Firmicutes_A	14608	P	1392630	5789	1398419	0.31231
SRR10728438_1_kneaddata_paired	Firmicutes	12188	P	147599	1459	149058	0.03329
SRR10728438_1_kneaddata_paired	Verrucomicrobiota	33333	P	25362	1118	26480	0.00591
SRR10728438_1_kneaddata_paired	Proteobacteria	22518	P	24259	417	24676	0.00551
SRR10728438_1_kneaddata_paired	Actinobacteriota	615	P	17023	1	17024	0.00380
SRR10728438_1_kneaddata_paired	Cyanobacteria	9876	P	478	19	497	0.00011
SRR10728438_1_kneaddata_paired	Firmicutes_B	17289	P	259	7	266	0.00006
SRR10728438_1_kneaddata_paired	Desulfobacterota_A	11509	P	156	12	168	0.00004
SRR10728438_1_kneaddata_paired	Spirochaetota	32587	P	84	0	84	0.00002
SRR10728438_1_kneaddata_paired	Campylobacterota	8700	P	50	0	50	0.00001
SRR10728438_1_kneaddata_paired	Deferribacterota	10822	P	18	0	18	0.00000
SRR10728438_1_kneaddata_paired	Firmicutes_I	18140	P	17	0	17	0.00000
SRR10728438_1_kneaddata_paired	Firmicutes_C	17613	P	13	0	13	0.00000
SRR10728438_1_kneaddata_paired	Thermotogota	33086	P	3	0	3	0.00000
SRR10728438_1_kneaddata_paired	Elusimicrobiota	11888	P	1	0	1	0.00000
SRR10728445_1_kneaddata_paired	Bacteroidota	4587	P	3285148	33277	3318425	0.75242
SRR10728445_1_kneaddata_paired	Firmicutes_A	14608	P	890019	3451	893470	0.20259
SRR10728445_1_kneaddata_paired	Verrucomicrobiota	33333	P	136962	4087	141049	0.03198
SRR10728445_1_kneaddata_paired	Proteobacteria	22518	P	26292	301	26593	0.00603
SRR10728445_1_kneaddata_paired	Actinobacteriota	615	P	18274	1	18275	0.00414
SRR10728445_1_kneaddata_paired	Firmicutes	12188	P	11826	140	11966	0.00271
SRR10728445_1_kneaddata_paired	Cyanobacteria	9876	P	271	7	278	0.00006
SRR10728445_1_kneaddata_paired	Firmicutes_B	17289	P	143	2	145	0.00003
SRR10728445_1_kneaddata_paired	Desulfobacterota_A	11509	P	56	2	58	0.00001
SRR10728445_1_kneaddata_paired	Firmicutes_I	18140	P	18	0	18	0.00000
SRR10728445_1_kneaddata_paired	Spirochaetota	32587	P	13	0	13	0.00000
SRR10728445_1_kneaddata_paired	Firmicutes_C	17613	P	10	0	10	0.00000
SRR10728445_1_kneaddata_paired	Campylobacterota	8700	P	9	0	9	0.00000
SRR10728445_1_kneaddata_paired	Deferribacterota	10822	P	3	0	3	0.00000
SRR10728445_1_kneaddata_paired	Elusimicrobiota	11888	P	2	0	2	0.00000
SRR10728467_1_kneaddata_paired	Bacteroidota	4587	P	2025318	20892	2046210	0.57058
SRR10728467_1_kneaddata_paired	Firmicutes_A	14608	P	1466556	4867	1471423	0.41030
SRR10728467_1_kneaddata_paired	Verrucomicrobiota	33333	P	23262	759	24021	0.00670
SRR10728467_1_kneaddata_paired	Firmicutes	12188	P	16084	136	16220	0.00452
SRR10728467_1_kneaddata_paired	Proteobacteria	22518	P	14220	179	14399	0.00402
SRR10728467_1_kneaddata_paired	Actinobacteriota	615	P	13345	1	13346	0.00372
SRR10728467_1_kneaddata_paired	Cyanobacteria	9876	P	226	5	231	0.00006
SRR10728467_1_kneaddata_paired	Firmicutes_B	17289	P	137	2	139	0.00004
SRR10728467_1_kneaddata_paired	Desulfobacterota_A	11509	P	133	8	141	0.00004
SRR10728467_1_kneaddata_paired	Firmicutes_I	18140	P	15	0	15	0.00000
SRR10728467_1_kneaddata_paired	Campylobacterota	8700	P	11	0	11	0.00000
SRR10728467_1_kneaddata_paired	Deferribacterota	10822	P	11	0	11	0.00000
SRR10728467_1_kneaddata_paired	Spirochaetota	32587	P	10	0	10	0.00000
SRR10728467_1_kneaddata_paired	Firmicutes_C	17613	P	7	0	7	0.00000
SRR10728467_1_kneaddata_paired	Elusimicrobiota	11888	P	2	0	2	0.00000
SRR10728499_1_kneaddata_paired	Bacteroidota	4587	P	1554661	10560	1565221	0.49979
SRR10728499_1_kneaddata_paired	Firmicutes_A	14608	P	1288074	6772	1294846	0.41345
SRR10728499_1_kneaddata_paired	Firmicutes	12188	P	264817	3489	268306	0.08567
SRR10728499_1_kneaddata_paired	Actinobacteriota	615	P	1547	2	1549	0.00049
SRR10728499_1_kneaddata_paired	Cyanobacteria	9876	P	662	19	681	0.00022
SRR10728499_1_kneaddata_paired	Firmicutes_B	17289	P	555	24	579	0.00018
SRR10728499_1_kneaddata_paired	Proteobacteria	22518	P	152	0	152	0.00005
SRR10728499_1_kneaddata_paired	Desulfobacterota_A	11509	P	120	14	134	0.00004
SRR10728499_1_kneaddata_paired	Spirochaetota	32587	P	85	0	85	0.00003
SRR10728499_1_kneaddata_paired	Deferribacterota	10822	P	83	0	83	0.00003
SRR10728499_1_kneaddata_paired	Campylobacterota	8700	P	71	0	71	0.00002
SRR10728499_1_kneaddata_paired	Verrucomicrobiota	33333	P	38	2	40	0.00001
SRR10728499_1_kneaddata_paired	Firmicutes_I	18140	P	23	0	23	0.00001
SRR10728499_1_kneaddata_paired	Firmicutes_C	17613	P	13	0	13	0.00000
SRR10728499_1_kneaddata_paired	Thermotogota	33086	P	2	0	2	0.00000
SRR10728499_1_kneaddata_paired	Elusimicrobiota	11888	P	1	0	1	0.00000
SRR10728510_1_kneaddata_paired	Firmicutes_A	14608	P	2944558	14213	2958771	0.76897
SRR10728510_1_kneaddata_paired	Bacteroidota	4587	P	705318	5896	711214	0.18484
SRR10728510_1_kneaddata_paired	Firmicutes	12188	P	170050	2889	172939	0.04495
SRR10728510_1_kneaddata_paired	Actinobacteriota	615	P	2426	2	2428	0.00063
SRR10728510_1_kneaddata_paired	Firmicutes_B	17289	P	1234	53	1287	0.00033
SRR10728510_1_kneaddata_paired	Cyanobacteria	9876	P	307	8	315	0.00008
SRR10728510_1_kneaddata_paired	Desulfobacterota_A	11509	P	302	39	341	0.00009
SRR10728510_1_kneaddata_paired	Proteobacteria	22518	P	184	1	185	0.00005
SRR10728510_1_kneaddata_paired	Verrucomicrobiota	33333	P	63	4	67	0.00002
SRR10728510_1_kneaddata_paired	Spirochaetota	32587	P	54	0	54	0.00001
SRR10728510_1_kneaddata_paired	Firmicutes_I	18140	P	38	0	38	0.00001
SRR10728510_1_kneaddata_paired	Campylobacterota	8700	P	25	0	25	0.00001
SRR10728510_1_kneaddata_paired	Thermotogota	33086	P	21	0	21	0.00001
SRR10728510_1_kneaddata_paired	Deferribacterota	10822	P	16	0	16	0.00000
SRR10728510_1_kneaddata_paired	Firmicutes_C	17613	P	16	0	16	0.00000
SRR10728512_1_kneaddata_paired	Bacteroidota	4587	P	1930503	13210	1943713	0.58564
SRR10728512_1_kneaddata_paired	Firmicutes_A	14608	P	1112140	6877	1119017	0.33716
SRR10728512_1_kneaddata_paired	Firmicutes	12188	P	246858	3082	249940	0.07531
SRR10728512_1_kneaddata_paired	Actinobacteriota	615	P	3014	2	3016	0.00091
SRR10728512_1_kneaddata_paired	Cyanobacteria	9876	P	1428	31	1459	0.00044
SRR10728512_1_kneaddata_paired	Firmicutes_B	17289	P	721	31	752	0.00023
SRR10728512_1_kneaddata_paired	Campylobacterota	8700	P	211	0	211	0.00006
SRR10728512_1_kneaddata_paired	Deferribacterota	10822	P	192	0	192	0.00006
SRR10728512_1_kneaddata_paired	Spirochaetota	32587	P	183	0	183	0.00006
SRR10728512_1_kneaddata_paired	Proteobacteria	22518	P	181	0	181	0.00005
SRR10728512_1_kneaddata_paired	Desulfobacterota_A	11509	P	119	16	135	0.00004
SRR10728512_1_kneaddata_paired	Verrucomicrobiota	33333	P	67	4	71	0.00002
SRR10728512_1_kneaddata_paired	Firmicutes_I	18140	P	60	0	60	0.00002
SRR10728512_1_kneaddata_paired	Thermotogota	33086	P	27	0	27	0.00001
SRR10728512_1_kneaddata_paired	Firmicutes_C	17613	P	11	0	11	0.00000
SRR10728513_1_kneaddata_paired	Firmicutes_A	14608	P	1477818	7290	1485108	0.51259
SRR10728513_1_kneaddata_paired	Bacteroidota	4587	P	1232526	11286	1243812	0.42931
SRR10728513_1_kneaddata_paired	Firmicutes	12188	P	162339	2075	164414	0.05675
SRR10728513_1_kneaddata_paired	Actinobacteriota	615	P	2282	1	2283	0.00079
SRR10728513_1_kneaddata_paired	Firmicutes_B	17289	P	719	26	745	0.00026
SRR10728513_1_kneaddata_paired	Cyanobacteria	9876	P	401	8	409	0.00014
SRR10728513_1_kneaddata_paired	Desulfobacterota_A	11509	P	141	13	154	0.00005
SRR10728513_1_kneaddata_paired	Proteobacteria	22518	P	100	0	100	0.00003
SRR10728513_1_kneaddata_paired	Spirochaetota	32587	P	50	0	50	0.00002
SRR10728513_1_kneaddata_paired	Verrucomicrobiota	33333	P	48	2	50	0.00002
SRR10728513_1_kneaddata_paired	Campylobacterota	8700	P	37	0	37	0.00001
SRR10728513_1_kneaddata_paired	Deferribacterota	10822	P	36	0	36	0.00001
SRR10728513_1_kneaddata_paired	Firmicutes_I	18140	P	16	0	16	0.00001
SRR10728513_1_kneaddata_paired	Firmicutes_C	17613	P	13	0	13	0.00000
SRR10728513_1_kneaddata_paired	Thermotogota	33086	P	12	0	12	0.00000
SRR10728514_1_kneaddata_paired	Bacteroidota	4587	P	1911439	20042	1931481	0.51694
SRR10728514_1_kneaddata_paired	Firmicutes_A	14608	P	1626176	11511	1637687	0.43831
SRR10728514_1_kneaddata_paired	Firmicutes	12188	P	157576	3336	160912	0.04307
SRR10728514_1_kneaddata_paired	Actinobacteriota	615	P	3836	2	3838	0.00103
SRR10728514_1_kneaddata_paired	Cyanobacteria	9876	P	807	33	840	0.00022
SRR10728514_1_kneaddata_paired	Firmicutes_B	17289	P	741	42	783	0.00021
SRR10728514_1_kneaddata_paired	Desulfobacterota_A	11509	P	213	31	244	0.00007
SRR10728514_1_kneaddata_paired	Proteobacteria	22518	P	159	1	160	0.00004
SRR10728514_1_kneaddata_paired	Deferribacterota	10822	P	102	0	102	0.00003
SRR10728514_1_kneaddata_paired	Spirochaetota	32587	P	90	0	90	0.00002
SRR10728514_1_kneaddata_paired	Campylobacterota	8700	P	71	0	71	0.00002
SRR10728514_1_kneaddata_paired	Verrucomicrobiota	33333	P	68	6	74	0.00002
SRR10728514_1_kneaddata_paired	Firmicutes_I	18140	P	34	0	34	0.00001
SRR10728514_1_kneaddata_paired	Firmicutes_C	17613	P	12	0	12	0.00000
SRR10728514_1_kneaddata_paired	Thermotogota	33086	P	4	0	4	0.00000
SRR10728514_1_kneaddata_paired	Elusimicrobiota	11888	P	3	0	3	0.00000
SRR10728522_1_kneaddata_paired	Firmicutes_A	14608	P	2094654	9009	2103663	0.63689
SRR10728522_1_kneaddata_paired	Bacteroidota	4587	P	1096264	9982	1106246	0.33492
SRR10728522_1_kneaddata_paired	Firmicutes	12188	P	65480	693	66173	0.02003
SRR10728522_1_kneaddata_paired	Proteobacteria	22518	P	11655	192	11847	0.00359
SRR10728522_1_kneaddata_paired	Actinobacteriota	615	P	7960	2	7962	0.00241
SRR10728522_1_kneaddata_paired	Verrucomicrobiota	33333	P	5938	245	6183	0.00187
SRR10728522_1_kneaddata_paired	Firmicutes_B	17289	P	251	6	257	0.00008
SRR10728522_1_kneaddata_paired	Desulfobacterota_A	11509	P	241	23	264	0.00008
SRR10728522_1_kneaddata_paired	Cyanobacteria	9876	P	239	5	244	0.00007
SRR10728522_1_kneaddata_paired	Spirochaetota	32587	P	55	0	55	0.00002
SRR10728522_1_kneaddata_paired	Firmicutes_I	18140	P	36	0	36	0.00001
SRR10728522_1_kneaddata_paired	Campylobacterota	8700	P	30	0	30	0.00001
SRR10728522_1_kneaddata_paired	Deferribacterota	10822	P	17	0	17	0.00001
SRR10728522_1_kneaddata_paired	Firmicutes_C	17613	P	16	0	16	0.00000
SRR10728522_1_kneaddata_paired	Thermotogota	33086	P	5	0	5	0.00000
SRR10728523_1_kneaddata_paired	Bacteroidota	4587	P	3362430	42575	3405005	0.72997
SRR10728523_1_kneaddata_paired	Firmicutes_A	14608	P	1140449	6436	1146885	0.24587
SRR10728523_1_kneaddata_paired	Firmicutes	12188	P	52759	633	53392	0.01145
SRR10728523_1_kneaddata_paired	Verrucomicrobiota	33333	P	25147	1037	26184	0.00561
SRR10728523_1_kneaddata_paired	Proteobacteria	22518	P	21109	343	21452	0.00460
SRR10728523_1_kneaddata_paired	Actinobacteriota	615	P	10321	1	10322	0.00221
SRR10728523_1_kneaddata_paired	Cyanobacteria	9876	P	677	22	699	0.00015
SRR10728523_1_kneaddata_paired	Firmicutes_B	17289	P	191	5	196	0.00004
SRR10728523_1_kneaddata_paired	Desulfobacterota_A	11509	P	160	13	173	0.00004
SRR10728523_1_kneaddata_paired	Spirochaetota	32587	P	86	0	86	0.00002
SRR10728523_1_kneaddata_paired	Campylobacterota	8700	P	76	0	76	0.00002
SRR10728523_1_kneaddata_paired	Deferribacterota	10822	P	47	0	47	0.00001
SRR10728523_1_kneaddata_paired	Firmicutes_I	18140	P	36	0	36	0.00001
SRR10728523_1_kneaddata_paired	Firmicutes_C	17613	P	6	0	6	0.00000
SRR10728523_1_kneaddata_paired	Elusimicrobiota	11888	P	1	0	1	0.00000
SRR10728523_1_kneaddata_paired	Thermotogota	33086	P	1	0	1	0.00000
SRR10728524_1_kneaddata_paired	Firmicutes_A	14608	P	1657625	6646	1664271	0.47431
SRR10728524_1_kneaddata_paired	Bacteroidota	4587	P	1645507	12852	1658359	0.47262
SRR10728524_1_kneaddata_paired	Firmicutes	12188	P	177783	1970	179753	0.05123
SRR10728524_1_kneaddata_paired	Actinobacteriota	615	P	4847	1	4848	0.00138
SRR10728524_1_kneaddata_paired	Cyanobacteria	9876	P	512	13	525	0.00015
SRR10728524_1_kneaddata_paired	Firmicutes_B	17289	P	427	14	441	0.00013
SRR10728524_1_kneaddata_paired	Desulfobacterota_A	11509	P	179	11	190	0.00005
SRR10728524_1_kneaddata_paired	Proteobacteria	22518	P	156	1	157	0.00004
SRR10728524_1_kneaddata_paired	Campylobacterota	8700	P	75	0	75	0.00002
SRR10728524_1_kneaddata_paired	Verrucomicrobiota	33333	P	67	3	70	0.00002
SRR10728524_1_kneaddata_paired	Deferribacterota	10822	P	56	0	56	0.00002
SRR10728524_1_kneaddata_paired	Spirochaetota	32587	P	50	0	50	0.00001
SRR10728524_1_kneaddata_paired	Firmicutes_I	18140	P	22	0	22	0.00001
SRR10728524_1_kneaddata_paired	Firmicutes_C	17613	P	8	0	8	0.00000
SRR10728524_1_kneaddata_paired	Thermotogota	33086	P	1	0	1	0.00000
SRR10728525_1_kneaddata_paired	Firmicutes_A	14608	P	1553611	3586	1557197	0.47251
SRR10728525_1_kneaddata_paired	Bacteroidota	4587	P	1427348	9311	1436659	0.43594
SRR10728525_1_kneaddata_paired	Verrucomicrobiota	33333	P	206049	4806	210855	0.06398
SRR10728525_1_kneaddata_paired	Actinobacteriota	615	P	46180	3	46183	0.01401
SRR10728525_1_kneaddata_paired	Firmicutes	12188	P	36440	219	36659	0.01112
SRR10728525_1_kneaddata_paired	Proteobacteria	22518	P	7602	65	7667	0.00233
SRR10728525_1_kneaddata_paired	Desulfobacterota_A	11509	P	116	4	120	0.00004
SRR10728525_1_kneaddata_paired	Cyanobacteria	9876	P	95	1	96	0.00003
SRR10728525_1_kneaddata_paired	Firmicutes_B	17289	P	81	1	82	0.00002
SRR10728525_1_kneaddata_paired	Firmicutes_C	17613	P	16	0	16	0.00000
SRR10728525_1_kneaddata_paired	Firmicutes_I	18140	P	16	0	16	0.00000
SRR10728525_1_kneaddata_paired	Campylobacterota	8700	P	8	0	8	0.00000
SRR10728525_1_kneaddata_paired	Spirochaetota	32587	P	7	0	7	0.00000
SRR10728525_1_kneaddata_paired	Deferribacterota	10822	P	2	0	2	0.00000
SRR10728525_1_kneaddata_paired	Thermotogota	33086	P	2	0	2	0.00000
SRR10728525_1_kneaddata_paired	Elusimicrobiota	11888	P	1	0	1	0.00000
SRR10728526_1_kneaddata_paired	Bacteroidota	4587	P	1275492	7382	1282874	0.67839
SRR10728526_1_kneaddata_paired	Firmicutes_A	14608	P	425957	1417	427374	0.22600
SRR10728526_1_kneaddata_paired	Verrucomicrobiota	33333	P	100603	2420	103023	0.05448
SRR10728526_1_kneaddata_paired	Firmicutes	12188	P	43258	257	43515	0.02301
SRR10728526_1_kneaddata_paired	Actinobacteriota	615	P	26237	1	26238	0.01388
SRR10728526_1_kneaddata_paired	Proteobacteria	22518	P	7772	70	7842	0.00415
SRR10728526_1_kneaddata_paired	Cyanobacteria	9876	P	64	1	65	0.00003
SRR10728526_1_kneaddata_paired	Desulfobacterota_A	11509	P	51	1	52	0.00003
SRR10728526_1_kneaddata_paired	Firmicutes_B	17289	P	38	0	38	0.00002
SRR10728526_1_kneaddata_paired	Firmicutes_I	18140	P	7	0	7	0.00000
SRR10728526_1_kneaddata_paired	Firmicutes_C	17613	P	6	0	6	0.00000
SRR10728526_1_kneaddata_paired	Spirochaetota	32587	P	5	0	5	0.00000
SRR10728526_1_kneaddata_paired	Campylobacterota	8700	P	2	0	2	0.00000
SRR10728527_1_kneaddata_paired	Bacteroidota	4587	P	1786639	8155	1794794	0.69760
SRR10728527_1_kneaddata_paired	Firmicutes_A	14608	P	635920	1706	637626	0.24783
SRR10728527_1_kneaddata_paired	Verrucomicrobiota	33333	P	89097	1621	90718	0.03526
SRR10728527_1_kneaddata_paired	Proteobacteria	22518	P	25563	178	25741	0.01001
SRR10728527_1_kneaddata_paired	Actinobacteriota	615	P	14688	0	14688	0.00571
SRR10728527_1_kneaddata_paired	Firmicutes	12188	P	8987	60	9047	0.00352
SRR10728527_1_kneaddata_paired	Cyanobacteria	9876	P	59	0	59	0.00002
SRR10728527_1_kneaddata_paired	Firmicutes_B	17289	P	47	0	47	0.00002
SRR10728527_1_kneaddata_paired	Desulfobacterota_A	11509	P	45	1	46	0.00002
SRR10728527_1_kneaddata_paired	Firmicutes_C	17613	P	16	0	16	0.00001
SRR10728527_1_kneaddata_paired	Spirochaetota	32587	P	13	0	13	0.00001
SRR10728527_1_kneaddata_paired	Campylobacterota	8700	P	5	0	5	0.00000
SRR10728527_1_kneaddata_paired	Firmicutes_I	18140	P	4	0	4	0.00000
SRR10728527_1_kneaddata_paired	Deferribacterota	10822	P	2	0	2	0.00000
SRR10728527_1_kneaddata_paired	Thermotogota	33086	P	1	0	1	0.00000
SRR10728528_1_kneaddata_paired	Firmicutes_A	14608	P	1058209	4053	1062262	0.57357
SRR10728528_1_kneaddata_paired	Bacteroidota	4587	P	671547	7138	678685	0.36646
SRR10728528_1_kneaddata_paired	Firmicutes	12188	P	52537	434	52971	0.02860
SRR10728528_1_kneaddata_paired	Actinobacteriota	615	P	46101	4	46105	0.02489
SRR10728528_1_kneaddata_paired	Verrucomicrobiota	33333	P	7578	272	7850	0.00424
SRR10728528_1_kneaddata_paired	Proteobacteria	22518	P	3794	49	3843	0.00208
SRR10728528_1_kneaddata_paired	Desulfobacterota_A	11509	P	120	8	128	0.00007
SRR10728528_1_kneaddata_paired	Cyanobacteria	9876	P	63	1	64	0.00003
SRR10728528_1_kneaddata_paired	Firmicutes_B	17289	P	56	1	57	0.00003
SRR10728528_1_kneaddata_paired	Firmicutes_I	18140	P	11	0	11	0.00001
SRR10728528_1_kneaddata_paired	Firmicutes_C	17613	P	10	0	10	0.00001
SRR10728528_1_kneaddata_paired	Spirochaetota	32587	P	7	0	7	0.00000
SRR10728528_1_kneaddata_paired	Campylobacterota	8700	P	5	0	5	0.00000
SRR10728528_1_kneaddata_paired	Deferribacterota	10822	P	5	0	5	0.00000
SRR10728528_1_kneaddata_paired	Thermotogota	33086	P	5	0	5	0.00000
SRR10728528_1_kneaddata_paired	Elusimicrobiota	11888	P	2	0	2	0.00000
SRR10728535_1_kneaddata_paired	Firmicutes_A	14608	P	1941544	8022	1949566	0.50579
SRR10728535_1_kneaddata_paired	Bacteroidota	4587	P	1597933	21220	1619153	0.42007
SRR10728535_1_kneaddata_paired	Firmicutes	12188	P	278935	2831	281766	0.07310
SRR10728535_1_kneaddata_paired	Actinobacteriota	615	P	2486	1	2487	0.00065
SRR10728535_1_kneaddata_paired	Firmicutes_B	17289	P	691	22	713	0.00019
SRR10728535_1_kneaddata_paired	Cyanobacteria	9876	P	308	12	320	0.00008
SRR10728535_1_kneaddata_paired	Desulfobacterota_A	11509	P	151	15	166	0.00004
SRR10728535_1_kneaddata_paired	Proteobacteria	22518	P	94	0	94	0.00002
SRR10728535_1_kneaddata_paired	Verrucomicrobiota	33333	P	84	3	87	0.00002
SRR10728535_1_kneaddata_paired	Spirochaetota	32587	P	43	0	43	0.00001
SRR10728535_1_kneaddata_paired	Campylobacterota	8700	P	27	0	27	0.00001
SRR10728535_1_kneaddata_paired	Firmicutes_I	18140	P	14	0	14	0.00000
SRR10728535_1_kneaddata_paired	Firmicutes_C	17613	P	12	0	12	0.00000
SRR10728535_1_kneaddata_paired	Deferribacterota	10822	P	6	0	6	0.00000
SRR10728535_1_kneaddata_paired	Elusimicrobiota	11888	P	3	0	3	0.00000
SRR10728535_1_kneaddata_paired	Thermotogota	33086	P	1	0	1	0.00000
SRR10728536_1_kneaddata_paired	Firmicutes_A	14608	P	2267690	11128	2278818	0.51433
SRR10728536_1_kneaddata_paired	Bacteroidota	4587	P	1805060	14076	1819136	0.41058
SRR10728536_1_kneaddata_paired	Firmicutes	12188	P	322666	3389	326055	0.07359
SRR10728536_1_kneaddata_paired	Actinobacteriota	615	P	2877	2	2879	0.00065
SRR10728536_1_kneaddata_paired	Cyanobacteria	9876	P	1625	28	1653	0.00037
SRR10728536_1_kneaddata_paired	Firmicutes_B	17289	P	831	28	859	0.00019
SRR10728536_1_kneaddata_paired	Deferribacterota	10822	P	281	0	281	0.00006
SRR10728536_1_kneaddata_paired	Campylobacterota	8700	P	249	0	249	0.00006
SRR10728536_1_kneaddata_paired	Proteobacteria	22518	P	221	1	222	0.00005
SRR10728536_1_kneaddata_paired	Desulfobacterota_A	11509	P	168	16	184	0.00004
SRR10728536_1_kneaddata_paired	Spirochaetota	32587	P	144	0	144	0.00003
SRR10728536_1_kneaddata_paired	Firmicutes_I	18140	P	87	0	87	0.00002
SRR10728536_1_kneaddata_paired	Verrucomicrobiota	33333	P	54	2	56	0.00001
SRR10728536_1_kneaddata_paired	Thermotogota	33086	P	18	0	18	0.00000
SRR10728536_1_kneaddata_paired	Firmicutes_C	17613	P	11	0	11	0.00000
SRR10728536_1_kneaddata_paired	Elusimicrobiota	11888	P	1	0	1	0.00000
SRR10728537_1_kneaddata_paired	Firmicutes_A	14608	P	939054	4038	943092	0.62552
SRR10728537_1_kneaddata_paired	Bacteroidota	4587	P	513483	2986	516469	0.34256
SRR10728537_1_kneaddata_paired	Firmicutes	12188	P	45705	442	46147	0.03061
SRR10728537_1_kneaddata_paired	Actinobacteriota	615	P	1245	0	1245	0.00083
SRR10728537_1_kneaddata_paired	Firmicutes_B	17289	P	301	8	309	0.00021
SRR10728537_1_kneaddata_paired	Cyanobacteria	9876	P	207	3	210	0.00014
SRR10728537_1_kneaddata_paired	Desulfobacterota_A	11509	P	82	5	87	0.00006
SRR10728537_1_kneaddata_paired	Proteobacteria	22518	P	48	0	48	0.00003
SRR10728537_1_kneaddata_paired	Verrucomicrobiota	33333	P	29	0	29	0.00002
SRR10728537_1_kneaddata_paired	Deferribacterota	10822	P	14	0	14	0.00001
SRR10728537_1_kneaddata_paired	Campylobacterota	8700	P	13	0	13	0.00001
SRR10728537_1_kneaddata_paired	Spirochaetota	32587	P	10	0	10	0.00001
SRR10728537_1_kneaddata_paired	Firmicutes_I	18140	P	6	0	6	0.00000
SRR10728537_1_kneaddata_paired	Thermotogota	33086	P	3	0	3	0.00000
SRR10728537_1_kneaddata_paired	Firmicutes_C	17613	P	2	0	2	0.00000
SRR10728537_1_kneaddata_paired	Elusimicrobiota	11888	P	1	0	1	0.00000
SRR10728538_1_kneaddata_paired	Bacteroidota	4587	P	973038	6804	979842	0.47381
SRR10728538_1_kneaddata_paired	Firmicutes_A	14608	P	954785	4662	959447	0.46394
SRR10728538_1_kneaddata_paired	Firmicutes	12188	P	123578	1494	125072	0.06048
SRR10728538_1_kneaddata_paired	Actinobacteriota	615	P	1601	1	1602	0.00077
SRR10728538_1_kneaddata_paired	Firmicutes_B	17289	P	741	26	767	0.00037
SRR10728538_1_kneaddata_paired	Cyanobacteria	9876	P	671	9	680	0.00033
SRR10728538_1_kneaddata_paired	Desulfobacterota_A	11509	P	122	16	138	0.00007
SRR10728538_1_kneaddata_paired	Proteobacteria	22518	P	119	0	119	0.00006
SRR10728538_1_kneaddata_paired	Campylobacterota	8700	P	103	0	103	0.00005
SRR10728538_1_kneaddata_paired	Spirochaetota	32587	P	90	0	90	0.00004
SRR10728538_1_kneaddata_paired	Deferribacterota	10822	P	81	0	81	0.00004
SRR10728538_1_kneaddata_paired	Verrucomicrobiota	33333	P	39	1	40	0.00002
SRR10728538_1_kneaddata_paired	Firmicutes_I	18140	P	23	0	23	0.00001
SRR10728538_1_kneaddata_paired	Firmicutes_C	17613	P	10	0	10	0.00000
SRR10728538_1_kneaddata_paired	Thermotogota	33086	P	3	0	3	0.00000
SRR10728538_1_kneaddata_paired	Elusimicrobiota	11888	P	1	0	1	0.00000
SRR11229733_1_kneaddata_paired	Firmicutes_A	14608	P	30003175	177472	30180647	0.79427
SRR11229733_1_kneaddata_paired	Firmicutes	12188	P	6658031	89849	6747880	0.17759
SRR11229733_1_kneaddata_paired	Proteobacteria	22518	P	935262	2599	937861	0.02468
SRR11229733_1_kneaddata_paired	Bacteroidota	4587	P	103650	2295	105945	0.00279
SRR11229733_1_kneaddata_paired	Cyanobacteria	9876	P	11864	133	11997	0.00032
SRR11229733_1_kneaddata_paired	Campylobacterota	8700	P	5035	6	5041	0.00013
SRR11229733_1_kneaddata_paired	Desulfobacterota_A	11509	P	3021	302	3323	0.00009
SRR11229733_1_kneaddata_paired	Actinobacteriota	615	P	1899	1	1900	0.00005
SRR11229733_1_kneaddata_paired	Verrucomicrobiota	33333	P	1815	128	1943	0.00005
SRR11229733_1_kneaddata_paired	Spirochaetota	32587	P	748	0	748	0.00002
SRR11229733_1_kneaddata_paired	Firmicutes_I	18140	P	499	0	499	0.00001
SRR11229733_1_kneaddata_paired	Firmicutes_B	17289	P	176	7	183	0.00000
SRR11229733_1_kneaddata_paired	Deferribacterota	10822	P	15	0	15	0.00000
SRR11229733_1_kneaddata_paired	Elusimicrobiota	11888	P	2	0	2	0.00000
SRR11229733_1_kneaddata_paired	Firmicutes_C	17613	P	2	0	2	0.00000
SRR11229733_1_kneaddata_paired	Thermotogota	33086	P	2	0	2	0.00000
SRR11229734_1_kneaddata_paired	Firmicutes_A	14608	P	37322630	246859	37569489	0.86073
SRR11229734_1_kneaddata_paired	Firmicutes	12188	P	5344715	68542	5413257	0.12402
SRR11229734_1_kneaddata_paired	Proteobacteria	22518	P	498225	2206	500431	0.01147
SRR11229734_1_kneaddata_paired	Bacteroidota	4587	P	135386	2476	137862	0.00316
SRR11229734_1_kneaddata_paired	Cyanobacteria	9876	P	13990	256	14246	0.00033
SRR11229734_1_kneaddata_paired	Desulfobacterota_A	11509	P	5857	455	6312	0.00014
SRR11229734_1_kneaddata_paired	Campylobacterota	8700	P	2396	3	2399	0.00005
SRR11229734_1_kneaddata_paired	Actinobacteriota	615	P	2090	1	2091	0.00005
SRR11229734_1_kneaddata_paired	Spirochaetota	32587	P	827	0	827	0.00002
SRR11229734_1_kneaddata_paired	Verrucomicrobiota	33333	P	786	46	832	0.00002
SRR11229734_1_kneaddata_paired	Firmicutes_B	17289	P	350	12	362	0.00001
SRR11229734_1_kneaddata_paired	Firmicutes_I	18140	P	57	0	57	0.00000
SRR11229734_1_kneaddata_paired	Deferribacterota	10822	P	24	0	24	0.00000
SRR11229734_1_kneaddata_paired	Thermotogota	33086	P	23	0	23	0.00000
SRR11229734_1_kneaddata_paired	Firmicutes_C	17613	P	21	0	21	0.00000
SRR11229735_1_kneaddata_paired	Firmicutes_A	14608	P	30833327	182433	31015760	0.78220
SRR11229735_1_kneaddata_paired	Firmicutes	12188	P	7570228	76208	7646436	0.19284
SRR11229735_1_kneaddata_paired	Proteobacteria	22518	P	860163	1896	862059	0.02174
SRR11229735_1_kneaddata_paired	Bacteroidota	4587	P	94658	1439	96097	0.00242
SRR11229735_1_kneaddata_paired	Cyanobacteria	9876	P	16838	126	16964	0.00043
SRR11229735_1_kneaddata_paired	Campylobacterota	8700	P	5454	5	5459	0.00014
SRR11229735_1_kneaddata_paired	Desulfobacterota_A	11509	P	4548	258	4806	0.00012
SRR11229735_1_kneaddata_paired	Actinobacteriota	615	P	2479	0	2479	0.00006
SRR11229735_1_kneaddata_paired	Spirochaetota	32587	P	782	0	782	0.00002
SRR11229735_1_kneaddata_paired	Firmicutes_I	18140	P	553	0	553	0.00001
SRR11229735_1_kneaddata_paired	Verrucomicrobiota	33333	P	393	20	413	0.00001
SRR11229735_1_kneaddata_paired	Firmicutes_B	17289	P	323	10	333	0.00001
SRR11229735_1_kneaddata_paired	Firmicutes_C	17613	P	19	0	19	0.00000
SRR11229735_1_kneaddata_paired	Deferribacterota	10822	P	11	0	11	0.00000
SRR11229736_1_kneaddata_paired	Firmicutes_A	14608	P	30898456	144357	31042813	0.91387
SRR11229736_1_kneaddata_paired	Firmicutes	12188	P	2193997	16236	2210233	0.06507
SRR11229736_1_kneaddata_paired	Proteobacteria	22518	P	615396	2487	617883	0.01819
SRR11229736_1_kneaddata_paired	Bacteroidota	4587	P	53403	604	54007	0.00159
SRR11229736_1_kneaddata_paired	Cyanobacteria	9876	P	19321	272	19593	0.00058
SRR11229736_1_kneaddata_paired	Actinobacteriota	615	P	11928	3	11931	0.00035
SRR11229736_1_kneaddata_paired	Desulfobacterota_A	11509	P	4731	316	5047	0.00015
SRR11229736_1_kneaddata_paired	Campylobacterota	8700	P	2933	2	2935	0.00009
SRR11229736_1_kneaddata_paired	Verrucomicrobiota	33333	P	1216	60	1276	0.00004
SRR11229736_1_kneaddata_paired	Spirochaetota	32587	P	1178	1	1179	0.00003
SRR11229736_1_kneaddata_paired	Firmicutes_B	17289	P	640	20	660	0.00002
SRR11229736_1_kneaddata_paired	Firmicutes_I	18140	P	639	0	639	0.00002
SRR11229736_1_kneaddata_paired	Firmicutes_C	17613	P	301	0	301	0.00001
SRR11229736_1_kneaddata_paired	Elusimicrobiota	11888	P	50	0	50	0.00000
SRR11229736_1_kneaddata_paired	Deferribacterota	10822	P	34	0	34	0.00000
SRR11229736_1_kneaddata_paired	Thermotogota	33086	P	24	0	24	0.00000
SRR11229737_1_kneaddata_paired	Firmicutes_A	14608	P	56453954	277552	56731506	0.97345
SRR11229737_1_kneaddata_paired	Proteobacteria	22518	P	713287	1938	715225	0.01227
SRR11229737_1_kneaddata_paired	Firmicutes	12188	P	678984	9607	688591	0.01182
SRR11229737_1_kneaddata_paired	Bacteroidota	4587	P	106256	1450	107706	0.00185
SRR11229737_1_kneaddata_paired	Desulfobacterota_A	11509	P	12482	563	13045	0.00022
SRR11229737_1_kneaddata_paired	Cyanobacteria	9876	P	9037	69	9106	0.00016
SRR11229737_1_kneaddata_paired	Actinobacteriota	615	P	7762	2	7764	0.00013
SRR11229737_1_kneaddata_paired	Verrucomicrobiota	33333	P	1566	65	1631	0.00003
SRR11229737_1_kneaddata_paired	Firmicutes_B	17289	P	1344	34	1378	0.00002
SRR11229737_1_kneaddata_paired	Spirochaetota	32587	P	1051	0	1051	0.00002
SRR11229737_1_kneaddata_paired	Campylobacterota	8700	P	652	0	652	0.00001
SRR11229737_1_kneaddata_paired	Firmicutes_C	17613	P	550	0	550	0.00001
SRR11229737_1_kneaddata_paired	Firmicutes_I	18140	P	361	0	361	0.00001
SRR11229737_1_kneaddata_paired	Thermotogota	33086	P	90	0	90	0.00000
SRR11229737_1_kneaddata_paired	Elusimicrobiota	11888	P	37	0	37	0.00000
SRR11229737_1_kneaddata_paired	Deferribacterota	10822	P	30	0	30	0.00000
SRR11229738_1_kneaddata_paired	Firmicutes_A	14608	P	51907466	228482	52135948	0.92361
SRR11229738_1_kneaddata_paired	Firmicutes	12188	P	4107456	28767	4136223	0.07327
SRR11229738_1_kneaddata_paired	Bacteroidota	4587	P	87618	940	88558	0.00157
SRR11229738_1_kneaddata_paired	Proteobacteria	22518	P	48288	214	48502	0.00086
SRR11229738_1_kneaddata_paired	Cyanobacteria	9876	P	20046	478	20524	0.00036
SRR11229738_1_kneaddata_paired	Desulfobacterota_A	11509	P	6596	492	7088	0.00013
SRR11229738_1_kneaddata_paired	Campylobacterota	8700	P	3759	2	3761	0.00007
SRR11229738_1_kneaddata_paired	Actinobacteriota	615	P	2615	3	2618	0.00005
SRR11229738_1_kneaddata_paired	Firmicutes_B	17289	P	1022	31	1053	0.00002
SRR11229738_1_kneaddata_paired	Firmicutes_I	18140	P	980	0	980	0.00002
SRR11229738_1_kneaddata_paired	Verrucomicrobiota	33333	P	965	46	1011	0.00002
SRR11229738_1_kneaddata_paired	Spirochaetota	32587	P	909	1	910	0.00002
SRR11229738_1_kneaddata_paired	Firmicutes_C	17613	P	555	1	556	0.00001
SRR11229738_1_kneaddata_paired	Deferribacterota	10822	P	119	0	119	0.00000
SRR11229738_1_kneaddata_paired	Elusimicrobiota	11888	P	73	0	73	0.00000
SRR11229738_1_kneaddata_paired	Thermotogota	33086	P	51	0	51	0.00000
SRR11229739_1_kneaddata_paired	Firmicutes_A	14608	P	43258920	279598	43538518	0.96945
SRR11229739_1_kneaddata_paired	Firmicutes	12188	P	1212759	14703	1227462	0.02733
SRR11229739_1_kneaddata_paired	Bacteroidota	4587	P	106079	2026	108105	0.00241
SRR11229739_1_kneaddata_paired	Proteobacteria	22518	P	11824	120	11944	0.00027
SRR11229739_1_kneaddata_paired	Desulfobacterota_A	11509	P	8183	517	8700	0.00019
SRR11229739_1_kneaddata_paired	Cyanobacteria	9876	P	6604	86	6690	0.00015
SRR11229739_1_kneaddata_paired	Actinobacteriota	615	P	4573	4	4577	0.00010
SRR11229739_1_kneaddata_paired	Spirochaetota	32587	P	1365	1	1366	0.00003
SRR11229739_1_kneaddata_paired	Campylobacterota	8700	P	934	0	934	0.00002
SRR11229739_1_kneaddata_paired	Firmicutes_B	17289	P	930	33	963	0.00002
SRR11229739_1_kneaddata_paired	Verrucomicrobiota	33333	P	674	37	711	0.00002
SRR11229739_1_kneaddata_paired	Firmicutes_C	17613	P	261	0	261	0.00001
SRR11229739_1_kneaddata_paired	Firmicutes_I	18140	P	100	0	100	0.00000
SRR11229739_1_kneaddata_paired	Thermotogota	33086	P	62	0	62	0.00000
SRR11229739_1_kneaddata_paired	Elusimicrobiota	11888	P	31	0	31	0.00000
SRR11229739_1_kneaddata_paired	Deferribacterota	10822	P	20	0	20	0.00000
SRR11229740_1_kneaddata_paired	Firmicutes_A	14608	P	48996133	236173	49232306	0.85210
SRR11229740_1_kneaddata_paired	Firmicutes	12188	P	7881720	48787	7930507	0.13726
SRR11229740_1_kneaddata_paired	Proteobacteria	22518	P	498506	1430	499936	0.00865
SRR11229740_1_kneaddata_paired	Bacteroidota	4587	P	84687	906	85593	0.00148
SRR11229740_1_kneaddata_paired	Cyanobacteria	9876	P	11368	64	11432	0.00020
SRR11229740_1_kneaddata_paired	Desulfobacterota_A	11509	P	9324	231	9555	0.00017
SRR11229740_1_kneaddata_paired	Campylobacterota	8700	P	5012	3	5015	0.00009
SRR11229740_1_kneaddata_paired	Actinobacteriota	615	P	1381	0	1381	0.00002
SRR11229740_1_kneaddata_paired	Spirochaetota	32587	P	650	0	650	0.00001
SRR11229740_1_kneaddata_paired	Verrucomicrobiota	33333	P	496	16	512	0.00001
SRR11229740_1_kneaddata_paired	Firmicutes_B	17289	P	413	8	421	0.00001
SRR11229740_1_kneaddata_paired	Firmicutes_I	18140	P	323	0	323	0.00001
SRR11229740_1_kneaddata_paired	Firmicutes_C	17613	P	173	0	173	0.00000
SRR11229740_1_kneaddata_paired	Elusimicrobiota	11888	P	67	0	67	0.00000
SRR11229740_1_kneaddata_paired	Deferribacterota	10822	P	31	0	31	0.00000
SRR11229741_1_kneaddata_paired	Firmicutes_A	14608	P	46299493	195100	46494593	0.89941
SRR11229741_1_kneaddata_paired	Firmicutes	12188	P	4854039	43801	4897840	0.09475
SRR11229741_1_kneaddata_paired	Proteobacteria	22518	P	202366	1182	203548	0.00394
SRR11229741_1_kneaddata_paired	Bacteroidota	4587	P	73070	1898	74968	0.00145
SRR11229741_1_kneaddata_paired	Cyanobacteria	9876	P	12193	197	12390	0.00024
SRR11229741_1_kneaddata_paired	Desulfobacterota_A	11509	P	3661	520	4181	0.00008
SRR11229741_1_kneaddata_paired	Campylobacterota	8700	P	2392	4	2396	0.00005
SRR11229741_1_kneaddata_paired	Actinobacteriota	615	P	1986	1	1987	0.00004
SRR11229741_1_kneaddata_paired	Verrucomicrobiota	33333	P	611	39	650	0.00001
SRR11229741_1_kneaddata_paired	Firmicutes_C	17613	P	588	1	589	0.00001
SRR11229741_1_kneaddata_paired	Firmicutes_B	17289	P	478	19	497	0.00001
SRR11229741_1_kneaddata_paired	Spirochaetota	32587	P	348	0	348	0.00001
SRR11229741_1_kneaddata_paired	Firmicutes_I	18140	P	264	0	264	0.00001
SRR11229741_1_kneaddata_paired	Elusimicrobiota	11888	P	93	0	93	0.00000
SRR11229741_1_kneaddata_paired	Deferribacterota	10822	P	68	0	68	0.00000
SRR11229741_1_kneaddata_paired	Thermotogota	33086	P	5	0	5	0.00000
SRR11229742_1_kneaddata_paired	Firmicutes_A	14608	P	23441314	219362	23660676	0.71811
SRR11229742_1_kneaddata_paired	Firmicutes	12188	P	8283713	86274	8369987	0.25403
SRR11229742_1_kneaddata_paired	Proteobacteria	22518	P	776815	4177	780992	0.02370
SRR11229742_1_kneaddata_paired	Bacteroidota	4587	P	98285	2325	100610	0.00305
SRR11229742_1_kneaddata_paired	Cyanobacteria	9876	P	20372	454	20826	0.00063
SRR11229742_1_kneaddata_paired	Actinobacteriota	615	P	5468	3	5471	0.00017
SRR11229742_1_kneaddata_paired	Campylobacterota	8700	P	3892	8	3900	0.00012
SRR11229742_1_kneaddata_paired	Desulfobacterota_A	11509	P	3255	399	3654	0.00011
SRR11229742_1_kneaddata_paired	Spirochaetota	32587	P	1291	1	1292	0.00004
SRR11229742_1_kneaddata_paired	Verrucomicrobiota	33333	P	556	44	600	0.00002
SRR11229742_1_kneaddata_paired	Firmicutes_B	17289	P	274	13	287	0.00001
SRR11229742_1_kneaddata_paired	Firmicutes_I	18140	P	86	0	86	0.00000
SRR11229742_1_kneaddata_paired	Firmicutes_C	17613	P	69	0	69	0.00000
SRR11229742_1_kneaddata_paired	Thermotogota	33086	P	52	0	52	0.00000
SRR11229742_1_kneaddata_paired	Deferribacterota	10822	P	47	0	47	0.00000
SRR11229742_1_kneaddata_paired	Elusimicrobiota	11888	P	18	0	18	0.00000
SRR11229743_1_kneaddata_paired	Firmicutes_A	14608	P	33928998	224418	34153416	0.78354
SRR11229743_1_kneaddata_paired	Firmicutes	12188	P	8513261	62921	8576182	0.19675
SRR11229743_1_kneaddata_paired	Proteobacteria	22518	P	735877	1865	737742	0.01693
SRR11229743_1_kneaddata_paired	Bacteroidota	4587	P	84536	1473	86009	0.00197
SRR11229743_1_kneaddata_paired	Cyanobacteria	9876	P	18638	406	19044	0.00044
SRR11229743_1_kneaddata_paired	Desulfobacterota_A	11509	P	5254	250	5504	0.00013
SRR11229743_1_kneaddata_paired	Campylobacterota	8700	P	4417	6	4423	0.00010
SRR11229743_1_kneaddata_paired	Actinobacteriota	615	P	4058	2	4060	0.00009
SRR11229743_1_kneaddata_paired	Spirochaetota	32587	P	950	0	950	0.00002
SRR11229743_1_kneaddata_paired	Verrucomicrobiota	33333	P	698	36	734	0.00002
SRR11229743_1_kneaddata_paired	Firmicutes_B	17289	P	303	10	313	0.00001
SRR11229743_1_kneaddata_paired	Firmicutes_I	18140	P	156	0	156	0.00000
SRR11229743_1_kneaddata_paired	Firmicutes_C	17613	P	97	0	97	0.00000
SRR11229743_1_kneaddata_paired	Elusimicrobiota	11888	P	80	0	80	0.00000
SRR11229743_1_kneaddata_paired	Deferribacterota	10822	P	39	0	39	0.00000
SRR11229743_1_kneaddata_paired	Thermotogota	33086	P	9	0	9	0.00000
SRR11229744_1_kneaddata_paired	Firmicutes_A	14608	P	25317278	143178	25460456	0.84090
SRR11229744_1_kneaddata_paired	Proteobacteria	22518	P	2626669	7337	2634006	0.08700
SRR11229744_1_kneaddata_paired	Firmicutes	12188	P	2042549	8878	2051427	0.06775
SRR11229744_1_kneaddata_paired	Bacteroidota	4587	P	86646	661	87307	0.00288
SRR11229744_1_kneaddata_paired	Cyanobacteria	9876	P	29638	277	29915	0.00099
SRR11229744_1_kneaddata_paired	Desulfobacterota_A	11509	P	7127	228	7355	0.00024
SRR11229744_1_kneaddata_paired	Actinobacteriota	615	P	3388	0	3388	0.00011
SRR11229744_1_kneaddata_paired	Verrucomicrobiota	33333	P	1593	58	1651	0.00005
SRR11229744_1_kneaddata_paired	Campylobacterota	8700	P	944	0	944	0.00003
SRR11229744_1_kneaddata_paired	Spirochaetota	32587	P	715	0	715	0.00002
SRR11229744_1_kneaddata_paired	Firmicutes_B	17289	P	220	4	224	0.00001
SRR11229744_1_kneaddata_paired	Firmicutes_C	17613	P	88	0	88	0.00000
SRR11229744_1_kneaddata_paired	Firmicutes_I	18140	P	59	0	59	0.00000
SRR11229744_1_kneaddata_paired	Elusimicrobiota	11888	P	34	0	34	0.00000
SRR11229744_1_kneaddata_paired	Thermotogota	33086	P	29	0	29	0.00000
SRR11229744_1_kneaddata_paired	Deferribacterota	10822	P	26	0	26	0.00000
SRR11229745_1_kneaddata_paired	Firmicutes_A	14608	P	17580705	140865	17721570	0.57440
SRR11229745_1_kneaddata_paired	Firmicutes	12188	P	6496638	58562	6555200	0.21247
SRR11229745_1_kneaddata_paired	Proteobacteria	22518	P	6392429	38847	6431276	0.20845
SRR11229745_1_kneaddata_paired	Bacteroidota	4587	P	100342	1975	102317	0.00332
SRR11229745_1_kneaddata_paired	Cyanobacteria	9876	P	27602	368	27970	0.00091
SRR11229745_1_kneaddata_paired	Actinobacteriota	615	P	5383	2	5385	0.00017
SRR11229745_1_kneaddata_paired	Campylobacterota	8700	P	3755	6	3761	0.00012
SRR11229745_1_kneaddata_paired	Desulfobacterota_A	11509	P	2279	220	2499	0.00008
SRR11229745_1_kneaddata_paired	Spirochaetota	32587	P	1145	1	1146	0.00004
SRR11229745_1_kneaddata_paired	Verrucomicrobiota	33333	P	593	46	639	0.00002
SRR11229745_1_kneaddata_paired	Firmicutes_I	18140	P	215	0	215	0.00001
SRR11229745_1_kneaddata_paired	Firmicutes_B	17289	P	214	10	224	0.00001
SRR11229745_1_kneaddata_paired	Firmicutes_C	17613	P	79	0	79	0.00000
SRR11229745_1_kneaddata_paired	Elusimicrobiota	11888	P	25	0	25	0.00000
SRR11229745_1_kneaddata_paired	Deferribacterota	10822	P	19	0	19	0.00000
SRR11229745_1_kneaddata_paired	Thermotogota	33086	P	2	0	2	0.00000
SRR11229746_1_kneaddata_paired	Firmicutes_A	14608	P	56062565	336667	56399232	0.94390
SRR11229746_1_kneaddata_paired	Firmicutes	12188	P	2655417	47496	2702913	0.04524
SRR11229746_1_kneaddata_paired	Proteobacteria	22518	P	444000	1913	445913	0.00746
SRR11229746_1_kneaddata_paired	Bacteroidota	4587	P	161375	2394	163769	0.00274
SRR11229746_1_kneaddata_paired	Cyanobacteria	9876	P	16879	154	17033	0.00029
SRR11229746_1_kneaddata_paired	Desulfobacterota_A	11509	P	9805	542	10347	0.00017
SRR11229746_1_kneaddata_paired	Actinobacteriota	615	P	7050	2	7052	0.00012
SRR11229746_1_kneaddata_paired	Spirochaetota	32587	P	1666	1	1667	0.00003
SRR11229746_1_kneaddata_paired	Verrucomicrobiota	33333	P	1142	58	1200	0.00002
SRR11229746_1_kneaddata_paired	Campylobacterota	8700	P	1106	0	1106	0.00002
SRR11229746_1_kneaddata_paired	Firmicutes_B	17289	P	995	31	1026	0.00002
SRR11229746_1_kneaddata_paired	Firmicutes_I	18140	P	52	0	52	0.00000
SRR11229746_1_kneaddata_paired	Firmicutes_C	17613	P	28	0	28	0.00000
SRR11229746_1_kneaddata_paired	Deferribacterota	10822	P	22	0	22	0.00000
SRR11229746_1_kneaddata_paired	Thermotogota	33086	P	4	0	4	0.00000
SRR11229747_1_kneaddata_paired	Firmicutes_A	14608	P	25834918	207877	26042795	0.55197
SRR11229747_1_kneaddata_paired	Firmicutes	12188	P	18975312	225362	19200674	0.40696
SRR11229747_1_kneaddata_paired	Proteobacteria	22518	P	1656735	9290	1666025	0.03531
SRR11229747_1_kneaddata_paired	Bacteroidota	4587	P	223783	2488	226271	0.00480
SRR11229747_1_kneaddata_paired	Cyanobacteria	9876	P	24512	128	24640	0.00052
SRR11229747_1_kneaddata_paired	Campylobacterota	8700	P	10430	18	10448	0.00022
SRR11229747_1_kneaddata_paired	Desulfobacterota_A	11509	P	4232	306	4538	0.00010
SRR11229747_1_kneaddata_paired	Actinobacteriota	615	P	3641	2	3643	0.00008
SRR11229747_1_kneaddata_paired	Spirochaetota	32587	P	1118	1	1119	0.00002
SRR11229747_1_kneaddata_paired	Firmicutes_I	18140	P	412	0	412	0.00001
SRR11229747_1_kneaddata_paired	Firmicutes_B	17289	P	258	11	269	0.00001
SRR11229747_1_kneaddata_paired	Verrucomicrobiota	33333	P	235	15	250	0.00001
SRR11229747_1_kneaddata_paired	Firmicutes_C	17613	P	109	0	109	0.00000
SRR11229747_1_kneaddata_paired	Elusimicrobiota	11888	P	68	0	68	0.00000
SRR11229747_1_kneaddata_paired	Deferribacterota	10822	P	7	0	7	0.00000
SRR11229748_1_kneaddata_paired	Firmicutes_A	14608	P	54681624	215142	54896766	0.92117
SRR11229748_1_kneaddata_paired	Firmicutes	12188	P	4545622	32184	4577806	0.07682
SRR11229748_1_kneaddata_paired	Bacteroidota	4587	P	68771	1195	69966	0.00117
SRR11229748_1_kneaddata_paired	Proteobacteria	22518	P	19619	236	19855	0.00033
SRR11229748_1_kneaddata_paired	Cyanobacteria	9876	P	16472	338	16810	0.00028
SRR11229748_1_kneaddata_paired	Desulfobacterota_A	11509	P	4269	472	4741	0.00008
SRR11229748_1_kneaddata_paired	Actinobacteriota	615	P	3192	2	3194	0.00005
SRR11229748_1_kneaddata_paired	Campylobacterota	8700	P	2222	2	2224	0.00004
SRR11229748_1_kneaddata_paired	Firmicutes_B	17289	P	1136	37	1173	0.00002
SRR11229748_1_kneaddata_paired	Verrucomicrobiota	33333	P	830	41	871	0.00001
SRR11229748_1_kneaddata_paired	Spirochaetota	32587	P	591	1	592	0.00001
SRR11229748_1_kneaddata_paired	Firmicutes_C	17613	P	548	1	549	0.00001
SRR11229748_1_kneaddata_paired	Firmicutes_I	18140	P	139	0	139	0.00000
SRR11229748_1_kneaddata_paired	Elusimicrobiota	11888	P	96	0	96	0.00000
SRR11229748_1_kneaddata_paired	Deferribacterota	10822	P	80	0	80	0.00000
SRR11229748_1_kneaddata_paired	Thermotogota	33086	P	28	0	28	0.00000
SRR11284171_1_kneaddata_paired	Bacteroidota	4587	P	13774771	26855	13801626	0.60064
SRR11284171_1_kneaddata_paired	Firmicutes_A	14608	P	5114130	19155	5133285	0.22340
SRR11284171_1_kneaddata_paired	Verrucomicrobiota	33333	P	2838560	66052	2904612	0.12641
SRR11284171_1_kneaddata_paired	Firmicutes	12188	P	643261	3100	646361	0.02813
SRR11284171_1_kneaddata_paired	Actinobacteriota	615	P	174230	323	174553	0.00760
SRR11284171_1_kneaddata_paired	Desulfobacterota_A	11509	P	109770	75	109845	0.00478
SRR11284171_1_kneaddata_paired	Firmicutes_B	17289	P	109043	1597	110640	0.00481
SRR11284171_1_kneaddata_paired	Proteobacteria	22518	P	63563	337	63900	0.00278
SRR11284171_1_kneaddata_paired	Deferribacterota	10822	P	30197	45	30242	0.00132
SRR11284171_1_kneaddata_paired	Cyanobacteria	9876	P	2319	25	2344	0.00010
SRR11284171_1_kneaddata_paired	Campylobacterota	8700	P	528	0	528	0.00002
SRR11284171_1_kneaddata_paired	Spirochaetota	32587	P	174	0	174	0.00001
SRR11284171_1_kneaddata_paired	Firmicutes_I	18140	P	133	0	133	0.00001
SRR11284171_1_kneaddata_paired	Thermotogota	33086	P	68	0	68	0.00000
SRR11284171_1_kneaddata_paired	Firmicutes_C	17613	P	47	0	47	0.00000
SRR11284171_1_kneaddata_paired	Elusimicrobiota	11888	P	8	0	8	0.00000
SRR11284179_1_kneaddata_paired	Firmicutes_A	14608	P	2389717	12317	2402034	0.70819
SRR11284179_1_kneaddata_paired	Bacteroidota	4587	P	743900	3982	747882	0.22050
SRR11284179_1_kneaddata_paired	Firmicutes	12188	P	111581	2058	113639	0.03350
SRR11284179_1_kneaddata_paired	Deferribacterota	10822	P	92673	352	93025	0.02743
SRR11284179_1_kneaddata_paired	Desulfobacterota_A	11509	P	18440	63	18503	0.00546
SRR11284179_1_kneaddata_paired	Actinobacteriota	615	P	5635	30	5665	0.00167
SRR11284179_1_kneaddata_paired	Verrucomicrobiota	33333	P	5540	324	5864	0.00173
SRR11284179_1_kneaddata_paired	Firmicutes_B	17289	P	3121	115	3236	0.00095
SRR11284179_1_kneaddata_paired	Proteobacteria	22518	P	1225	15	1240	0.00037
SRR11284179_1_kneaddata_paired	Cyanobacteria	9876	P	532	4	536	0.00016
SRR11284179_1_kneaddata_paired	Spirochaetota	32587	P	81	0	81	0.00002
SRR11284179_1_kneaddata_paired	Campylobacterota	8700	P	37	0	37	0.00001
SRR11284179_1_kneaddata_paired	Firmicutes_C	17613	P	19	0	19	0.00001
SRR11284179_1_kneaddata_paired	Firmicutes_I	18140	P	19	0	19	0.00001
SRR11284179_1_kneaddata_paired	Thermotogota	33086	P	6	0	6	0.00000
SRR11284179_1_kneaddata_paired	Elusimicrobiota	11888	P	1	0	1	0.00000
SRR11284180_1_kneaddata_paired	Firmicutes_A	14608	P	1816518	9350	1825868	0.55746
SRR11284180_1_kneaddata_paired	Bacteroidota	4587	P	1130379	6682	1137061	0.34716
SRR11284180_1_kneaddata_paired	Firmicutes	12188	P	242436	3144	245580	0.07498
SRR11284180_1_kneaddata_paired	Verrucomicrobiota	33333	P	16598	923	17521	0.00535
SRR11284180_1_kneaddata_paired	Actinobacteriota	615	P	14633	62	14695	0.00449
SRR11284180_1_kneaddata_paired	Deferribacterota	10822	P	13116	47	13163	0.00402
SRR11284180_1_kneaddata_paired	Firmicutes_B	17289	P	11007	386	11393	0.00348
SRR11284180_1_kneaddata_paired	Desulfobacterota_A	11509	P	7064	54	7118	0.00217
SRR11284180_1_kneaddata_paired	Proteobacteria	22518	P	2104	28	2132	0.00065
SRR11284180_1_kneaddata_paired	Cyanobacteria	9876	P	602	4	606	0.00019
SRR11284180_1_kneaddata_paired	Campylobacterota	8700	P	71	0	71	0.00002
SRR11284180_1_kneaddata_paired	Spirochaetota	32587	P	55	0	55	0.00002
SRR11284180_1_kneaddata_paired	Firmicutes_I	18140	P	26	0	26	0.00001
SRR11284180_1_kneaddata_paired	Firmicutes_C	17613	P	23	0	23	0.00001
SRR11284180_1_kneaddata_paired	Thermotogota	33086	P	5	0	5	0.00000
SRR11284180_1_kneaddata_paired	Elusimicrobiota	11888	P	4	0	4	0.00000
SRR11284181_1_kneaddata_paired	Bacteroidota	4587	P	2110287	9396	2119683	0.55529
SRR11284181_1_kneaddata_paired	Firmicutes_A	14608	P	1317868	5329	1323197	0.34663
SRR11284181_1_kneaddata_paired	Firmicutes	12188	P	196031	3917	199948	0.05238
SRR11284181_1_kneaddata_paired	Verrucomicrobiota	33333	P	90219	3593	93812	0.02458
SRR11284181_1_kneaddata_paired	Actinobacteriota	615	P	48239	149	48388	0.01268
SRR11284181_1_kneaddata_paired	Firmicutes_B	17289	P	12905	323	13228	0.00347
SRR11284181_1_kneaddata_paired	Desulfobacterota_A	11509	P	10509	25	10534	0.00276
SRR11284181_1_kneaddata_paired	Deferribacterota	10822	P	4369	11	4380	0.00115
SRR11284181_1_kneaddata_paired	Proteobacteria	22518	P	3373	28	3401	0.00089
SRR11284181_1_kneaddata_paired	Cyanobacteria	9876	P	573	4	577	0.00015
SRR11284181_1_kneaddata_paired	Campylobacterota	8700	P	50	0	50	0.00001
SRR11284181_1_kneaddata_paired	Spirochaetota	32587	P	47	0	47	0.00001
SRR11284181_1_kneaddata_paired	Firmicutes_I	18140	P	19	0	19	0.00000
SRR11284181_1_kneaddata_paired	Firmicutes_C	17613	P	10	0	10	0.00000
SRR11284181_1_kneaddata_paired	Thermotogota	33086	P	5	0	5	0.00000
SRR11284181_1_kneaddata_paired	Elusimicrobiota	11888	P	1	0	1	0.00000
SRR11284182_1_kneaddata_paired	Bacteroidota	4587	P	18268793	81969	18350762	0.60167
SRR11284182_1_kneaddata_paired	Firmicutes_A	14608	P	9964836	61758	10026594	0.32874
SRR11284182_1_kneaddata_paired	Firmicutes	12188	P	1314883	8238	1323121	0.04338
SRR11284182_1_kneaddata_paired	Actinobacteriota	615	P	359805	976	360781	0.01183
SRR11284182_1_kneaddata_paired	Proteobacteria	22518	P	143931	1136	145067	0.00476
SRR11284182_1_kneaddata_paired	Firmicutes_B	17289	P	130250	3867	134117	0.00440
SRR11284182_1_kneaddata_paired	Desulfobacterota_A	11509	P	57001	273	57274	0.00188
SRR11284182_1_kneaddata_paired	Deferribacterota	10822	P	53963	163	54126	0.00177
SRR11284182_1_kneaddata_paired	Verrucomicrobiota	33333	P	39585	1819	41404	0.00136
SRR11284182_1_kneaddata_paired	Cyanobacteria	9876	P	5036	77	5113	0.00017
SRR11284182_1_kneaddata_paired	Campylobacterota	8700	P	709	0	709	0.00002
SRR11284182_1_kneaddata_paired	Spirochaetota	32587	P	402	0	402	0.00001
SRR11284182_1_kneaddata_paired	Firmicutes_I	18140	P	244	0	244	0.00001
SRR11284182_1_kneaddata_paired	Firmicutes_C	17613	P	83	0	83	0.00000
SRR11284182_1_kneaddata_paired	Elusimicrobiota	11888	P	32	0	32	0.00000
SRR11284182_1_kneaddata_paired	Thermotogota	33086	P	21	0	21	0.00000
SRR11284183_1_kneaddata_paired	Bacteroidota	4587	P	1748348	8140	1756488	0.56907
SRR11284183_1_kneaddata_paired	Firmicutes_A	14608	P	964875	5240	970115	0.31430
SRR11284183_1_kneaddata_paired	Firmicutes	12188	P	294927	4328	299255	0.09695
SRR11284183_1_kneaddata_paired	Actinobacteriota	615	P	32513	200	32713	0.01060
SRR11284183_1_kneaddata_paired	Firmicutes_B	17289	P	11815	362	12177	0.00395
SRR11284183_1_kneaddata_paired	Desulfobacterota_A	11509	P	7524	29	7553	0.00245
SRR11284183_1_kneaddata_paired	Proteobacteria	22518	P	2964	30	2994	0.00097
SRR11284183_1_kneaddata_paired	Verrucomicrobiota	33333	P	2819	135	2954	0.00096
SRR11284183_1_kneaddata_paired	Deferribacterota	10822	P	1493	4	1497	0.00049
SRR11284183_1_kneaddata_paired	Cyanobacteria	9876	P	612	6	618	0.00020
SRR11284183_1_kneaddata_paired	Campylobacterota	8700	P	129	0	129	0.00004
SRR11284183_1_kneaddata_paired	Spirochaetota	32587	P	48	0	48	0.00002
SRR11284183_1_kneaddata_paired	Firmicutes_I	18140	P	27	0	27	0.00001
SRR11284183_1_kneaddata_paired	Firmicutes_C	17613	P	11	0	11	0.00000
SRR11284183_1_kneaddata_paired	Elusimicrobiota	11888	P	3	0	3	0.00000
SRR11284184_1_kneaddata_paired	Bacteroidota	4587	P	1964129	8678	1972807	0.59317
SRR11284184_1_kneaddata_paired	Firmicutes_A	14608	P	956286	5428	961714	0.28916
SRR11284184_1_kneaddata_paired	Firmicutes	12188	P	315948	4969	320917	0.09649
SRR11284184_1_kneaddata_paired	Actinobacteriota	615	P	27724	166	27890	0.00839
SRR11284184_1_kneaddata_paired	Firmicutes_B	17289	P	18832	551	19383	0.00583
SRR11284184_1_kneaddata_paired	Desulfobacterota_A	11509	P	9312	26	9338	0.00281
SRR11284184_1_kneaddata_paired	Verrucomicrobiota	33333	P	5519	255	5774	0.00174
SRR11284184_1_kneaddata_paired	Deferribacterota	10822	P	4165	12	4177	0.00126
SRR11284184_1_kneaddata_paired	Proteobacteria	22518	P	2933	29	2962	0.00089
SRR11284184_1_kneaddata_paired	Cyanobacteria	9876	P	638	7	645	0.00019
SRR11284184_1_kneaddata_paired	Campylobacterota	8700	P	137	0	137	0.00004
SRR11284184_1_kneaddata_paired	Spirochaetota	32587	P	66	0	66	0.00002
SRR11284184_1_kneaddata_paired	Firmicutes_I	18140	P	26	0	26	0.00001
SRR11284184_1_kneaddata_paired	Firmicutes_C	17613	P	6	0	6	0.00000
SRR11284184_1_kneaddata_paired	Elusimicrobiota	11888	P	2	0	2	0.00000
SRR11284184_1_kneaddata_paired	Thermotogota	33086	P	2	0	2	0.00000
SRR11284185_1_kneaddata_paired	Bacteroidota	4587	P	1418180	6507	1424687	0.57429
SRR11284185_1_kneaddata_paired	Firmicutes_A	14608	P	801649	4594	806243	0.32500
SRR11284185_1_kneaddata_paired	Firmicutes	12188	P	194653	3284	197937	0.07979
SRR11284185_1_kneaddata_paired	Actinobacteriota	615	P	18660	123	18783	0.00757
SRR11284185_1_kneaddata_paired	Desulfobacterota_A	11509	P	13584	25	13609	0.00549
SRR11284185_1_kneaddata_paired	Firmicutes_B	17289	P	9193	291	9484	0.00382
SRR11284185_1_kneaddata_paired	Verrucomicrobiota	33333	P	5037	251	5288	0.00213
SRR11284185_1_kneaddata_paired	Proteobacteria	22518	P	2852	31	2883	0.00116
SRR11284185_1_kneaddata_paired	Deferribacterota	10822	P	1264	4	1268	0.00051
SRR11284185_1_kneaddata_paired	Cyanobacteria	9876	P	452	4	456	0.00018
SRR11284185_1_kneaddata_paired	Campylobacterota	8700	P	71	0	71	0.00003
SRR11284185_1_kneaddata_paired	Spirochaetota	32587	P	32	0	32	0.00001
SRR11284185_1_kneaddata_paired	Firmicutes_I	18140	P	18	0	18	0.00001
SRR11284185_1_kneaddata_paired	Firmicutes_C	17613	P	7	0	7	0.00000
SRR11284185_1_kneaddata_paired	Thermotogota	33086	P	2	0	2	0.00000
SRR11284186_1_kneaddata_paired	Firmicutes_A	14608	P	2294895	11723	2306618	0.72100
SRR11284186_1_kneaddata_paired	Bacteroidota	4587	P	682811	3572	686383	0.21455
SRR11284186_1_kneaddata_paired	Firmicutes	12188	P	149560	1616	151176	0.04725
SRR11284186_1_kneaddata_paired	Deferribacterota	10822	P	30577	109	30686	0.00959
SRR11284186_1_kneaddata_paired	Actinobacteriota	615	P	13983	33	14016	0.00438
SRR11284186_1_kneaddata_paired	Desulfobacterota_A	11509	P	5061	31	5092	0.00159
SRR11284186_1_kneaddata_paired	Firmicutes_B	17289	P	2592	90	2682	0.00084
SRR11284186_1_kneaddata_paired	Verrucomicrobiota	33333	P	1084	52	1136	0.00036
SRR11284186_1_kneaddata_paired	Proteobacteria	22518	P	653	6	659	0.00021
SRR11284186_1_kneaddata_paired	Cyanobacteria	9876	P	577	5	582	0.00018
SRR11284186_1_kneaddata_paired	Spirochaetota	32587	P	68	0	68	0.00002
SRR11284186_1_kneaddata_paired	Campylobacterota	8700	P	43	0	43	0.00001
SRR11284186_1_kneaddata_paired	Firmicutes_C	17613	P	22	0	22	0.00001
SRR11284186_1_kneaddata_paired	Firmicutes_I	18140	P	17	0	17	0.00001
SRR11284186_1_kneaddata_paired	Thermotogota	33086	P	12	0	12	0.00000
SRR11284186_1_kneaddata_paired	Elusimicrobiota	11888	P	2	0	2	0.00000
SRR11284187_1_kneaddata_paired	Bacteroidota	4587	P	1707985	9760	1717745	0.59267
SRR11284187_1_kneaddata_paired	Firmicutes_A	14608	P	908510	5393	913903	0.31532
SRR11284187_1_kneaddata_paired	Firmicutes	12188	P	216592	1890	218482	0.07538
SRR11284187_1_kneaddata_paired	Actinobacteriota	615	P	17190	49	17239	0.00595
SRR11284187_1_kneaddata_paired	Firmicutes_B	17289	P	17095	666	17761	0.00613
SRR11284187_1_kneaddata_paired	Verrucomicrobiota	33333	P	4331	266	4597	0.00159
SRR11284187_1_kneaddata_paired	Desulfobacterota_A	11509	P	4288	37	4325	0.00149
SRR11284187_1_kneaddata_paired	Deferribacterota	10822	P	2228	8	2236	0.00077
SRR11284187_1_kneaddata_paired	Proteobacteria	22518	P	1349	16	1365	0.00047
SRR11284187_1_kneaddata_paired	Cyanobacteria	9876	P	496	4	500	0.00017
SRR11284187_1_kneaddata_paired	Campylobacterota	8700	P	97	0	97	0.00003
SRR11284187_1_kneaddata_paired	Spirochaetota	32587	P	41	0	41	0.00001
SRR11284187_1_kneaddata_paired	Firmicutes_I	18140	P	16	0	16	0.00001
SRR11284187_1_kneaddata_paired	Firmicutes_C	17613	P	11	0	11	0.00000
SRR11284187_1_kneaddata_paired	Elusimicrobiota	11888	P	6	0	6	0.00000
SRR11284187_1_kneaddata_paired	Thermotogota	33086	P	4	0	4	0.00000
SRR11284188_1_kneaddata_paired	Bacteroidota	4587	P	1840703	9813	1850516	0.58677
SRR11284188_1_kneaddata_paired	Firmicutes_A	14608	P	957651	4677	962328	0.30514
SRR11284188_1_kneaddata_paired	Firmicutes	12188	P	272836	2788	275624	0.08740
SRR11284188_1_kneaddata_paired	Actinobacteriota	615	P	27562	77	27639	0.00876
SRR11284188_1_kneaddata_paired	Firmicutes_B	17289	P	16642	559	17201	0.00545
SRR11284188_1_kneaddata_paired	Verrucomicrobiota	33333	P	11286	600	11886	0.00377
SRR11284188_1_kneaddata_paired	Desulfobacterota_A	11509	P	4445	22	4467	0.00142
SRR11284188_1_kneaddata_paired	Proteobacteria	22518	P	1942	22	1964	0.00062
SRR11284188_1_kneaddata_paired	Deferribacterota	10822	P	1340	4	1344	0.00043
SRR11284188_1_kneaddata_paired	Cyanobacteria	9876	P	595	6	601	0.00019
SRR11284188_1_kneaddata_paired	Campylobacterota	8700	P	60	0	60	0.00002
SRR11284188_1_kneaddata_paired	Spirochaetota	32587	P	48	0	48	0.00002
SRR11284188_1_kneaddata_paired	Firmicutes_I	18140	P	21	0	21	0.00001
SRR11284188_1_kneaddata_paired	Firmicutes_C	17613	P	10	0	10	0.00000
SRR11284188_1_kneaddata_paired	Elusimicrobiota	11888	P	2	0	2	0.00000
SRR11284188_1_kneaddata_paired	Thermotogota	33086	P	1	0	1	0.00000
SRR11284189_1_kneaddata_paired	Firmicutes_A	14608	P	1673221	10441	1683662	0.54098
SRR11284189_1_kneaddata_paired	Bacteroidota	4587	P	1214623	7938	1222561	0.39282
SRR11284189_1_kneaddata_paired	Firmicutes	12188	P	147918	1764	149682	0.04809
SRR11284189_1_kneaddata_paired	Deferribacterota	10822	P	29377	137	29514	0.00948
SRR11284189_1_kneaddata_paired	Desulfobacterota_A	11509	P	9812	58	9870	0.00317
SRR11284189_1_kneaddata_paired	Firmicutes_B	17289	P	9173	418	9591	0.00308
SRR11284189_1_kneaddata_paired	Actinobacteriota	615	P	4280	46	4326	0.00139
SRR11284189_1_kneaddata_paired	Proteobacteria	22518	P	1231	24	1255	0.00040
SRR11284189_1_kneaddata_paired	Verrucomicrobiota	33333	P	1006	70	1076	0.00035
SRR11284189_1_kneaddata_paired	Cyanobacteria	9876	P	602	6	608	0.00020
SRR11284189_1_kneaddata_paired	Spirochaetota	32587	P	59	0	59	0.00002
SRR11284189_1_kneaddata_paired	Campylobacterota	8700	P	29	0	29	0.00001
SRR11284189_1_kneaddata_paired	Firmicutes_I	18140	P	18	0	18	0.00001
SRR11284189_1_kneaddata_paired	Firmicutes_C	17613	P	9	0	9	0.00000
SRR11284189_1_kneaddata_paired	Thermotogota	33086	P	4	0	4	0.00000
SRR11284190_1_kneaddata_paired	Firmicutes_A	14608	P	2600650	11537	2612187	0.77150
SRR11284190_1_kneaddata_paired	Bacteroidota	4587	P	594641	3366	598007	0.17662
SRR11284190_1_kneaddata_paired	Firmicutes	12188	P	148676	1510	150186	0.04436
SRR11284190_1_kneaddata_paired	Desulfobacterota_A	11509	P	8558	44	8602	0.00254
SRR11284190_1_kneaddata_paired	Deferribacterota	10822	P	6223	21	6244	0.00184
SRR11284190_1_kneaddata_paired	Actinobacteriota	615	P	4860	31	4891	0.00144
SRR11284190_1_kneaddata_paired	Firmicutes_B	17289	P	3283	110	3393	0.00100
SRR11284190_1_kneaddata_paired	Verrucomicrobiota	33333	P	818	39	857	0.00025
SRR11284190_1_kneaddata_paired	Cyanobacteria	9876	P	658	5	663	0.00020
SRR11284190_1_kneaddata_paired	Proteobacteria	22518	P	641	12	653	0.00019
SRR11284190_1_kneaddata_paired	Spirochaetota	32587	P	52	0	52	0.00002
SRR11284190_1_kneaddata_paired	Firmicutes_C	17613	P	30	0	30	0.00001
SRR11284190_1_kneaddata_paired	Firmicutes_I	18140	P	30	0	30	0.00001
SRR11284190_1_kneaddata_paired	Campylobacterota	8700	P	27	0	27	0.00001
SRR11284190_1_kneaddata_paired	Thermotogota	33086	P	9	0	9	0.00000
SRR11284190_1_kneaddata_paired	Elusimicrobiota	11888	P	2	0	2	0.00000
SRR11284191_1_kneaddata_paired	Bacteroidota	4587	P	2023677	10976	2034653	0.63205
SRR11284191_1_kneaddata_paired	Firmicutes_A	14608	P	819578	5412	824990	0.25628
SRR11284191_1_kneaddata_paired	Firmicutes	12188	P	318953	3274	322227	0.10010
SRR11284191_1_kneaddata_paired	Actinobacteriota	615	P	10421	94	10515	0.00327
SRR11284191_1_kneaddata_paired	Desulfobacterota_A	11509	P	8946	29	8975	0.00279
SRR11284191_1_kneaddata_paired	Firmicutes_B	17289	P	7961	332	8293	0.00258
SRR11284191_1_kneaddata_paired	Deferribacterota	10822	P	4309	18	4327	0.00134
SRR11284191_1_kneaddata_paired	Verrucomicrobiota	33333	P	2231	143	2374	0.00074
SRR11284191_1_kneaddata_paired	Proteobacteria	22518	P	1679	29	1708	0.00053
SRR11284191_1_kneaddata_paired	Cyanobacteria	9876	P	904	7	911	0.00028
SRR11284191_1_kneaddata_paired	Campylobacterota	8700	P	97	0	97	0.00003
SRR11284191_1_kneaddata_paired	Spirochaetota	32587	P	45	0	45	0.00001
SRR11284191_1_kneaddata_paired	Firmicutes_I	18140	P	8	0	8	0.00000
SRR11284191_1_kneaddata_paired	Firmicutes_C	17613	P	6	0	6	0.00000
SRR11284191_1_kneaddata_paired	Elusimicrobiota	11888	P	1	0	1	0.00000
SRR11284191_1_kneaddata_paired	Thermotogota	33086	P	1	0	1	0.00000
SRR11284192_1_kneaddata_paired	Bacteroidota	4587	P	2890205	14896	2905101	0.64414
SRR11284192_1_kneaddata_paired	Firmicutes_A	14608	P	1195667	4265	1199932	0.26606
SRR11284192_1_kneaddata_paired	Firmicutes	12188	P	351169	1747	352916	0.07825
SRR11284192_1_kneaddata_paired	Deferribacterota	10822	P	18969	53	19022	0.00422
SRR11284192_1_kneaddata_paired	Verrucomicrobiota	33333	P	10201	445	10646	0.00236
SRR11284192_1_kneaddata_paired	Actinobacteriota	615	P	9366	31	9397	0.00208
SRR11284192_1_kneaddata_paired	Firmicutes_B	17289	P	8402	232	8634	0.00191
SRR11284192_1_kneaddata_paired	Desulfobacterota_A	11509	P	2213	19	2232	0.00050
SRR11284192_1_kneaddata_paired	Proteobacteria	22518	P	1496	16	1512	0.00034
SRR11284192_1_kneaddata_paired	Cyanobacteria	9876	P	453	5	458	0.00010
SRR11284192_1_kneaddata_paired	Campylobacterota	8700	P	71	0	71	0.00002
SRR11284192_1_kneaddata_paired	Spirochaetota	32587	P	51	0	51	0.00001
SRR11284192_1_kneaddata_paired	Firmicutes_I	18140	P	31	0	31	0.00001
SRR11284192_1_kneaddata_paired	Firmicutes_C	17613	P	14	0	14	0.00000
SRR11284192_1_kneaddata_paired	Thermotogota	33086	P	4	0	4	0.00000
SRR11284193_1_kneaddata_paired	Firmicutes_A	14608	P	23172341	109670	23282011	0.56673
SRR11284193_1_kneaddata_paired	Bacteroidota	4587	P	15790768	85909	15876677	0.38647
SRR11284193_1_kneaddata_paired	Firmicutes	12188	P	1031905	9228	1041133	0.02534
SRR11284193_1_kneaddata_paired	Desulfobacterota_A	11509	P	226920	590	227510	0.00554
SRR11284193_1_kneaddata_paired	Actinobacteriota	615	P	164500	556	165056	0.00402
SRR11284193_1_kneaddata_paired	Verrucomicrobiota	33333	P	156030	7630	163660	0.00398
SRR11284193_1_kneaddata_paired	Deferribacterota	10822	P	145230	458	145688	0.00355
SRR11284193_1_kneaddata_paired	Firmicutes_B	17289	P	124165	3841	128006	0.00312
SRR11284193_1_kneaddata_paired	Proteobacteria	22518	P	42542	451	42993	0.00105
SRR11284193_1_kneaddata_paired	Cyanobacteria	9876	P	6763	107	6870	0.00017
SRR11284193_1_kneaddata_paired	Campylobacterota	8700	P	731	0	731	0.00002
SRR11284193_1_kneaddata_paired	Spirochaetota	32587	P	590	1	591	0.00001
SRR11284193_1_kneaddata_paired	Firmicutes_I	18140	P	370	0	370	0.00001
SRR11284193_1_kneaddata_paired	Firmicutes_C	17613	P	249	0	249	0.00001
SRR11284193_1_kneaddata_paired	Thermotogota	33086	P	76	0	76	0.00000
SRR11284193_1_kneaddata_paired	Elusimicrobiota	11888	P	27	0	27	0.00000
SRR11284194_1_kneaddata_paired	Firmicutes_A	14608	P	2350242	11210	2361452	0.53339
SRR11284194_1_kneaddata_paired	Bacteroidota	4587	P	1573840	10629	1584469	0.35789
SRR11284194_1_kneaddata_paired	Firmicutes	12188	P	427195	2889	430084	0.09715
SRR11284194_1_kneaddata_paired	Deferribacterota	10822	P	18904	72	18976	0.00429
SRR11284194_1_kneaddata_paired	Verrucomicrobiota	33333	P	13368	791	14159	0.00320
SRR11284194_1_kneaddata_paired	Actinobacteriota	615	P	12153	38	12191	0.00275
SRR11284194_1_kneaddata_paired	Firmicutes_B	17289	P	2931	110	3041	0.00069
SRR11284194_1_kneaddata_paired	Desulfobacterota_A	11509	P	966	75	1041	0.00024
SRR11284194_1_kneaddata_paired	Proteobacteria	22518	P	945	14	959	0.00022
SRR11284194_1_kneaddata_paired	Cyanobacteria	9876	P	603	9	612	0.00014
SRR11284194_1_kneaddata_paired	Campylobacterota	8700	P	122	0	122	0.00003
SRR11284194_1_kneaddata_paired	Spirochaetota	32587	P	48	0	48	0.00001
SRR11284194_1_kneaddata_paired	Firmicutes_I	18140	P	27	0	27	0.00001
SRR11284194_1_kneaddata_paired	Firmicutes_C	17613	P	14	0	14	0.00000
SRR11284194_1_kneaddata_paired	Thermotogota	33086	P	11	0	11	0.00000
SRR11284194_1_kneaddata_paired	Elusimicrobiota	11888	P	3	0	3	0.00000
SRR11284195_1_kneaddata_paired	Firmicutes_A	14608	P	3139000	11590	3150590	0.85822
SRR11284195_1_kneaddata_paired	Bacteroidota	4587	P	357447	2278	359725	0.09799
SRR11284195_1_kneaddata_paired	Firmicutes	12188	P	133416	1262	134678	0.03669
SRR11284195_1_kneaddata_paired	Deferribacterota	10822	P	18626	56	18682	0.00509
SRR11284195_1_kneaddata_paired	Actinobacteriota	615	P	2924	10	2934	0.00080
SRR11284195_1_kneaddata_paired	Desulfobacterota_A	11509	P	1591	85	1676	0.00046
SRR11284195_1_kneaddata_paired	Verrucomicrobiota	33333	P	897	35	932	0.00025
SRR11284195_1_kneaddata_paired	Firmicutes_B	17289	P	602	17	619	0.00017
SRR11284195_1_kneaddata_paired	Cyanobacteria	9876	P	559	6	565	0.00015
SRR11284195_1_kneaddata_paired	Proteobacteria	22518	P	510	8	518	0.00014
SRR11284195_1_kneaddata_paired	Spirochaetota	32587	P	43	0	43	0.00001
SRR11284195_1_kneaddata_paired	Firmicutes_I	18140	P	39	0	39	0.00001
SRR11284195_1_kneaddata_paired	Campylobacterota	8700	P	32	0	32	0.00001
SRR11284195_1_kneaddata_paired	Firmicutes_C	17613	P	23	0	23	0.00001
SRR11284195_1_kneaddata_paired	Thermotogota	33086	P	14	0	14	0.00000
SRR11284196_1_kneaddata_paired	Bacteroidota	4587	P	1847476	9108	1856584	0.68250
SRR11284196_1_kneaddata_paired	Firmicutes_A	14608	P	661164	2669	663833	0.24403
SRR11284196_1_kneaddata_paired	Firmicutes	12188	P	112443	545	112988	0.04154
SRR11284196_1_kneaddata_paired	Verrucomicrobiota	33333	P	69076	3091	72167	0.02653
SRR11284196_1_kneaddata_paired	Actinobacteriota	615	P	6588	14	6602	0.00243
SRR11284196_1_kneaddata_paired	Deferribacterota	10822	P	4146	11	4157	0.00153
SRR11284196_1_kneaddata_paired	Proteobacteria	22518	P	1490	16	1506	0.00055
SRR11284196_1_kneaddata_paired	Firmicutes_B	17289	P	1484	41	1525	0.00056
SRR11284196_1_kneaddata_paired	Desulfobacterota_A	11509	P	436	7	443	0.00016
SRR11284196_1_kneaddata_paired	Cyanobacteria	9876	P	351	4	355	0.00013
SRR11284196_1_kneaddata_paired	Campylobacterota	8700	P	56	0	56	0.00002
SRR11284196_1_kneaddata_paired	Spirochaetota	32587	P	18	0	18	0.00001
SRR11284196_1_kneaddata_paired	Firmicutes_I	18140	P	12	0	12	0.00000
SRR11284196_1_kneaddata_paired	Firmicutes_C	17613	P	3	0	3	0.00000
SRR11284196_1_kneaddata_paired	Thermotogota	33086	P	2	0	2	0.00000
SRR11284196_1_kneaddata_paired	Elusimicrobiota	11888	P	1	0	1	0.00000
SRR11284197_1_kneaddata_paired	Bacteroidota	4587	P	2256253	11248	2267501	0.63162
SRR11284197_1_kneaddata_paired	Firmicutes_A	14608	P	978589	4178	982767	0.27375
SRR11284197_1_kneaddata_paired	Firmicutes	12188	P	234464	1192	235656	0.06564
SRR11284197_1_kneaddata_paired	Verrucomicrobiota	33333	P	67399	3317	70716	0.01970
SRR11284197_1_kneaddata_paired	Actinobacteriota	615	P	13254	28	13282	0.00370
SRR11284197_1_kneaddata_paired	Firmicutes_B	17289	P	12238	379	12617	0.00351
SRR11284197_1_kneaddata_paired	Deferribacterota	10822	P	4189	13	4202	0.00117
SRR11284197_1_kneaddata_paired	Proteobacteria	22518	P	2296	31	2327	0.00065
SRR11284197_1_kneaddata_paired	Cyanobacteria	9876	P	484	6	490	0.00014
SRR11284197_1_kneaddata_paired	Desulfobacterota_A	11509	P	257	16	273	0.00008
SRR11284197_1_kneaddata_paired	Campylobacterota	8700	P	94	0	94	0.00003
SRR11284197_1_kneaddata_paired	Spirochaetota	32587	P	25	0	25	0.00001
SRR11284197_1_kneaddata_paired	Firmicutes_I	18140	P	17	0	17	0.00000
SRR11284197_1_kneaddata_paired	Firmicutes_C	17613	P	13	0	13	0.00000
SRR11284197_1_kneaddata_paired	Thermotogota	33086	P	4	0	4	0.00000
SRR11284197_1_kneaddata_paired	Elusimicrobiota	11888	P	1	0	1	0.00000
SRR11284198_1_kneaddata_paired	Bacteroidota	4587	P	1787212	5094	1792306	0.63765
SRR11284198_1_kneaddata_paired	Firmicutes_A	14608	P	577275	1524	578799	0.20592
SRR11284198_1_kneaddata_paired	Verrucomicrobiota	33333	P	273020	8146	281166	0.10003
SRR11284198_1_kneaddata_paired	Firmicutes	12188	P	139234	359	139593	0.04966
SRR11284198_1_kneaddata_paired	Firmicutes_B	17289	P	8219	154	8373	0.00298
SRR11284198_1_kneaddata_paired	Deferribacterota	10822	P	4746	9	4755	0.00169
SRR11284198_1_kneaddata_paired	Actinobacteriota	615	P	3861	13	3874	0.00138
SRR11284198_1_kneaddata_paired	Proteobacteria	22518	P	1273	9	1282	0.00046
SRR11284198_1_kneaddata_paired	Desulfobacterota_A	11509	P	370	7	377	0.00013
SRR11284198_1_kneaddata_paired	Cyanobacteria	9876	P	216	1	217	0.00008
SRR11284198_1_kneaddata_paired	Campylobacterota	8700	P	37	0	37	0.00001
SRR11284198_1_kneaddata_paired	Spirochaetota	32587	P	18	0	18	0.00001
SRR11284198_1_kneaddata_paired	Firmicutes_I	18140	P	7	0	7	0.00000
SRR11284198_1_kneaddata_paired	Thermotogota	33086	P	4	0	4	0.00000
SRR11284198_1_kneaddata_paired	Firmicutes_C	17613	P	3	0	3	0.00000
SRR11284204_1_kneaddata_paired	Bacteroidota	4587	P	15864922	60710	15925632	0.68089
SRR11284204_1_kneaddata_paired	Firmicutes_A	14608	P	5666864	32660	5699524	0.24368
SRR11284204_1_kneaddata_paired	Firmicutes	12188	P	885535	13102	898637	0.03842
SRR11284204_1_kneaddata_paired	Verrucomicrobiota	33333	P	312413	12433	324846	0.01389
SRR11284204_1_kneaddata_paired	Actinobacteriota	615	P	186595	971	187566	0.00802
SRR11284204_1_kneaddata_paired	Proteobacteria	22518	P	105251	633	105884	0.00453
SRR11284204_1_kneaddata_paired	Desulfobacterota_A	11509	P	100550	126	100676	0.00430
SRR11284204_1_kneaddata_paired	Firmicutes_B	17289	P	78922	1979	80901	0.00346
SRR11284204_1_kneaddata_paired	Deferribacterota	10822	P	61288	156	61444	0.00263
SRR11284204_1_kneaddata_paired	Cyanobacteria	9876	P	3215	44	3259	0.00014
SRR11284204_1_kneaddata_paired	Campylobacterota	8700	P	493	0	493	0.00002
SRR11284204_1_kneaddata_paired	Spirochaetota	32587	P	290	0	290	0.00001
SRR11284204_1_kneaddata_paired	Firmicutes_I	18140	P	135	0	135	0.00001
SRR11284204_1_kneaddata_paired	Firmicutes_C	17613	P	58	0	58	0.00000
SRR11284204_1_kneaddata_paired	Thermotogota	33086	P	43	0	43	0.00000
SRR11284204_1_kneaddata_paired	Elusimicrobiota	11888	P	8	0	8	0.00000
SRR11284205_1_kneaddata_paired	Firmicutes_A	14608	P	9723956	42456	9766412	0.62547
SRR11284205_1_kneaddata_paired	Bacteroidota	4587	P	5001186	24797	5025983	0.32188
SRR11284205_1_kneaddata_paired	Firmicutes	12188	P	557059	4283	561342	0.03595
SRR11284205_1_kneaddata_paired	Firmicutes_B	17289	P	70891	1811	72702	0.00466
SRR11284205_1_kneaddata_paired	Deferribacterota	10822	P	61264	159	61423	0.00393
SRR11284205_1_kneaddata_paired	Actinobacteriota	615	P	55742	94	55836	0.00358
SRR11284205_1_kneaddata_paired	Verrucomicrobiota	33333	P	50281	2034	52315	0.00335
SRR11284205_1_kneaddata_paired	Desulfobacterota_A	11509	P	7484	162	7646	0.00049
SRR11284205_1_kneaddata_paired	Proteobacteria	22518	P	6013	52	6065	0.00039
SRR11284205_1_kneaddata_paired	Cyanobacteria	9876	P	3695	89	3784	0.00024
SRR11284205_1_kneaddata_paired	Campylobacterota	8700	P	328	0	328	0.00002
SRR11284205_1_kneaddata_paired	Spirochaetota	32587	P	206	0	206	0.00001
SRR11284205_1_kneaddata_paired	Firmicutes_I	18140	P	132	0	132	0.00001
SRR11284205_1_kneaddata_paired	Thermotogota	33086	P	128	0	128	0.00001
SRR11284205_1_kneaddata_paired	Firmicutes_C	17613	P	77	0	77	0.00000
SRR11284205_1_kneaddata_paired	Elusimicrobiota	11888	P	10	0	10	0.00000
SRR11404525_1_kneaddata_paired	Bacteroidota	4587	P	1133961	9376	1143337	0.67718
SRR11404525_1_kneaddata_paired	Firmicutes_A	14608	P	469097	3919	473016	0.28016
SRR11404525_1_kneaddata_paired	Firmicutes	12188	P	60664	847	61511	0.03643
SRR11404525_1_kneaddata_paired	Proteobacteria	22518	P	5511	150	5661	0.00335
SRR11404525_1_kneaddata_paired	Actinobacteriota	615	P	3773	27	3800	0.00225
SRR11404525_1_kneaddata_paired	Verrucomicrobiota	33333	P	681	48	729	0.00043
SRR11404525_1_kneaddata_paired	Cyanobacteria	9876	P	155	2	157	0.00009
SRR11404525_1_kneaddata_paired	Desulfobacterota_A	11509	P	83	14	97	0.00006
SRR11404525_1_kneaddata_paired	Firmicutes_B	17289	P	18	0	18	0.00001
SRR11404525_1_kneaddata_paired	Campylobacterota	8700	P	16	0	16	0.00001
SRR11404525_1_kneaddata_paired	Firmicutes_I	18140	P	11	0	11	0.00001
SRR11404525_1_kneaddata_paired	Spirochaetota	32587	P	9	0	9	0.00001
SRR11404525_1_kneaddata_paired	Firmicutes_C	17613	P	7	0	7	0.00000
SRR11404525_1_kneaddata_paired	Deferribacterota	10822	P	2	0	2	0.00000
SRR11404525_1_kneaddata_paired	Elusimicrobiota	11888	P	2	0	2	0.00000
SRR11404526_1_kneaddata_paired	Firmicutes_A	14608	P	1659030	11611	1670641	0.79497
SRR11404526_1_kneaddata_paired	Bacteroidota	4587	P	399263	4841	404104	0.19229
SRR11404526_1_kneaddata_paired	Firmicutes	12188	P	19923	651	20574	0.00979
SRR11404526_1_kneaddata_paired	Actinobacteriota	615	P	3226	20	3246	0.00154
SRR11404526_1_kneaddata_paired	Proteobacteria	22518	P	1912	55	1967	0.00094
SRR11404526_1_kneaddata_paired	Verrucomicrobiota	33333	P	361	28	389	0.00019
SRR11404526_1_kneaddata_paired	Cyanobacteria	9876	P	243	3	246	0.00012
SRR11404526_1_kneaddata_paired	Desulfobacterota_A	11509	P	188	34	222	0.00011
SRR11404526_1_kneaddata_paired	Firmicutes_B	17289	P	57	2	59	0.00003
SRR11404526_1_kneaddata_paired	Campylobacterota	8700	P	21	0	21	0.00001
SRR11404526_1_kneaddata_paired	Spirochaetota	32587	P	19	0	19	0.00001
SRR11404526_1_kneaddata_paired	Firmicutes_I	18140	P	6	0	6	0.00000
SRR11404526_1_kneaddata_paired	Thermotogota	33086	P	6	0	6	0.00000
SRR11404526_1_kneaddata_paired	Deferribacterota	10822	P	4	0	4	0.00000
SRR11404526_1_kneaddata_paired	Elusimicrobiota	11888	P	2	0	2	0.00000
SRR11404527_1_kneaddata_paired	Bacteroidota	4587	P	504	5	509	0.32074
SRR11404527_1_kneaddata_paired	Firmicutes_A	14608	P	391	7	398	0.25098
SRR11404527_1_kneaddata_paired	Proteobacteria	22518	P	311	0	311	0.19604
SRR11404527_1_kneaddata_paired	Firmicutes	12188	P	283	7	290	0.18285
SRR11404527_1_kneaddata_paired	Campylobacterota	8700	P	42	0	42	0.02645
SRR11404527_1_kneaddata_paired	Verrucomicrobiota	33333	P	24	4	28	0.01775
SRR11404527_1_kneaddata_paired	Actinobacteriota	615	P	5	0	5	0.00322
SRR11404527_1_kneaddata_paired	Cyanobacteria	9876	P	2	0	2	0.00126
SRR11404527_1_kneaddata_paired	Firmicutes_B	17289	P	1	0	1	0.00070
SRR11404528_1_kneaddata_paired	Bacteroidota	4587	P	2294898	12630	2307528	0.72837
SRR11404528_1_kneaddata_paired	Firmicutes_A	14608	P	767858	9598	777456	0.24540
SRR11404528_1_kneaddata_paired	Firmicutes	12188	P	25754	1218	26972	0.00851
SRR11404528_1_kneaddata_paired	Campylobacterota	8700	P	16177	2	16179	0.00511
SRR11404528_1_kneaddata_paired	Actinobacteriota	615	P	14958	134	15092	0.00476
SRR11404528_1_kneaddata_paired	Firmicutes_B	17289	P	9457	628	10085	0.00318
SRR11404528_1_kneaddata_paired	Verrucomicrobiota	33333	P	7026	714	7740	0.00244
SRR11404528_1_kneaddata_paired	Proteobacteria	22518	P	3738	151	3889	0.00123
SRR11404528_1_kneaddata_paired	Cyanobacteria	9876	P	2988	9	2997	0.00095
SRR11404528_1_kneaddata_paired	Desulfobacterota_A	11509	P	84	17	101	0.00003
SRR11404528_1_kneaddata_paired	Firmicutes_I	18140	P	12	0	12	0.00000
SRR11404528_1_kneaddata_paired	Deferribacterota	10822	P	9	0	9	0.00000
SRR11404528_1_kneaddata_paired	Firmicutes_C	17613	P	4	0	4	0.00000
SRR11404528_1_kneaddata_paired	Spirochaetota	32587	P	4	0	4	0.00000
SRR11404529_1_kneaddata_paired	Bacteroidota	4587	P	1665617	13271	1678888	0.76475
SRR11404529_1_kneaddata_paired	Firmicutes_A	14608	P	425494	3389	428883	0.19536
SRR11404529_1_kneaddata_paired	Firmicutes	12188	P	70051	682	70733	0.03222
SRR11404529_1_kneaddata_paired	Actinobacteriota	615	P	9312	59	9371	0.00427
SRR11404529_1_kneaddata_paired	Proteobacteria	22518	P	5840	150	5990	0.00273
SRR11404529_1_kneaddata_paired	Verrucomicrobiota	33333	P	1096	69	1165	0.00053
SRR11404529_1_kneaddata_paired	Cyanobacteria	9876	P	130	1	131	0.00006
SRR11404529_1_kneaddata_paired	Desulfobacterota_A	11509	P	93	15	108	0.00005
SRR11404529_1_kneaddata_paired	Firmicutes_B	17289	P	21	0	21	0.00001
SRR11404529_1_kneaddata_paired	Campylobacterota	8700	P	14	0	14	0.00001
SRR11404529_1_kneaddata_paired	Firmicutes_I	18140	P	12	0	12	0.00001
SRR11404529_1_kneaddata_paired	Deferribacterota	10822	P	10	0	10	0.00000
SRR11404529_1_kneaddata_paired	Spirochaetota	32587	P	10	0	10	0.00000
SRR11404529_1_kneaddata_paired	Firmicutes_C	17613	P	3	0	3	0.00000
SRR11404529_1_kneaddata_paired	Elusimicrobiota	11888	P	1	0	1	0.00000
SRR11404529_1_kneaddata_paired	Thermotogota	33086	P	1	0	1	0.00000
SRR11404530_1_kneaddata_paired	Bacteroidota	4587	P	2208870	18334	2227204	0.72629
SRR11404530_1_kneaddata_paired	Firmicutes_A	14608	P	709028	6275	715303	0.23326
SRR11404530_1_kneaddata_paired	Firmicutes	12188	P	73039	627	73666	0.02402
SRR11404530_1_kneaddata_paired	Actinobacteriota	615	P	26909	151	27060	0.00882
SRR11404530_1_kneaddata_paired	Verrucomicrobiota	33333	P	13275	1006	14281	0.00466
SRR11404530_1_kneaddata_paired	Proteobacteria	22518	P	8346	244	8590	0.00280
SRR11404530_1_kneaddata_paired	Cyanobacteria	9876	P	180	2	182	0.00006
SRR11404530_1_kneaddata_paired	Desulfobacterota_A	11509	P	92	14	106	0.00003
SRR11404530_1_kneaddata_paired	Firmicutes_B	17289	P	65	3	68	0.00002
SRR11404530_1_kneaddata_paired	Firmicutes_I	18140	P	27	0	27	0.00001
SRR11404530_1_kneaddata_paired	Spirochaetota	32587	P	25	0	25	0.00001
SRR11404530_1_kneaddata_paired	Campylobacterota	8700	P	18	0	18	0.00001
SRR11404530_1_kneaddata_paired	Deferribacterota	10822	P	8	0	8	0.00000
SRR11404530_1_kneaddata_paired	Firmicutes_C	17613	P	6	0	6	0.00000
SRR11404530_1_kneaddata_paired	Elusimicrobiota	11888	P	1	0	1	0.00000
SRR11404531_1_kneaddata_paired	Firmicutes	12188	P	482530	12919	495449	0.92260
SRR11404531_1_kneaddata_paired	Proteobacteria	22518	P	33015	278	33293	0.06200
SRR11404531_1_kneaddata_paired	Firmicutes_A	14608	P	6543	182	6725	0.01252
SRR11404531_1_kneaddata_paired	Bacteroidota	4587	P	1032	15	1047	0.00195
SRR11404531_1_kneaddata_paired	Cyanobacteria	9876	P	398	2	400	0.00075
SRR11404531_1_kneaddata_paired	Actinobacteriota	615	P	50	0	50	0.00009
SRR11404531_1_kneaddata_paired	Desulfobacterota_A	11509	P	14	4	18	0.00003
SRR11404531_1_kneaddata_paired	Spirochaetota	32587	P	12	0	12	0.00002
SRR11404531_1_kneaddata_paired	Firmicutes_I	18140	P	11	0	11	0.00002
SRR11404531_1_kneaddata_paired	Campylobacterota	8700	P	5	0	5	0.00001
SRR11404531_1_kneaddata_paired	Deferribacterota	10822	P	1	0	1	0.00000
SRR11404531_1_kneaddata_paired	Verrucomicrobiota	33333	P	1	0	1	0.00000
SRR11404532_1_kneaddata_paired	Bacteroidota	4587	P	5615153	45759	5660912	0.83633
SRR11404532_1_kneaddata_paired	Firmicutes_A	14608	P	871542	9112	880654	0.13011
SRR11404532_1_kneaddata_paired	Firmicutes	12188	P	164486	1343	165829	0.02450
SRR11404532_1_kneaddata_paired	Actinobacteriota	615	P	37215	278	37493	0.00554
SRR11404532_1_kneaddata_paired	Proteobacteria	22518	P	18088	548	18636	0.00275
SRR11404532_1_kneaddata_paired	Verrucomicrobiota	33333	P	4069	313	4382	0.00065
SRR11404532_1_kneaddata_paired	Cyanobacteria	9876	P	441	5	446	0.00007
SRR11404532_1_kneaddata_paired	Desulfobacterota_A	11509	P	130	18	148	0.00002
SRR11404532_1_kneaddata_paired	Firmicutes_B	17289	P	72	3	75	0.00001
SRR11404532_1_kneaddata_paired	Campylobacterota	8700	P	46	0	46	0.00001
SRR11404532_1_kneaddata_paired	Firmicutes_I	18140	P	36	0	36	0.00001
SRR11404532_1_kneaddata_paired	Spirochaetota	32587	P	33	0	33	0.00000
SRR11404532_1_kneaddata_paired	Deferribacterota	10822	P	19	0	19	0.00000
SRR11404532_1_kneaddata_paired	Firmicutes_C	17613	P	9	0	9	0.00000
SRR11404532_1_kneaddata_paired	Elusimicrobiota	11888	P	2	0	2	0.00000
SRR11404532_1_kneaddata_paired	Thermotogota	33086	P	2	0	2	0.00000
SRR11404533_1_kneaddata_paired	Bacteroidota	4587	P	949323	8779	958102	0.52268
SRR11404533_1_kneaddata_paired	Firmicutes_A	14608	P	819986	5438	825424	0.45030
SRR11404533_1_kneaddata_paired	Firmicutes	12188	P	36428	423	36851	0.02010
SRR11404533_1_kneaddata_paired	Actinobacteriota	615	P	9641	47	9688	0.00529
SRR11404533_1_kneaddata_paired	Proteobacteria	22518	P	1756	47	1803	0.00098
SRR11404533_1_kneaddata_paired	Verrucomicrobiota	33333	P	782	55	837	0.00046
SRR11404533_1_kneaddata_paired	Cyanobacteria	9876	P	144	1	145	0.00008
SRR11404533_1_kneaddata_paired	Desulfobacterota_A	11509	P	93	15	108	0.00006
SRR11404533_1_kneaddata_paired	Firmicutes_B	17289	P	45	2	47	0.00003
SRR11404533_1_kneaddata_paired	Campylobacterota	8700	P	15	0	15	0.00001
SRR11404533_1_kneaddata_paired	Spirochaetota	32587	P	11	0	11	0.00001
SRR11404533_1_kneaddata_paired	Firmicutes_C	17613	P	8	0	8	0.00000
SRR11404533_1_kneaddata_paired	Firmicutes_I	18140	P	7	0	7	0.00000
SRR11404533_1_kneaddata_paired	Deferribacterota	10822	P	5	0	5	0.00000
SRR11404534_1_kneaddata_paired	Bacteroidota	4587	P	2377091	18889	2395980	0.68726
SRR11404534_1_kneaddata_paired	Firmicutes_A	14608	P	834631	10483	845114	0.24241
SRR11404534_1_kneaddata_paired	Firmicutes	12188	P	166207	1851	168058	0.04821
SRR11404534_1_kneaddata_paired	Verrucomicrobiota	33333	P	27350	2440	29790	0.00855
SRR11404534_1_kneaddata_paired	Actinobacteriota	615	P	24144	132	24276	0.00696
SRR11404534_1_kneaddata_paired	Proteobacteria	22518	P	13976	456	14432	0.00414
SRR11404534_1_kneaddata_paired	Desulfobacterota_A	11509	P	6552	34	6586	0.00189
SRR11404534_1_kneaddata_paired	Cyanobacteria	9876	P	1673	180	1853	0.00053
SRR11404534_1_kneaddata_paired	Spirochaetota	32587	P	61	0	61	0.00002
SRR11404534_1_kneaddata_paired	Firmicutes_B	17289	P	57	3	60	0.00002
SRR11404534_1_kneaddata_paired	Campylobacterota	8700	P	27	0	27	0.00001
SRR11404534_1_kneaddata_paired	Firmicutes_I	18140	P	14	0	14	0.00000
SRR11404534_1_kneaddata_paired	Deferribacterota	10822	P	5	0	5	0.00000
SRR11404534_1_kneaddata_paired	Firmicutes_C	17613	P	5	0	5	0.00000
SRR11404534_1_kneaddata_paired	Elusimicrobiota	11888	P	2	0	2	0.00000
SRR11404535_1_kneaddata_paired	Bacteroidota	4587	P	3466366	36657	3503023	0.75410
SRR11404535_1_kneaddata_paired	Firmicutes_A	14608	P	892370	11919	904289	0.19467
SRR11404535_1_kneaddata_paired	Firmicutes	12188	P	186500	2423	188923	0.04067
SRR11404535_1_kneaddata_paired	Actinobacteriota	615	P	23486	132	23618	0.00508
SRR11404535_1_kneaddata_paired	Verrucomicrobiota	33333	P	9941	936	10877	0.00234
SRR11404535_1_kneaddata_paired	Proteobacteria	22518	P	8454	284	8738	0.00188
SRR11404535_1_kneaddata_paired	Desulfobacterota_A	11509	P	5021	32	5053	0.00109
SRR11404535_1_kneaddata_paired	Cyanobacteria	9876	P	529	22	551	0.00012
SRR11404535_1_kneaddata_paired	Firmicutes_B	17289	P	85	5	90	0.00002
SRR11404535_1_kneaddata_paired	Spirochaetota	32587	P	45	0	45	0.00001
SRR11404535_1_kneaddata_paired	Campylobacterota	8700	P	32	0	32	0.00001
SRR11404535_1_kneaddata_paired	Firmicutes_I	18140	P	32	0	32	0.00001
SRR11404535_1_kneaddata_paired	Deferribacterota	10822	P	9	0	9	0.00000
SRR11404535_1_kneaddata_paired	Firmicutes_C	17613	P	4	0	4	0.00000
SRR11404535_1_kneaddata_paired	Elusimicrobiota	11888	P	1	0	1	0.00000
SRR11404536_1_kneaddata_paired	Bacteroidota	4587	P	2054170	19821	2073991	0.74096
SRR11404536_1_kneaddata_paired	Firmicutes_A	14608	P	460869	6012	466881	0.16680
SRR11404536_1_kneaddata_paired	Firmicutes	12188	P	182998	1487	184485	0.06591
SRR11404536_1_kneaddata_paired	Actinobacteriota	615	P	27259	185	27444	0.00981
SRR11404536_1_kneaddata_paired	Verrucomicrobiota	33333	P	17805	1637	19442	0.00695
SRR11404536_1_kneaddata_paired	Proteobacteria	22518	P	14802	499	15301	0.00547
SRR11404536_1_kneaddata_paired	Desulfobacterota_A	11509	P	11079	19	11098	0.00397
SRR11404536_1_kneaddata_paired	Cyanobacteria	9876	P	271	10	281	0.00010
SRR11404536_1_kneaddata_paired	Spirochaetota	32587	P	46	0	46	0.00002
SRR11404536_1_kneaddata_paired	Firmicutes_B	17289	P	42	2	44	0.00002
SRR11404536_1_kneaddata_paired	Firmicutes_I	18140	P	16	0	16	0.00001
SRR11404536_1_kneaddata_paired	Campylobacterota	8700	P	15	0	15	0.00001
SRR11404536_1_kneaddata_paired	Firmicutes_C	17613	P	5	0	5	0.00000
SRR11404536_1_kneaddata_paired	Deferribacterota	10822	P	2	0	2	0.00000
SRR11404536_1_kneaddata_paired	Elusimicrobiota	11888	P	1	0	1	0.00000
SRR11404536_1_kneaddata_paired	Thermotogota	33086	P	1	0	1	0.00000
SRR11404537_1_kneaddata_paired	Bacteroidota	4587	P	890311	7065	897376	0.65540
SRR11404537_1_kneaddata_paired	Firmicutes_A	14608	P	324472	4129	328601	0.23999
SRR11404537_1_kneaddata_paired	Firmicutes	12188	P	99382	1002	100384	0.07332
SRR11404537_1_kneaddata_paired	Actinobacteriota	615	P	16724	88	16812	0.01228
SRR11404537_1_kneaddata_paired	Verrucomicrobiota	33333	P	14640	1300	15940	0.01164
SRR11404537_1_kneaddata_paired	Proteobacteria	22518	P	7295	235	7530	0.00550
SRR11404537_1_kneaddata_paired	Desulfobacterota_A	11509	P	1907	8	1915	0.00140
SRR11404537_1_kneaddata_paired	Cyanobacteria	9876	P	511	51	562	0.00041
SRR11404537_1_kneaddata_paired	Firmicutes_B	17289	P	32	1	33	0.00002
SRR11404537_1_kneaddata_paired	Campylobacterota	8700	P	18	0	18	0.00001
SRR11404537_1_kneaddata_paired	Spirochaetota	32587	P	15	0	15	0.00001
SRR11404537_1_kneaddata_paired	Firmicutes_I	18140	P	6	0	6	0.00000
SRR11404537_1_kneaddata_paired	Firmicutes_C	17613	P	5	0	5	0.00000
SRR11404537_1_kneaddata_paired	Elusimicrobiota	11888	P	3	0	3	0.00000
SRR11404538_1_kneaddata_paired	Firmicutes_A	14608	P	1630797	10634	1641431	0.52895
SRR11404538_1_kneaddata_paired	Bacteroidota	4587	P	1204269	4769	1209038	0.38961
SRR11404538_1_kneaddata_paired	Campylobacterota	8700	P	157252	12	157264	0.05068
SRR11404538_1_kneaddata_paired	Verrucomicrobiota	33333	P	43019	2828	45847	0.01477
SRR11404538_1_kneaddata_paired	Firmicutes	12188	P	27480	1100	28580	0.00921
SRR11404538_1_kneaddata_paired	Cyanobacteria	9876	P	9385	13	9398	0.00303
SRR11404538_1_kneaddata_paired	Actinobacteriota	615	P	6374	19	6393	0.00206
SRR11404538_1_kneaddata_paired	Firmicutes_B	17289	P	2655	112	2767	0.00089
SRR11404538_1_kneaddata_paired	Proteobacteria	22518	P	2245	55	2300	0.00074
SRR11404538_1_kneaddata_paired	Desulfobacterota_A	11509	P	106	11	117	0.00004
SRR11404538_1_kneaddata_paired	Firmicutes_I	18140	P	17	0	17	0.00001
SRR11404538_1_kneaddata_paired	Firmicutes_C	17613	P	15	0	15	0.00000
SRR11404538_1_kneaddata_paired	Spirochaetota	32587	P	10	0	10	0.00000
SRR11404538_1_kneaddata_paired	Deferribacterota	10822	P	9	0	9	0.00000
SRR11404538_1_kneaddata_paired	Elusimicrobiota	11888	P	1	0	1	0.00000
SRR11404539_1_kneaddata_paired	Firmicutes_A	14608	P	1255285	8063	1263348	0.51048
SRR11404539_1_kneaddata_paired	Bacteroidota	4587	P	1005169	3842	1009011	0.40771
SRR11404539_1_kneaddata_paired	Campylobacterota	8700	P	125234	9	125243	0.05061
SRR11404539_1_kneaddata_paired	Verrucomicrobiota	33333	P	34913	2250	37163	0.01502
SRR11404539_1_kneaddata_paired	Firmicutes	12188	P	22632	911	23543	0.00951
SRR11404539_1_kneaddata_paired	Cyanobacteria	9876	P	7027	10	7037	0.00284
SRR11404539_1_kneaddata_paired	Actinobacteriota	615	P	5319	16	5335	0.00216
SRR11404539_1_kneaddata_paired	Firmicutes_B	17289	P	2208	91	2299	0.00093
SRR11404539_1_kneaddata_paired	Proteobacteria	22518	P	1643	39	1682	0.00068
SRR11404539_1_kneaddata_paired	Desulfobacterota_A	11509	P	101	12	113	0.00005
SRR11404539_1_kneaddata_paired	Firmicutes_I	18140	P	19	0	19	0.00001
SRR11404539_1_kneaddata_paired	Spirochaetota	32587	P	12	0	12	0.00000
SRR11404539_1_kneaddata_paired	Deferribacterota	10822	P	6	0	6	0.00000
SRR11404539_1_kneaddata_paired	Firmicutes_C	17613	P	6	0	6	0.00000
SRR11404539_1_kneaddata_paired	Elusimicrobiota	11888	P	1	0	1	0.00000
SRR11404540_1_kneaddata_paired	Bacteroidota	4587	P	1044949	4529	1049478	0.56244
SRR11404540_1_kneaddata_paired	Firmicutes_A	14608	P	656083	4977	661060	0.35428
SRR11404540_1_kneaddata_paired	Campylobacterota	8700	P	83369	7	83376	0.04468
SRR11404540_1_kneaddata_paired	Verrucomicrobiota	33333	P	37456	2652	40108	0.02150
SRR11404540_1_kneaddata_paired	Firmicutes	12188	P	20993	718	21711	0.01164
SRR11404540_1_kneaddata_paired	Cyanobacteria	9876	P	3429	6	3435	0.00184
SRR11404540_1_kneaddata_paired	Actinobacteriota	615	P	3344	13	3357	0.00180
SRR11404540_1_kneaddata_paired	Proteobacteria	22518	P	2153	53	2206	0.00118
SRR11404540_1_kneaddata_paired	Firmicutes_B	17289	P	1066	48	1114	0.00060
SRR11404540_1_kneaddata_paired	Desulfobacterota_A	11509	P	45	4	49	0.00003
SRR11404540_1_kneaddata_paired	Firmicutes_I	18140	P	12	0	12	0.00001
SRR11404540_1_kneaddata_paired	Spirochaetota	32587	P	6	0	6	0.00000
SRR11404540_1_kneaddata_paired	Deferribacterota	10822	P	5	0	5	0.00000
SRR11404540_1_kneaddata_paired	Elusimicrobiota	11888	P	2	0	2	0.00000
SRR11404540_1_kneaddata_paired	Firmicutes_C	17613	P	2	0	2	0.00000
SRR11404541_1_kneaddata_paired	Firmicutes_A	14608	P	1238372	8649	1247021	0.65479
SRR11404541_1_kneaddata_paired	Bacteroidota	4587	P	621932	6304	628236	0.32988
SRR11404541_1_kneaddata_paired	Firmicutes	12188	P	21789	408	22197	0.01166
SRR11404541_1_kneaddata_paired	Proteobacteria	22518	P	3143	89	3232	0.00170
SRR11404541_1_kneaddata_paired	Actinobacteriota	615	P	2774	19	2793	0.00147
SRR11404541_1_kneaddata_paired	Verrucomicrobiota	33333	P	417	31	448	0.00024
SRR11404541_1_kneaddata_paired	Cyanobacteria	9876	P	234	6	240	0.00013
SRR11404541_1_kneaddata_paired	Desulfobacterota_A	11509	P	147	24	171	0.00009
SRR11404541_1_kneaddata_paired	Firmicutes_B	17289	P	59	2	61	0.00003
SRR11404541_1_kneaddata_paired	Campylobacterota	8700	P	19	0	19	0.00001
SRR11404541_1_kneaddata_paired	Spirochaetota	32587	P	19	0	19	0.00001
SRR11404541_1_kneaddata_paired	Firmicutes_C	17613	P	10	0	10	0.00001
SRR11404541_1_kneaddata_paired	Firmicutes_I	18140	P	8	0	8	0.00000
SRR11404541_1_kneaddata_paired	Elusimicrobiota	11888	P	3	0	3	0.00000
SRR11404541_1_kneaddata_paired	Deferribacterota	10822	P	1	0	1	0.00000
SRR11404541_1_kneaddata_paired	Thermotogota	33086	P	1	0	1	0.00000
SRR11404542_1_kneaddata_paired	Firmicutes	12188	P	299459	8690	308149	0.73450
SRR11404542_1_kneaddata_paired	Proteobacteria	22518	P	105669	423	106092	0.25288
SRR11404542_1_kneaddata_paired	Firmicutes_A	14608	P	3919	74	3993	0.00952
SRR11404542_1_kneaddata_paired	Bacteroidota	4587	P	891	14	905	0.00216
SRR11404542_1_kneaddata_paired	Cyanobacteria	9876	P	310	2	312	0.00074
SRR11404542_1_kneaddata_paired	Desulfobacterota_A	11509	P	29	10	39	0.00009
SRR11404542_1_kneaddata_paired	Campylobacterota	8700	P	11	0	11	0.00003
SRR11404542_1_kneaddata_paired	Spirochaetota	32587	P	10	0	10	0.00002
SRR11404542_1_kneaddata_paired	Actinobacteriota	615	P	9	0	9	0.00002
SRR11404542_1_kneaddata_paired	Firmicutes_I	18140	P	9	0	9	0.00002
SRR11404542_1_kneaddata_paired	Deferribacterota	10822	P	2	0	2	0.00000
SRR11404542_1_kneaddata_paired	Firmicutes_B	17289	P	2	0	2	0.00001
SRR11404543_1_kneaddata_paired	Bacteroidota	4587	P	657217	6615	663832	0.73753
SRR11404543_1_kneaddata_paired	Firmicutes_A	14608	P	179638	1508	181146	0.20126
SRR11404543_1_kneaddata_paired	Firmicutes	12188	P	29437	141	29578	0.03286
SRR11404543_1_kneaddata_paired	Proteobacteria	22518	P	8615	20	8635	0.00959
SRR11404543_1_kneaddata_paired	Campylobacterota	8700	P	7734	0	7734	0.00859
SRR11404543_1_kneaddata_paired	Actinobacteriota	615	P	7335	18	7353	0.00817
SRR11404543_1_kneaddata_paired	Desulfobacterota_A	11509	P	1473	7	1480	0.00165
SRR11404543_1_kneaddata_paired	Firmicutes_B	17289	P	127	5	132	0.00015
SRR11404543_1_kneaddata_paired	Cyanobacteria	9876	P	86	1	87	0.00010
SRR11404543_1_kneaddata_paired	Verrucomicrobiota	33333	P	67	3	70	0.00008
SRR11404543_1_kneaddata_paired	Deferribacterota	10822	P	13	0	13	0.00001
SRR11404543_1_kneaddata_paired	Spirochaetota	32587	P	8	0	8	0.00001
SRR11404543_1_kneaddata_paired	Firmicutes_I	18140	P	7	0	7	0.00001
SRR11404543_1_kneaddata_paired	Firmicutes_C	17613	P	2	0	2	0.00000
SRR11404544_1_kneaddata_paired	Bacteroidota	4587	P	922629	8754	931383	0.72400
SRR11404544_1_kneaddata_paired	Firmicutes_A	14608	P	250034	2101	252135	0.19599
SRR11404544_1_kneaddata_paired	Firmicutes	12188	P	48349	259	48608	0.03778
SRR11404544_1_kneaddata_paired	Campylobacterota	8700	P	25413	1	25414	0.01976
SRR11404544_1_kneaddata_paired	Proteobacteria	22518	P	14472	33	14505	0.01128
SRR11404544_1_kneaddata_paired	Actinobacteriota	615	P	10704	29	10733	0.00834
SRR11404544_1_kneaddata_paired	Desulfobacterota_A	11509	P	3055	11	3066	0.00238
SRR11404544_1_kneaddata_paired	Firmicutes_B	17289	P	210	8	218	0.00017
SRR11404544_1_kneaddata_paired	Cyanobacteria	9876	P	169	2	171	0.00013
SRR11404544_1_kneaddata_paired	Verrucomicrobiota	33333	P	124	7	131	0.00010
SRR11404544_1_kneaddata_paired	Deferribacterota	10822	P	43	0	43	0.00003
SRR11404544_1_kneaddata_paired	Spirochaetota	32587	P	17	0	17	0.00001
SRR11404544_1_kneaddata_paired	Firmicutes_I	18140	P	8	0	8	0.00001
SRR11404544_1_kneaddata_paired	Firmicutes_C	17613	P	2	0	2	0.00000
SRR11404544_1_kneaddata_paired	Elusimicrobiota	11888	P	1	0	1	0.00000
SRR11404545_1_kneaddata_paired	Bacteroidota	4587	P	641385	6759	648144	0.68906
SRR11404545_1_kneaddata_paired	Firmicutes_A	14608	P	160557	1662	162219	0.17246
SRR11404545_1_kneaddata_paired	Firmicutes	12188	P	54255	264	54519	0.05796
SRR11404545_1_kneaddata_paired	Campylobacterota	8700	P	49693	2	49695	0.05283
SRR11404545_1_kneaddata_paired	Proteobacteria	22518	P	12836	31	12867	0.01368
SRR11404545_1_kneaddata_paired	Actinobacteriota	615	P	11308	40	11348	0.01206
SRR11404545_1_kneaddata_paired	Desulfobacterota_A	11509	P	1356	8	1364	0.00145
SRR11404545_1_kneaddata_paired	Cyanobacteria	9876	P	181	2	183	0.00020
SRR11404545_1_kneaddata_paired	Firmicutes_B	17289	P	105	5	110	0.00012
SRR11404545_1_kneaddata_paired	Verrucomicrobiota	33333	P	76	5	81	0.00009
SRR11404545_1_kneaddata_paired	Deferribacterota	10822	P	70	0	70	0.00007
SRR11404545_1_kneaddata_paired	Spirochaetota	32587	P	11	0	11	0.00001
SRR11404545_1_kneaddata_paired	Firmicutes_I	18140	P	5	0	5	0.00001
SRR11404545_1_kneaddata_paired	Firmicutes_C	17613	P	2	0	2	0.00000
SRR11404546_1_kneaddata_paired	Firmicutes	12188	P	54672	1463	56135	0.90445
SRR11404546_1_kneaddata_paired	Proteobacteria	22518	P	2631	96	2727	0.04395
SRR11404546_1_kneaddata_paired	Firmicutes_A	14608	P	2340	187	2527	0.04073
SRR11404546_1_kneaddata_paired	Bacteroidota	4587	P	474	20	494	0.00798
SRR11404546_1_kneaddata_paired	Cyanobacteria	9876	P	138	1	139	0.00224
SRR11404546_1_kneaddata_paired	Campylobacterota	8700	P	22	0	22	0.00036
SRR11404546_1_kneaddata_paired	Actinobacteriota	615	P	11	0	11	0.00018
SRR11404546_1_kneaddata_paired	Desulfobacterota_A	11509	P	4	0	4	0.00008
SRR11404546_1_kneaddata_paired	Spirochaetota	32587	P	2	0	2	0.00003
SRR11404546_1_kneaddata_paired	Firmicutes_I	18140	P	1	0	1	0.00002
SRR11404547_1_kneaddata_paired	Firmicutes	12188	P	70103	2007	72110	0.91347
SRR11404547_1_kneaddata_paired	Proteobacteria	22518	P	3626	144	3770	0.04776
SRR11404547_1_kneaddata_paired	Firmicutes_A	14608	P	2182	183	2365	0.02997
SRR11404547_1_kneaddata_paired	Bacteroidota	4587	P	510	25	535	0.00678
SRR11404547_1_kneaddata_paired	Cyanobacteria	9876	P	116	1	117	0.00148
SRR11404547_1_kneaddata_paired	Campylobacterota	8700	P	18	0	18	0.00023
SRR11404547_1_kneaddata_paired	Actinobacteriota	615	P	11	0	11	0.00014
SRR11404547_1_kneaddata_paired	Verrucomicrobiota	33333	P	7	0	7	0.00009
SRR11404547_1_kneaddata_paired	Spirochaetota	32587	P	5	0	5	0.00006
SRR11404547_1_kneaddata_paired	Firmicutes_I	18140	P	1	0	1	0.00001
SRR11404548_1_kneaddata_paired	Firmicutes	12188	P	18875	476	19351	0.90007
SRR11404548_1_kneaddata_paired	Firmicutes_A	14608	P	1513	53	1566	0.07286
SRR11404548_1_kneaddata_paired	Bacteroidota	4587	P	404	5	409	0.01907
SRR11404548_1_kneaddata_paired	Cyanobacteria	9876	P	139	0	139	0.00650
SRR11404548_1_kneaddata_paired	Actinobacteriota	615	P	19	0	19	0.00089
SRR11404548_1_kneaddata_paired	Spirochaetota	32587	P	7	0	7	0.00033
SRR11404548_1_kneaddata_paired	Desulfobacterota_A	11509	P	2	0	2	0.00009
SRR11404548_1_kneaddata_paired	Proteobacteria	22518	P	2	0	2	0.00009
SRR11404548_1_kneaddata_paired	Campylobacterota	8700	P	1	0	1	0.00005
SRR11404548_1_kneaddata_paired	Deferribacterota	10822	P	1	0	1	0.00005
SRR11404549_1_kneaddata_paired	Firmicutes	12188	P	4076	79	4155	0.90710
SRR11404549_1_kneaddata_paired	Firmicutes_A	14608	P	318	10	328	0.07173
SRR11404549_1_kneaddata_paired	Bacteroidota	4587	P	67	0	67	0.01479
SRR11404549_1_kneaddata_paired	Cyanobacteria	9876	P	26	0	26	0.00573
SRR11404549_1_kneaddata_paired	Actinobacteriota	615	P	2	0	2	0.00044
SRR11404549_1_kneaddata_paired	Firmicutes_I	18140	P	1	0	1	0.00022
SRR11404550_1_kneaddata_paired	Firmicutes	12188	P	7642	193	7835	0.77710
SRR11404550_1_kneaddata_paired	Firmicutes_A	14608	P	1496	50	1546	0.15338
SRR11404550_1_kneaddata_paired	Bacteroidota	4587	P	533	9	542	0.05376
SRR11404550_1_kneaddata_paired	Cyanobacteria	9876	P	141	0	141	0.01407
SRR11404550_1_kneaddata_paired	Spirochaetota	32587	P	8	0	8	0.00079
SRR11404550_1_kneaddata_paired	Actinobacteriota	615	P	7	0	7	0.00070
SRR11404550_1_kneaddata_paired	Deferribacterota	10822	P	1	0	1	0.00010
SRR11404550_1_kneaddata_paired	Proteobacteria	22518	P	1	0	1	0.00010
SRR11404551_1_kneaddata_paired	Firmicutes	12188	P	330096	10004	340100	0.71335
SRR11404551_1_kneaddata_paired	Proteobacteria	22518	P	122757	393	123150	0.25830
SRR11404551_1_kneaddata_paired	Firmicutes_A	14608	P	9169	776	9945	0.02086
SRR11404551_1_kneaddata_paired	Bacteroidota	4587	P	2581	136	2717	0.00570
SRR11404551_1_kneaddata_paired	Cyanobacteria	9876	P	572	5	577	0.00121
SRR11404551_1_kneaddata_paired	Campylobacterota	8700	P	124	0	124	0.00026
SRR11404551_1_kneaddata_paired	Actinobacteriota	615	P	41	0	41	0.00009
SRR11404551_1_kneaddata_paired	Desulfobacterota_A	11509	P	39	26	65	0.00014
SRR11404551_1_kneaddata_paired	Verrucomicrobiota	33333	P	25	0	25	0.00005
SRR11404551_1_kneaddata_paired	Spirochaetota	32587	P	10	0	10	0.00002
SRR11404551_1_kneaddata_paired	Firmicutes_I	18140	P	8	0	8	0.00002
SRR11404551_1_kneaddata_paired	Firmicutes_B	17289	P	1	0	1	0.00000
SRR11404552_1_kneaddata_paired	Firmicutes	12188	P	84725	2257	86982	0.95940
SRR11404552_1_kneaddata_paired	Firmicutes_A	14608	P	2758	98	2856	0.03150
SRR11404552_1_kneaddata_paired	Bacteroidota	4587	P	577	8	585	0.00646
SRR11404552_1_kneaddata_paired	Cyanobacteria	9876	P	211	1	212	0.00234
SRR11404552_1_kneaddata_paired	Actinobacteriota	615	P	14	0	14	0.00015
SRR11404552_1_kneaddata_paired	Verrucomicrobiota	33333	P	6	0	6	0.00007
SRR11404552_1_kneaddata_paired	Proteobacteria	22518	P	3	0	3	0.00003
SRR11404552_1_kneaddata_paired	Campylobacterota	8700	P	1	0	1	0.00001
SRR11404552_1_kneaddata_paired	Desulfobacterota_A	11509	P	1	0	1	0.00001
SRR11404552_1_kneaddata_paired	Firmicutes_I	18140	P	1	0	1	0.00001
SRR11404552_1_kneaddata_paired	Spirochaetota	32587	P	1	0	1	0.00001
SRR11404553_1_kneaddata_paired	Firmicutes	12188	P	5958	158	6116	0.87659
SRR11404553_1_kneaddata_paired	Firmicutes_A	14608	P	569	16	585	0.08395
SRR11404553_1_kneaddata_paired	Bacteroidota	4587	P	210	3	213	0.03064
SRR11404553_1_kneaddata_paired	Cyanobacteria	9876	P	52	0	52	0.00750
SRR11404553_1_kneaddata_paired	Spirochaetota	32587	P	4	0	4	0.00057
SRR11404553_1_kneaddata_paired	Actinobacteriota	615	P	3	0	3	0.00043
SRR11404553_1_kneaddata_paired	Proteobacteria	22518	P	1	0	1	0.00014
SRR11404553_1_kneaddata_paired	Verrucomicrobiota	33333	P	1	0	1	0.00016
SRR11404554_1_kneaddata_paired	Firmicutes_A	14608	P	348288	2629	350917	0.50341
SRR11404554_1_kneaddata_paired	Bacteroidota	4587	P	305199	3123	308322	0.44231
SRR11404554_1_kneaddata_paired	Firmicutes	12188	P	17176	231	17407	0.02497
SRR11404554_1_kneaddata_paired	Campylobacterota	8700	P	9665	9	9674	0.01388
SRR11404554_1_kneaddata_paired	Deferribacterota	10822	P	3683	16	3699	0.00531
SRR11404554_1_kneaddata_paired	Actinobacteriota	615	P	2915	13	2928	0.00420
SRR11404554_1_kneaddata_paired	Verrucomicrobiota	33333	P	1630	112	1742	0.00250
SRR11404554_1_kneaddata_paired	Desulfobacterota_A	11509	P	1511	7	1518	0.00218
SRR11404554_1_kneaddata_paired	Proteobacteria	22518	P	580	2	582	0.00084
SRR11404554_1_kneaddata_paired	Cyanobacteria	9876	P	227	3	230	0.00033
SRR11404554_1_kneaddata_paired	Firmicutes_B	17289	P	36	1	37	0.00005
SRR11404554_1_kneaddata_paired	Spirochaetota	32587	P	13	0	13	0.00002
SRR11404554_1_kneaddata_paired	Firmicutes_C	17613	P	3	0	3	0.00000
SRR11404554_1_kneaddata_paired	Firmicutes_I	18140	P	2	0	2	0.00000
SRR11404554_1_kneaddata_paired	Thermotogota	33086	P	1	0	1	0.00000
SRR11404555_1_kneaddata_paired	Firmicutes_A	14608	P	504444	4432	508876	0.51807
SRR11404555_1_kneaddata_paired	Bacteroidota	4587	P	411220	4058	415278	0.42278
SRR11404555_1_kneaddata_paired	Firmicutes	12188	P	23092	296	23388	0.02381
SRR11404555_1_kneaddata_paired	Campylobacterota	8700	P	21410	18	21428	0.02182
SRR11404555_1_kneaddata_paired	Deferribacterota	10822	P	4382	18	4400	0.00448
SRR11404555_1_kneaddata_paired	Actinobacteriota	615	P	3282	10	3292	0.00335
SRR11404555_1_kneaddata_paired	Verrucomicrobiota	33333	P	2583	167	2750	0.00280
SRR11404555_1_kneaddata_paired	Desulfobacterota_A	11509	P	1696	6	1702	0.00173
SRR11404555_1_kneaddata_paired	Proteobacteria	22518	P	621	2	623	0.00063
SRR11404555_1_kneaddata_paired	Cyanobacteria	9876	P	448	5	453	0.00046
SRR11404555_1_kneaddata_paired	Firmicutes_B	17289	P	38	1	39	0.00004
SRR11404555_1_kneaddata_paired	Spirochaetota	32587	P	19	0	19	0.00002
SRR11404555_1_kneaddata_paired	Firmicutes_C	17613	P	2	0	2	0.00000
SRR11404555_1_kneaddata_paired	Firmicutes_I	18140	P	2	0	2	0.00000
SRR11404555_1_kneaddata_paired	Elusimicrobiota	11888	P	1	0	1	0.00000
SRR11404556_1_kneaddata_paired	Firmicutes_A	14608	P	1285719	9175	1294894	0.66728
SRR11404556_1_kneaddata_paired	Bacteroidota	4587	P	463153	4085	467238	0.24077
SRR11404556_1_kneaddata_paired	Deferribacterota	10822	P	72368	309	72677	0.03745
SRR11404556_1_kneaddata_paired	Campylobacterota	8700	P	62991	55	63046	0.03249
SRR11404556_1_kneaddata_paired	Firmicutes	12188	P	25104	395	25499	0.01314
SRR11404556_1_kneaddata_paired	Desulfobacterota_A	11509	P	6904	23	6927	0.00357
SRR11404556_1_kneaddata_paired	Actinobacteriota	615	P	5684	19	5703	0.00294
SRR11404556_1_kneaddata_paired	Verrucomicrobiota	33333	P	2278	149	2427	0.00125
SRR11404556_1_kneaddata_paired	Cyanobacteria	9876	P	1040	14	1054	0.00054
SRR11404556_1_kneaddata_paired	Proteobacteria	22518	P	950	3	953	0.00049
SRR11404556_1_kneaddata_paired	Spirochaetota	32587	P	65	0	65	0.00003
SRR11404556_1_kneaddata_paired	Firmicutes_B	17289	P	60	2	62	0.00003
SRR11404556_1_kneaddata_paired	Firmicutes_C	17613	P	8	0	8	0.00000
SRR11404556_1_kneaddata_paired	Firmicutes_I	18140	P	3	0	3	0.00000
SRR11404556_1_kneaddata_paired	Thermotogota	33086	P	2	0	2	0.00000
SRR11404556_1_kneaddata_paired	Elusimicrobiota	11888	P	1	0	1	0.00000
SRR11404557_1_kneaddata_paired	Firmicutes_A	14608	P	1509060	11485	1520545	0.87216
SRR11404557_1_kneaddata_paired	Bacteroidota	4587	P	129654	1222	130876	0.07507
SRR11404557_1_kneaddata_paired	Deferribacterota	10822	P	57620	236	57856	0.03319
SRR11404557_1_kneaddata_paired	Campylobacterota	8700	P	18550	15	18565	0.01065
SRR11404557_1_kneaddata_paired	Firmicutes	12188	P	7177	241	7418	0.00426
SRR11404557_1_kneaddata_paired	Desulfobacterota_A	11509	P	4685	14	4699	0.00270
SRR11404557_1_kneaddata_paired	Actinobacteriota	615	P	1742	8	1750	0.00100
SRR11404557_1_kneaddata_paired	Verrucomicrobiota	33333	P	777	49	826	0.00047
SRR11404557_1_kneaddata_paired	Cyanobacteria	9876	P	415	6	421	0.00024
SRR11404557_1_kneaddata_paired	Proteobacteria	22518	P	346	1	347	0.00020
SRR11404557_1_kneaddata_paired	Spirochaetota	32587	P	69	0	69	0.00004
SRR11404557_1_kneaddata_paired	Firmicutes_B	17289	P	28	1	29	0.00002
SRR11404557_1_kneaddata_paired	Firmicutes_I	18140	P	5	0	5	0.00000
SRR11404557_1_kneaddata_paired	Firmicutes_C	17613	P	4	0	4	0.00000
SRR11404557_1_kneaddata_paired	Elusimicrobiota	11888	P	2	0	2	0.00000
SRR11404557_1_kneaddata_paired	Thermotogota	33086	P	1	0	1	0.00000
SRR11404558_1_kneaddata_paired	Firmicutes_A	14608	P	849894	5860	855754	0.82972
SRR11404558_1_kneaddata_paired	Bacteroidota	4587	P	153425	1443	154868	0.15016
SRR11404558_1_kneaddata_paired	Firmicutes	12188	P	19125	238	19363	0.01877
SRR11404558_1_kneaddata_paired	Actinobacteriota	615	P	599	0	599	0.00058
SRR11404558_1_kneaddata_paired	Verrucomicrobiota	33333	P	325	18	343	0.00033
SRR11404558_1_kneaddata_paired	Cyanobacteria	9876	P	237	2	239	0.00023
SRR11404558_1_kneaddata_paired	Proteobacteria	22518	P	67	1	68	0.00007
SRR11404558_1_kneaddata_paired	Firmicutes_B	17289	P	63	2	65	0.00006
SRR11404558_1_kneaddata_paired	Desulfobacterota_A	11509	P	45	6	51	0.00005
SRR11404558_1_kneaddata_paired	Campylobacterota	8700	P	7	0	7	0.00001
SRR11404558_1_kneaddata_paired	Firmicutes_I	18140	P	5	0	5	0.00000
SRR11404558_1_kneaddata_paired	Spirochaetota	32587	P	3	0	3	0.00000
SRR11404558_1_kneaddata_paired	Elusimicrobiota	11888	P	2	0	2	0.00000
SRR11404558_1_kneaddata_paired	Firmicutes_C	17613	P	2	0	2	0.00000
SRR11404558_1_kneaddata_paired	Deferribacterota	10822	P	1	0	1	0.00000
SRR11404558_1_kneaddata_paired	Thermotogota	33086	P	1	0	1	0.00000
SRR11404559_1_kneaddata_paired	Firmicutes_A	14608	P	699382	4625	704007	0.79260
SRR11404559_1_kneaddata_paired	Bacteroidota	4587	P	169775	1640	171415	0.19299
SRR11404559_1_kneaddata_paired	Firmicutes	12188	P	8764	170	8934	0.01006
SRR11404559_1_kneaddata_paired	Verrucomicrobiota	33333	P	2711	157	2868	0.00323
SRR11404559_1_kneaddata_paired	Actinobacteriota	615	P	589	0	589	0.00066
SRR11404559_1_kneaddata_paired	Cyanobacteria	9876	P	161	2	163	0.00018
SRR11404559_1_kneaddata_paired	Proteobacteria	22518	P	80	2	82	0.00009
SRR11404559_1_kneaddata_paired	Desulfobacterota_A	11509	P	64	9	73	0.00008
SRR11404559_1_kneaddata_paired	Firmicutes_B	17289	P	61	2	63	0.00007
SRR11404559_1_kneaddata_paired	Campylobacterota	8700	P	7	0	7	0.00001
SRR11404559_1_kneaddata_paired	Firmicutes_C	17613	P	5	0	5	0.00001
SRR11404559_1_kneaddata_paired	Firmicutes_I	18140	P	5	0	5	0.00001
SRR11404559_1_kneaddata_paired	Spirochaetota	32587	P	3	0	3	0.00000
SRR11404559_1_kneaddata_paired	Deferribacterota	10822	P	2	0	2	0.00000
SRR11404559_1_kneaddata_paired	Elusimicrobiota	11888	P	1	0	1	0.00000
SRR11404559_1_kneaddata_paired	Thermotogota	33086	P	1	0	1	0.00000
SRR11404560_1_kneaddata_paired	Bacteroidota	4587	P	1027925	11082	1039007	0.77662
SRR11404560_1_kneaddata_paired	Firmicutes_A	14608	P	246585	2920	249505	0.18650
SRR11404560_1_kneaddata_paired	Firmicutes	12188	P	36195	696	36891	0.02758
SRR11404560_1_kneaddata_paired	Actinobacteriota	615	P	11026	25	11051	0.00826
SRR11404560_1_kneaddata_paired	Desulfobacterota_A	11509	P	663	16	679	0.00051
SRR11404560_1_kneaddata_paired	Cyanobacteria	9876	P	406	41	447	0.00033
SRR11404560_1_kneaddata_paired	Proteobacteria	22518	P	174	1	175	0.00013
SRR11404560_1_kneaddata_paired	Firmicutes_B	17289	P	30	1	31	0.00002
SRR11404560_1_kneaddata_paired	Verrucomicrobiota	33333	P	24	1	25	0.00002
SRR11404560_1_kneaddata_paired	Campylobacterota	8700	P	18	0	18	0.00001
SRR11404560_1_kneaddata_paired	Spirochaetota	32587	P	14	0	14	0.00001
SRR11404560_1_kneaddata_paired	Deferribacterota	10822	P	5	0	5	0.00000
SRR11404560_1_kneaddata_paired	Firmicutes_I	18140	P	4	0	4	0.00000
SRR11404560_1_kneaddata_paired	Thermotogota	33086	P	1	0	1	0.00000
SRR11404561_1_kneaddata_paired	Bacteroidota	4587	P	831737	9395	841132	0.76484
SRR11404561_1_kneaddata_paired	Firmicutes_A	14608	P	214500	2710	217210	0.19751
SRR11404561_1_kneaddata_paired	Firmicutes	12188	P	30727	620	31347	0.02850
SRR11404561_1_kneaddata_paired	Actinobacteriota	615	P	8895	24	8919	0.00811
SRR11404561_1_kneaddata_paired	Desulfobacterota_A	11509	P	524	16	540	0.00049
SRR11404561_1_kneaddata_paired	Cyanobacteria	9876	P	318	33	351	0.00032
SRR11404561_1_kneaddata_paired	Proteobacteria	22518	P	142	1	143	0.00013
SRR11404561_1_kneaddata_paired	Verrucomicrobiota	33333	P	37	2	39	0.00004
SRR11404561_1_kneaddata_paired	Firmicutes_B	17289	P	31	1	32	0.00003
SRR11404561_1_kneaddata_paired	Campylobacterota	8700	P	10	0	10	0.00001
SRR11404561_1_kneaddata_paired	Firmicutes_I	18140	P	8	0	8	0.00001
SRR11404561_1_kneaddata_paired	Deferribacterota	10822	P	5	0	5	0.00000
SRR11404561_1_kneaddata_paired	Spirochaetota	32587	P	5	0	5	0.00000
SRR11404561_1_kneaddata_paired	Elusimicrobiota	11888	P	4	0	4	0.00000
SRR11404562_1_kneaddata_paired	Firmicutes	12188	P	449862	14294	464156	0.77812
SRR11404562_1_kneaddata_paired	Proteobacteria	22518	P	118972	354	119326	0.20004
SRR11404562_1_kneaddata_paired	Firmicutes_A	14608	P	8637	749	9386	0.01574
SRR11404562_1_kneaddata_paired	Bacteroidota	4587	P	2657	174	2831	0.00475
SRR11404562_1_kneaddata_paired	Cyanobacteria	9876	P	512	5	517	0.00087
SRR11404562_1_kneaddata_paired	Campylobacterota	8700	P	175	1	176	0.00030
SRR11404562_1_kneaddata_paired	Actinobacteriota	615	P	40	0	40	0.00007
SRR11404562_1_kneaddata_paired	Desulfobacterota_A	11509	P	35	24	59	0.00010
SRR11404562_1_kneaddata_paired	Firmicutes_I	18140	P	9	0	9	0.00002
SRR11404562_1_kneaddata_paired	Spirochaetota	32587	P	4	0	4	0.00001
SRR11404562_1_kneaddata_paired	Firmicutes_B	17289	P	3	0	3	0.00001
SRR11404563_1_kneaddata_paired	Bacteroidota	4587	P	716569	1922	718491	0.72836
SRR11404563_1_kneaddata_paired	Firmicutes_A	14608	P	221929	1191	223120	0.22618
SRR11404563_1_kneaddata_paired	Verrucomicrobiota	33333	P	22223	1141	23364	0.02369
SRR11404563_1_kneaddata_paired	Firmicutes	12188	P	18394	258	18652	0.01891
SRR11404563_1_kneaddata_paired	Actinobacteriota	615	P	2537	4	2541	0.00258
SRR11404563_1_kneaddata_paired	Proteobacteria	22518	P	144	3	147	0.00015
SRR11404563_1_kneaddata_paired	Cyanobacteria	9876	P	69	1	70	0.00007
SRR11404563_1_kneaddata_paired	Desulfobacterota_A	11509	P	26	1	27	0.00003
SRR11404563_1_kneaddata_paired	Firmicutes_B	17289	P	15	0	15	0.00002
SRR11404563_1_kneaddata_paired	Deferribacterota	10822	P	7	0	7	0.00001
SRR11404563_1_kneaddata_paired	Spirochaetota	32587	P	6	0	6	0.00001
SRR11404563_1_kneaddata_paired	Campylobacterota	8700	P	5	0	5	0.00001
SRR11404563_1_kneaddata_paired	Firmicutes_C	17613	P	5	0	5	0.00001
SRR11404563_1_kneaddata_paired	Thermotogota	33086	P	2	0	2	0.00000
SRR11404563_1_kneaddata_paired	Firmicutes_I	18140	P	1	0	1	0.00000
SRR11404564_1_kneaddata_paired	Firmicutes_A	14608	P	682633	4636	687269	0.71473
SRR11404564_1_kneaddata_paired	Bacteroidota	4587	P	175772	4280	180052	0.18725
SRR11404564_1_kneaddata_paired	Firmicutes	12188	P	68555	930	69485	0.07226
SRR11404564_1_kneaddata_paired	Verrucomicrobiota	33333	P	20436	1283	21719	0.02259
SRR11404564_1_kneaddata_paired	Actinobacteriota	615	P	2471	2	2473	0.00257
SRR11404564_1_kneaddata_paired	Cyanobacteria	9876	P	236	4	240	0.00025
SRR11404564_1_kneaddata_paired	Proteobacteria	22518	P	108	2	110	0.00012
SRR11404564_1_kneaddata_paired	Desulfobacterota_A	11509	P	61	7	68	0.00007
SRR11404564_1_kneaddata_paired	Firmicutes_B	17289	P	54	2	56	0.00006
SRR11404564_1_kneaddata_paired	Spirochaetota	32587	P	39	0	39	0.00004
SRR11404564_1_kneaddata_paired	Campylobacterota	8700	P	25	0	25	0.00003
SRR11404564_1_kneaddata_paired	Deferribacterota	10822	P	17	0	17	0.00002
SRR11404564_1_kneaddata_paired	Firmicutes_I	18140	P	10	0	10	0.00001
SRR11404564_1_kneaddata_paired	Firmicutes_C	17613	P	5	0	5	0.00001
SRR11404564_1_kneaddata_paired	Thermotogota	33086	P	1	0	1	0.00000
SRR11404565_1_kneaddata_paired	Firmicutes_A	14608	P	336732	2807	339539	0.73838
SRR11404565_1_kneaddata_paired	Bacteroidota	4587	P	91195	2912	94107	0.20465
SRR11404565_1_kneaddata_paired	Firmicutes	12188	P	20377	380	20757	0.04514
SRR11404565_1_kneaddata_paired	Actinobacteriota	615	P	2974	3	2977	0.00647
SRR11404565_1_kneaddata_paired	Verrucomicrobiota	33333	P	2094	140	2234	0.00486
SRR11404565_1_kneaddata_paired	Cyanobacteria	9876	P	98	3	101	0.00022
SRR11404565_1_kneaddata_paired	Proteobacteria	22518	P	72	2	74	0.00016
SRR11404565_1_kneaddata_paired	Desulfobacterota_A	11509	P	21	3	24	0.00005
SRR11404565_1_kneaddata_paired	Firmicutes_B	17289	P	14	0	14	0.00003
SRR11404565_1_kneaddata_paired	Spirochaetota	32587	P	7	0	7	0.00002
SRR11404565_1_kneaddata_paired	Campylobacterota	8700	P	3	0	3	0.00001
SRR11404565_1_kneaddata_paired	Deferribacterota	10822	P	2	0	2	0.00000
SRR11404565_1_kneaddata_paired	Firmicutes_I	18140	P	2	0	2	0.00000
SRR11404566_1_kneaddata_paired	Firmicutes_A	14608	P	81023	352	81375	0.41935
SRR11404566_1_kneaddata_paired	Bacteroidota	4587	P	66652	796	67448	0.34758
SRR11404566_1_kneaddata_paired	Firmicutes	12188	P	31101	274	31375	0.16169
SRR11404566_1_kneaddata_paired	Verrucomicrobiota	33333	P	12723	668	13391	0.06901
SRR11404566_1_kneaddata_paired	Actinobacteriota	615	P	302	0	302	0.00156
SRR11404566_1_kneaddata_paired	Cyanobacteria	9876	P	83	1	84	0.00044
SRR11404566_1_kneaddata_paired	Proteobacteria	22518	P	13	0	13	0.00007
SRR11404566_1_kneaddata_paired	Desulfobacterota_A	11509	P	12	1	13	0.00007
SRR11404566_1_kneaddata_paired	Firmicutes_B	17289	P	11	0	11	0.00006
SRR11404566_1_kneaddata_paired	Spirochaetota	32587	P	11	0	11	0.00006
SRR11404566_1_kneaddata_paired	Campylobacterota	8700	P	10	0	10	0.00005
SRR11404566_1_kneaddata_paired	Deferribacterota	10822	P	10	0	10	0.00005
SRR11404566_1_kneaddata_paired	Firmicutes_I	18140	P	3	0	3	0.00002
SRR11404566_1_kneaddata_paired	Firmicutes_C	17613	P	1	0	1	0.00001
SRR11404567_1_kneaddata_paired	Bacteroidota	4587	P	1413908	10866	1424774	0.68773
SRR11404567_1_kneaddata_paired	Firmicutes_A	14608	P	542930	4968	547898	0.26447
SRR11404567_1_kneaddata_paired	Firmicutes	12188	P	88303	1302	89605	0.04325
SRR11404567_1_kneaddata_paired	Actinobacteriota	615	P	5848	31	5879	0.00284
SRR11404567_1_kneaddata_paired	Verrucomicrobiota	33333	P	2424	205	2629	0.00127
SRR11404567_1_kneaddata_paired	Proteobacteria	22518	P	409	10	419	0.00020
SRR11404567_1_kneaddata_paired	Cyanobacteria	9876	P	238	8	246	0.00012
SRR11404567_1_kneaddata_paired	Firmicutes_B	17289	P	86	4	90	0.00004
SRR11404567_1_kneaddata_paired	Desulfobacterota_A	11509	P	55	9	64	0.00003
SRR11404567_1_kneaddata_paired	Campylobacterota	8700	P	29	0	29	0.00001
SRR11404567_1_kneaddata_paired	Firmicutes_I	18140	P	21	0	21	0.00001
SRR11404567_1_kneaddata_paired	Spirochaetota	32587	P	19	0	19	0.00001
SRR11404567_1_kneaddata_paired	Deferribacterota	10822	P	18	0	18	0.00001
SRR11404567_1_kneaddata_paired	Thermotogota	33086	P	3	0	3	0.00000
SRR11404567_1_kneaddata_paired	Elusimicrobiota	11888	P	1	0	1	0.00000
SRR11404567_1_kneaddata_paired	Firmicutes_C	17613	P	1	0	1	0.00000
SRR11404568_1_kneaddata_paired	Bacteroidota	4587	P	763081	6338	769419	0.69261
SRR11404568_1_kneaddata_paired	Firmicutes_A	14608	P	293137	2905	296042	0.26649
SRR11404568_1_kneaddata_paired	Firmicutes	12188	P	38248	604	38852	0.03497
SRR11404568_1_kneaddata_paired	Actinobacteriota	615	P	4499	27	4526	0.00407
SRR11404568_1_kneaddata_paired	Verrucomicrobiota	33333	P	1433	134	1567	0.00141
SRR11404568_1_kneaddata_paired	Proteobacteria	22518	P	246	8	254	0.00023
SRR11404568_1_kneaddata_paired	Cyanobacteria	9876	P	106	3	109	0.00010
SRR11404568_1_kneaddata_paired	Firmicutes_B	17289	P	42	2	44	0.00004
SRR11404568_1_kneaddata_paired	Desulfobacterota_A	11509	P	27	5	32	0.00003
SRR11404568_1_kneaddata_paired	Campylobacterota	8700	P	19	0	19	0.00002
SRR11404568_1_kneaddata_paired	Firmicutes_I	18140	P	10	0	10	0.00001
SRR11404568_1_kneaddata_paired	Spirochaetota	32587	P	7	0	7	0.00001
SRR11404568_1_kneaddata_paired	Deferribacterota	10822	P	4	0	4	0.00000
SRR11404568_1_kneaddata_paired	Firmicutes_C	17613	P	3	0	3	0.00000
SRR11404568_1_kneaddata_paired	Elusimicrobiota	11888	P	1	0	1	0.00000
SRR11404568_1_kneaddata_paired	Thermotogota	33086	P	1	0	1	0.00000
SRR11404569_1_kneaddata_paired	Firmicutes_A	14608	P	2708022	21670	2729692	0.69520
SRR11404569_1_kneaddata_paired	Bacteroidota	4587	P	1058052	10118	1068170	0.27204
SRR11404569_1_kneaddata_paired	Firmicutes	12188	P	112364	2407	114771	0.02923
SRR11404569_1_kneaddata_paired	Actinobacteriota	615	P	10611	37	10648	0.00271
SRR11404569_1_kneaddata_paired	Verrucomicrobiota	33333	P	1089	110	1199	0.00031
SRR11404569_1_kneaddata_paired	Cyanobacteria	9876	P	570	20	590	0.00015
SRR11404569_1_kneaddata_paired	Firmicutes_B	17289	P	414	27	441	0.00011
SRR11404569_1_kneaddata_paired	Proteobacteria	22518	P	327	7	334	0.00009
SRR11404569_1_kneaddata_paired	Desulfobacterota_A	11509	P	279	66	345	0.00009
SRR11404569_1_kneaddata_paired	Campylobacterota	8700	P	86	0	86	0.00002
SRR11404569_1_kneaddata_paired	Spirochaetota	32587	P	77	0	77	0.00002
SRR11404569_1_kneaddata_paired	Firmicutes_I	18140	P	41	0	41	0.00001
SRR11404569_1_kneaddata_paired	Deferribacterota	10822	P	35	0	35	0.00001
SRR11404569_1_kneaddata_paired	Firmicutes_C	17613	P	32	0	32	0.00001
SRR11404569_1_kneaddata_paired	Thermotogota	33086	P	4	0	4	0.00000
SRR11404569_1_kneaddata_paired	Elusimicrobiota	11888	P	1	0	1	0.00000
SRR11404570_1_kneaddata_paired	Firmicutes_A	14608	P	3366963	26915	3393878	0.75885
SRR11404570_1_kneaddata_paired	Bacteroidota	4587	P	935409	8697	944106	0.21110
SRR11404570_1_kneaddata_paired	Firmicutes	12188	P	120000	2793	122793	0.02746
SRR11404570_1_kneaddata_paired	Actinobacteriota	615	P	7952	35	7987	0.00179
SRR11404570_1_kneaddata_paired	Verrucomicrobiota	33333	P	1008	102	1110	0.00025
SRR11404570_1_kneaddata_paired	Cyanobacteria	9876	P	862	31	893	0.00020
SRR11404570_1_kneaddata_paired	Firmicutes_B	17289	P	553	36	589	0.00013
SRR11404570_1_kneaddata_paired	Desulfobacterota_A	11509	P	354	85	439	0.00010
SRR11404570_1_kneaddata_paired	Proteobacteria	22518	P	341	6	347	0.00008
SRR11404570_1_kneaddata_paired	Spirochaetota	32587	P	83	0	83	0.00002
SRR11404570_1_kneaddata_paired	Campylobacterota	8700	P	82	0	82	0.00002
SRR11404570_1_kneaddata_paired	Deferribacterota	10822	P	41	0	41	0.00001
SRR11404570_1_kneaddata_paired	Firmicutes_I	18140	P	35	0	35	0.00001
SRR11404570_1_kneaddata_paired	Firmicutes_C	17613	P	34	0	34	0.00001
SRR11404570_1_kneaddata_paired	Thermotogota	33086	P	2	0	2	0.00000
SRR11404571_1_kneaddata_paired	Firmicutes_A	14608	P	1289945	9397	1299342	0.47517
SRR11404571_1_kneaddata_paired	Bacteroidota	4587	P	1251138	11071	1262209	0.46159
SRR11404571_1_kneaddata_paired	Verrucomicrobiota	33333	P	55070	4075	59145	0.02163
SRR11404571_1_kneaddata_paired	Campylobacterota	8700	P	54558	55	54613	0.01997
SRR11404571_1_kneaddata_paired	Firmicutes	12188	P	21003	877	21880	0.00800
SRR11404571_1_kneaddata_paired	Actinobacteriota	615	P	20257	37	20294	0.00742
SRR11404571_1_kneaddata_paired	Desulfobacterota_A	11509	P	12891	56	12947	0.00473
SRR11404571_1_kneaddata_paired	Proteobacteria	22518	P	2929	8	2937	0.00107
SRR11404571_1_kneaddata_paired	Cyanobacteria	9876	P	833	33	866	0.00032
SRR11404571_1_kneaddata_paired	Firmicutes_B	17289	P	109	5	114	0.00004
SRR11404571_1_kneaddata_paired	Spirochaetota	32587	P	102	0	102	0.00004
SRR11404571_1_kneaddata_paired	Firmicutes_I	18140	P	16	0	16	0.00001
SRR11404571_1_kneaddata_paired	Deferribacterota	10822	P	10	0	10	0.00000
SRR11404571_1_kneaddata_paired	Firmicutes_C	17613	P	10	0	10	0.00000
SRR11404571_1_kneaddata_paired	Elusimicrobiota	11888	P	5	0	5	0.00000
SRR11404571_1_kneaddata_paired	Thermotogota	33086	P	5	0	5	0.00000
SRR11404572_1_kneaddata_paired	Bacteroidota	4587	P	1092350	8705	1101055	0.78496
SRR11404572_1_kneaddata_paired	Firmicutes_A	14608	P	175623	2160	177783	0.12675
SRR11404572_1_kneaddata_paired	Verrucomicrobiota	33333	P	59444	5064	64508	0.04599
SRR11404572_1_kneaddata_paired	Campylobacterota	8700	P	27558	32	27590	0.01967
SRR11404572_1_kneaddata_paired	Actinobacteriota	615	P	17257	39	17296	0.01233
SRR11404572_1_kneaddata_paired	Firmicutes	12188	P	8129	180	8309	0.00592
SRR11404572_1_kneaddata_paired	Proteobacteria	22518	P	2910	8	2918	0.00208
SRR11404572_1_kneaddata_paired	Desulfobacterota_A	11509	P	2693	12	2705	0.00193
SRR11404572_1_kneaddata_paired	Cyanobacteria	9876	P	453	32	485	0.00035
SRR11404572_1_kneaddata_paired	Spirochaetota	32587	P	14	0	14	0.00001
SRR11404572_1_kneaddata_paired	Firmicutes_B	17289	P	10	0	10	0.00001
SRR11404572_1_kneaddata_paired	Firmicutes_C	17613	P	3	0	3	0.00000
SRR11404572_1_kneaddata_paired	Firmicutes_I	18140	P	2	0	2	0.00000
SRR11404572_1_kneaddata_paired	Deferribacterota	10822	P	1	0	1	0.00000
SRR11404572_1_kneaddata_paired	Elusimicrobiota	11888	P	1	0	1	0.00000
SRR11404572_1_kneaddata_paired	Thermotogota	33086	P	1	0	1	0.00000
SRR11404573_1_kneaddata_paired	Firmicutes	12188	P	137032	2964	139996	0.66757
SRR11404573_1_kneaddata_paired	Proteobacteria	22518	P	49707	158	49865	0.23778
SRR11404573_1_kneaddata_paired	Actinobacteriota	615	P	17528	51	17579	0.08383
SRR11404573_1_kneaddata_paired	Firmicutes_A	14608	P	1697	36	1733	0.00827
SRR11404573_1_kneaddata_paired	Bacteroidota	4587	P	356	6	362	0.00173
SRR11404573_1_kneaddata_paired	Cyanobacteria	9876	P	118	0	118	0.00057
SRR11404573_1_kneaddata_paired	Desulfobacterota_A	11509	P	20	8	28	0.00014
SRR11404573_1_kneaddata_paired	Campylobacterota	8700	P	9	0	9	0.00004
SRR11404573_1_kneaddata_paired	Firmicutes_I	18140	P	9	0	9	0.00004
SRR11404573_1_kneaddata_paired	Spirochaetota	32587	P	5	0	5	0.00002
SRR11404573_1_kneaddata_paired	Deferribacterota	10822	P	1	0	1	0.00000
SRR11404573_1_kneaddata_paired	Firmicutes_B	17289	P	1	0	1	0.00001
SRR11404574_1_kneaddata_paired	Bacteroidota	4587	P	1388870	25375	1414245	0.59351
SRR11404574_1_kneaddata_paired	Firmicutes_A	14608	P	872190	3824	876014	0.36764
SRR11404574_1_kneaddata_paired	Firmicutes	12188	P	47884	623	48507	0.02036
SRR11404574_1_kneaddata_paired	Proteobacteria	22518	P	14476	331	14807	0.00621
SRR11404574_1_kneaddata_paired	Firmicutes_B	17289	P	13505	533	14038	0.00589
SRR11404574_1_kneaddata_paired	Verrucomicrobiota	33333	P	12719	774	13493	0.00566
SRR11404574_1_kneaddata_paired	Actinobacteriota	615	P	1009	0	1009	0.00042
SRR11404574_1_kneaddata_paired	Cyanobacteria	9876	P	427	17	444	0.00019
SRR11404574_1_kneaddata_paired	Desulfobacterota_A	11509	P	85	12	97	0.00004
SRR11404574_1_kneaddata_paired	Campylobacterota	8700	P	59	0	59	0.00002
SRR11404574_1_kneaddata_paired	Spirochaetota	32587	P	44	0	44	0.00002
SRR11404574_1_kneaddata_paired	Deferribacterota	10822	P	30	0	30	0.00001
SRR11404574_1_kneaddata_paired	Firmicutes_I	18140	P	28	0	28	0.00001
SRR11404574_1_kneaddata_paired	Firmicutes_C	17613	P	7	0	7	0.00000
SRR11404574_1_kneaddata_paired	Thermotogota	33086	P	4	0	4	0.00000
SRR11404574_1_kneaddata_paired	Elusimicrobiota	11888	P	1	0	1	0.00000
SRR11404575_1_kneaddata_paired	Firmicutes_A	14608	P	1472430	6687	1479117	0.57810
SRR11404575_1_kneaddata_paired	Bacteroidota	4587	P	985907	20069	1005976	0.39318
SRR11404575_1_kneaddata_paired	Firmicutes	12188	P	44982	835	45817	0.01791
SRR11404575_1_kneaddata_paired	Firmicutes_B	17289	P	11016	503	11519	0.00450
SRR11404575_1_kneaddata_paired	Proteobacteria	22518	P	8644	226	8870	0.00347
SRR11404575_1_kneaddata_paired	Verrucomicrobiota	33333	P	5389	381	5770	0.00226
SRR11404575_1_kneaddata_paired	Actinobacteriota	615	P	813	0	813	0.00032
SRR11404575_1_kneaddata_paired	Cyanobacteria	9876	P	358	15	373	0.00015
SRR11404575_1_kneaddata_paired	Desulfobacterota_A	11509	P	170	29	199	0.00008
SRR11404575_1_kneaddata_paired	Spirochaetota	32587	P	43	0	43	0.00002
SRR11404575_1_kneaddata_paired	Campylobacterota	8700	P	40	0	40	0.00002
SRR11404575_1_kneaddata_paired	Firmicutes_I	18140	P	18	0	18	0.00001
SRR11404575_1_kneaddata_paired	Deferribacterota	10822	P	14	0	14	0.00001
SRR11404575_1_kneaddata_paired	Firmicutes_C	17613	P	8	0	8	0.00000
SRR11404575_1_kneaddata_paired	Elusimicrobiota	11888	P	3	0	3	0.00000
SRR11404575_1_kneaddata_paired	Thermotogota	33086	P	3	0	3	0.00000
SRR11404576_1_kneaddata_paired	Bacteroidota	4587	P	403992	3553	407545	0.59551
SRR11404576_1_kneaddata_paired	Firmicutes_A	14608	P	259356	1728	261084	0.38150
SRR11404576_1_kneaddata_paired	Firmicutes	12188	P	11269	139	11408	0.01667
SRR11404576_1_kneaddata_paired	Actinobacteriota	615	P	3568	4	3572	0.00522
SRR11404576_1_kneaddata_paired	Verrucomicrobiota	33333	P	409	26	435	0.00064
SRR11404576_1_kneaddata_paired	Cyanobacteria	9876	P	168	2	170	0.00025
SRR11404576_1_kneaddata_paired	Firmicutes_B	17289	P	85	3	88	0.00013
SRR11404576_1_kneaddata_paired	Proteobacteria	22518	P	35	0	35	0.00005
SRR11404576_1_kneaddata_paired	Desulfobacterota_A	11509	P	16	2	18	0.00003
SRR11404576_1_kneaddata_paired	Firmicutes_I	18140	P	4	0	4	0.00001
SRR11404576_1_kneaddata_paired	Thermotogota	33086	P	2	0	2	0.00000
SRR11404576_1_kneaddata_paired	Campylobacterota	8700	P	1	0	1	0.00000
SRR11404576_1_kneaddata_paired	Firmicutes_C	17613	P	1	0	1	0.00000
SRR11404576_1_kneaddata_paired	Spirochaetota	32587	P	1	0	1	0.00000
SRR11404577_1_kneaddata_paired	Firmicutes_A	14608	P	1326966	8661	1335627	0.79155
SRR11404577_1_kneaddata_paired	Bacteroidota	4587	P	339993	4110	344103	0.20393
SRR11404577_1_kneaddata_paired	Firmicutes	12188	P	4192	139	4331	0.00257
SRR11404577_1_kneaddata_paired	Actinobacteriota	615	P	1327	1	1328	0.00079
SRR11404577_1_kneaddata_paired	Firmicutes_B	17289	P	770	34	804	0.00048
SRR11404577_1_kneaddata_paired	Verrucomicrobiota	33333	P	555	36	591	0.00035
SRR11404577_1_kneaddata_paired	Cyanobacteria	9876	P	340	5	345	0.00020
SRR11404577_1_kneaddata_paired	Proteobacteria	22518	P	121	3	124	0.00007
SRR11404577_1_kneaddata_paired	Desulfobacterota_A	11509	P	70	11	81	0.00005
SRR11404577_1_kneaddata_paired	Firmicutes_I	18140	P	10	0	10	0.00001
SRR11404577_1_kneaddata_paired	Firmicutes_C	17613	P	6	0	6	0.00000
SRR11404577_1_kneaddata_paired	Campylobacterota	8700	P	3	0	3	0.00000
SRR11404577_1_kneaddata_paired	Spirochaetota	32587	P	3	0	3	0.00000
SRR11404577_1_kneaddata_paired	Thermotogota	33086	P	3	0	3	0.00000
SRR11404577_1_kneaddata_paired	Deferribacterota	10822	P	1	0	1	0.00000
SRR11404578_1_kneaddata_paired	Bacteroidota	4587	P	412814	2599	415413	0.87861
SRR11404578_1_kneaddata_paired	Firmicutes_A	14608	P	32921	371	33292	0.07041
SRR11404578_1_kneaddata_paired	Firmicutes	12188	P	9693	49	9742	0.02060
SRR11404578_1_kneaddata_paired	Campylobacterota	8700	P	6139	0	6139	0.01298
SRR11404578_1_kneaddata_paired	Proteobacteria	22518	P	5149	7	5156	0.01091
SRR11404578_1_kneaddata_paired	Actinobacteriota	615	P	1175	14	1189	0.00251
SRR11404578_1_kneaddata_paired	Cyanobacteria	9876	P	1145	60	1205	0.00255
SRR11404578_1_kneaddata_paired	Deferribacterota	10822	P	472	1	473	0.00100
SRR11404578_1_kneaddata_paired	Desulfobacterota_A	11509	P	165	1	166	0.00035
SRR11404578_1_kneaddata_paired	Verrucomicrobiota	33333	P	11	0	11	0.00002
SRR11404578_1_kneaddata_paired	Spirochaetota	32587	P	7	0	7	0.00001
SRR11404578_1_kneaddata_paired	Firmicutes_B	17289	P	4	0	4	0.00001
SRR11404578_1_kneaddata_paired	Elusimicrobiota	11888	P	3	0	3	0.00001
SRR11404578_1_kneaddata_paired	Firmicutes_C	17613	P	2	0	2	0.00000
SRR11404578_1_kneaddata_paired	Firmicutes_I	18140	P	2	0	2	0.00000
SRR11404579_1_kneaddata_paired	Bacteroidota	4587	P	746400	5705	752105	0.93885
SRR11404579_1_kneaddata_paired	Firmicutes_A	14608	P	35183	646	35829	0.04473
SRR11404579_1_kneaddata_paired	Verrucomicrobiota	33333	P	6634	583	7217	0.00901
SRR11404579_1_kneaddata_paired	Firmicutes	12188	P	4505	102	4607	0.00575
SRR11404579_1_kneaddata_paired	Actinobacteriota	615	P	491	2	493	0.00062
SRR11404579_1_kneaddata_paired	Proteobacteria	22518	P	346	5	351	0.00044
SRR11404579_1_kneaddata_paired	Desulfobacterota_A	11509	P	292	2	294	0.00037
SRR11404579_1_kneaddata_paired	Cyanobacteria	9876	P	154	10	164	0.00020
SRR11404579_1_kneaddata_paired	Campylobacterota	8700	P	9	0	9	0.00001
SRR11404579_1_kneaddata_paired	Spirochaetota	32587	P	8	0	8	0.00001
SRR11404579_1_kneaddata_paired	Firmicutes_B	17289	P	6	0	6	0.00001
SRR11404579_1_kneaddata_paired	Deferribacterota	10822	P	2	0	2	0.00000
SRR11404579_1_kneaddata_paired	Firmicutes_I	18140	P	1	0	1	0.00000
SRR11404580_1_kneaddata_paired	Firmicutes	12188	P	343293	8687	351980	0.57196
SRR11404580_1_kneaddata_paired	Proteobacteria	22518	P	252548	1507	254055	0.41283
SRR11404580_1_kneaddata_paired	Firmicutes_A	14608	P	5952	325	6277	0.01020
SRR11404580_1_kneaddata_paired	Bacteroidota	4587	P	2077	106	2183	0.00355
SRR11404580_1_kneaddata_paired	Cyanobacteria	9876	P	494	2	496	0.00081
SRR11404580_1_kneaddata_paired	Campylobacterota	8700	P	156	0	156	0.00025
SRR11404580_1_kneaddata_paired	Desulfobacterota_A	11509	P	74	40	114	0.00019
SRR11404580_1_kneaddata_paired	Actinobacteriota	615	P	55	1	56	0.00009
SRR11404580_1_kneaddata_paired	Firmicutes_I	18140	P	47	0	47	0.00008
SRR11404580_1_kneaddata_paired	Spirochaetota	32587	P	21	0	21	0.00003
SRR11404580_1_kneaddata_paired	Firmicutes_B	17289	P	5	0	5	0.00001
SRR11404580_1_kneaddata_paired	Deferribacterota	10822	P	1	0	1	0.00000
SRR11404580_1_kneaddata_paired	Verrucomicrobiota	33333	P	1	0	1	0.00000
SRR11404581_1_kneaddata_paired	Firmicutes	12188	P	447960	11915	459875	0.86117
SRR11404581_1_kneaddata_paired	Proteobacteria	22518	P	62667	1787	64454	0.12070
SRR11404581_1_kneaddata_paired	Firmicutes_A	14608	P	6080	373	6453	0.01209
SRR11404581_1_kneaddata_paired	Bacteroidota	4587	P	2240	146	2386	0.00447
SRR11404581_1_kneaddata_paired	Cyanobacteria	9876	P	485	2	487	0.00091
SRR11404581_1_kneaddata_paired	Campylobacterota	8700	P	184	1	185	0.00035
SRR11404581_1_kneaddata_paired	Actinobacteriota	615	P	72	1	73	0.00014
SRR11404581_1_kneaddata_paired	Firmicutes_I	18140	P	53	0	53	0.00010
SRR11404581_1_kneaddata_paired	Spirochaetota	32587	P	20	0	20	0.00004
SRR11404581_1_kneaddata_paired	Desulfobacterota_A	11509	P	12	6	18	0.00004
SRR11404581_1_kneaddata_paired	Deferribacterota	10822	P	1	0	1	0.00000
SRR11404581_1_kneaddata_paired	Firmicutes_B	17289	P	1	0	1	0.00000
SRR11404582_1_kneaddata_paired	Proteobacteria	22518	P	254328	234	254562	0.73651
SRR11404582_1_kneaddata_paired	Firmicutes	12188	P	84573	2974	87547	0.25330
SRR11404582_1_kneaddata_paired	Firmicutes_A	14608	P	2664	125	2789	0.00807
SRR11404582_1_kneaddata_paired	Bacteroidota	4587	P	405	10	415	0.00120
SRR11404582_1_kneaddata_paired	Cyanobacteria	9876	P	112	0	112	0.00033
SRR11404582_1_kneaddata_paired	Desulfobacterota_A	11509	P	80	44	124	0.00036
SRR11404582_1_kneaddata_paired	Campylobacterota	8700	P	53	0	53	0.00015
SRR11404582_1_kneaddata_paired	Actinobacteriota	615	P	15	0	15	0.00004
SRR11404582_1_kneaddata_paired	Firmicutes_I	18140	P	8	0	8	0.00002
SRR11404582_1_kneaddata_paired	Spirochaetota	32587	P	5	0	5	0.00001
SRR11404583_1_kneaddata_paired	Proteobacteria	22518	P	92372	75	92447	0.90841
SRR11404583_1_kneaddata_paired	Firmicutes	12188	P	4950	177	5127	0.05038
SRR11404583_1_kneaddata_paired	Firmicutes_A	14608	P	3037	164	3201	0.03146
SRR11404583_1_kneaddata_paired	Bacteroidota	4587	P	703	13	716	0.00704
SRR11404583_1_kneaddata_paired	Cyanobacteria	9876	P	188	1	189	0.00186
SRR11404583_1_kneaddata_paired	Desulfobacterota_A	11509	P	33	16	49	0.00048
SRR11404583_1_kneaddata_paired	Actinobacteriota	615	P	14	0	14	0.00014
SRR11404583_1_kneaddata_paired	Campylobacterota	8700	P	14	0	14	0.00014
SRR11404583_1_kneaddata_paired	Spirochaetota	32587	P	6	0	6	0.00006
SRR11404583_1_kneaddata_paired	Firmicutes_I	18140	P	2	0	2	0.00002
SRR11404583_1_kneaddata_paired	Deferribacterota	10822	P	1	0	1	0.00001
SRR11404584_1_kneaddata_paired	Bacteroidota	4587	P	9	0	9	0.33333
SRR11404584_1_kneaddata_paired	Actinobacteriota	615	P	5	0	5	0.18519
SRR11404584_1_kneaddata_paired	Firmicutes	12188	P	5	0	5	0.18519
SRR11404584_1_kneaddata_paired	Proteobacteria	22518	P	5	0	5	0.18519
SRR11404584_1_kneaddata_paired	Firmicutes_A	14608	P	3	0	3	0.11111
SRR11404585_1_kneaddata_paired	Firmicutes	12188	P	238815	5949	244764	0.88882
SRR11404585_1_kneaddata_paired	Proteobacteria	22518	P	24700	446	25146	0.09131
SRR11404585_1_kneaddata_paired	Firmicutes_A	14608	P	3870	256	4126	0.01498
SRR11404585_1_kneaddata_paired	Bacteroidota	4587	P	949	50	999	0.00363
SRR11404585_1_kneaddata_paired	Cyanobacteria	9876	P	212	1	213	0.00077
SRR11404585_1_kneaddata_paired	Campylobacterota	8700	P	70	0	70	0.00026
SRR11404585_1_kneaddata_paired	Actinobacteriota	615	P	17	0	17	0.00006
SRR11404585_1_kneaddata_paired	Firmicutes_I	18140	P	15	0	15	0.00005
SRR11404585_1_kneaddata_paired	Desulfobacterota_A	11509	P	10	4	14	0.00005
SRR11404585_1_kneaddata_paired	Spirochaetota	32587	P	7	0	7	0.00003
SRR11404585_1_kneaddata_paired	Verrucomicrobiota	33333	P	6	0	6	0.00002
SRR11404585_1_kneaddata_paired	Deferribacterota	10822	P	1	0	1	0.00000
SRR11404585_1_kneaddata_paired	Firmicutes_B	17289	P	1	0	1	0.00000
SRR11404586_1_kneaddata_paired	Firmicutes	12188	P	186463	3797	190260	0.62013
SRR11404586_1_kneaddata_paired	Proteobacteria	22518	P	112756	312	113068	0.36853
SRR11404586_1_kneaddata_paired	Firmicutes_A	14608	P	2435	94	2529	0.00824
SRR11404586_1_kneaddata_paired	Bacteroidota	4587	P	614	22	636	0.00207
SRR11404586_1_kneaddata_paired	Cyanobacteria	9876	P	170	1	171	0.00056
SRR11404586_1_kneaddata_paired	Campylobacterota	8700	P	42	0	42	0.00014
SRR11404586_1_kneaddata_paired	Desulfobacterota_A	11509	P	42	19	61	0.00020
SRR11404586_1_kneaddata_paired	Actinobacteriota	615	P	16	0	16	0.00005
SRR11404586_1_kneaddata_paired	Firmicutes_I	18140	P	8	0	8	0.00003
SRR11404586_1_kneaddata_paired	Spirochaetota	32587	P	7	0	7	0.00002
SRR11404586_1_kneaddata_paired	Firmicutes_B	17289	P	5	0	5	0.00002
SRR11404587_1_kneaddata_paired	Firmicutes	12188	P	51709	1503	53212	0.90338
SRR11404587_1_kneaddata_paired	Proteobacteria	22518	P	2324	92	2416	0.04103
SRR11404587_1_kneaddata_paired	Firmicutes_A	14608	P	2151	146	2297	0.03901
SRR11404587_1_kneaddata_paired	Bacteroidota	4587	P	695	30	725	0.01232
SRR11404587_1_kneaddata_paired	Cyanobacteria	9876	P	199	2	201	0.00341
SRR11404587_1_kneaddata_paired	Campylobacterota	8700	P	17	0	17	0.00029
SRR11404587_1_kneaddata_paired	Spirochaetota	32587	P	11	0	11	0.00019
SRR11404587_1_kneaddata_paired	Verrucomicrobiota	33333	P	11	0	11	0.00019
SRR11404587_1_kneaddata_paired	Actinobacteriota	615	P	6	0	6	0.00010
SRR11404587_1_kneaddata_paired	Firmicutes_I	18140	P	3	0	3	0.00005
SRR11404587_1_kneaddata_paired	Deferribacterota	10822	P	1	0	1	0.00002
SRR11404588_1_kneaddata_paired	Firmicutes	12188	P	267289	10219	277508	0.95495
SRR11404588_1_kneaddata_paired	Firmicutes_A	14608	P	4658	453	5111	0.01759
SRR11404588_1_kneaddata_paired	Proteobacteria	22518	P	3922	189	4111	0.01415
SRR11404588_1_kneaddata_paired	Bacteroidota	4587	P	2926	273	3199	0.01101
SRR11404588_1_kneaddata_paired	Cyanobacteria	9876	P	487	4	491	0.00169
SRR11404588_1_kneaddata_paired	Campylobacterota	8700	P	112	1	113	0.00039
SRR11404588_1_kneaddata_paired	Firmicutes_I	18140	P	25	0	25	0.00009
SRR11404588_1_kneaddata_paired	Actinobacteriota	615	P	15	0	15	0.00005
SRR11404588_1_kneaddata_paired	Spirochaetota	32587	P	15	0	15	0.00005
SRR11404588_1_kneaddata_paired	Deferribacterota	10822	P	3	0	3	0.00001
SRR11404588_1_kneaddata_paired	Desulfobacterota_A	11509	P	3	1	4	0.00002
SRR11404588_1_kneaddata_paired	Verrucomicrobiota	33333	P	1	0	1	0.00000
SRR11404589_1_kneaddata_paired	Firmicutes	12188	P	61963	2314	64277	0.89071
SRR11404589_1_kneaddata_paired	Proteobacteria	22518	P	3753	193	3946	0.05469
SRR11404589_1_kneaddata_paired	Firmicutes_A	14608	P	2367	199	2566	0.03556
SRR11404589_1_kneaddata_paired	Bacteroidota	4587	P	1001	74	1075	0.01490
SRR11404589_1_kneaddata_paired	Cyanobacteria	9876	P	219	2	221	0.00307
SRR11404589_1_kneaddata_paired	Campylobacterota	8700	P	36	0	36	0.00050
SRR11404589_1_kneaddata_paired	Firmicutes_I	18140	P	14	0	14	0.00019
SRR11404589_1_kneaddata_paired	Spirochaetota	32587	P	13	0	13	0.00018
SRR11404589_1_kneaddata_paired	Actinobacteriota	615	P	5	0	5	0.00007
SRR11404589_1_kneaddata_paired	Desulfobacterota_A	11509	P	3	2	5	0.00008
SRR11404589_1_kneaddata_paired	Firmicutes_B	17289	P	2	0	2	0.00003
SRR11404590_1_kneaddata_paired	Firmicutes	12188	P	237696	7835	245531	0.91464
SRR11404590_1_kneaddata_paired	Proteobacteria	22518	P	11439	505	11944	0.04449
SRR11404590_1_kneaddata_paired	Firmicutes_A	14608	P	7071	636	7707	0.02871
SRR11404590_1_kneaddata_paired	Bacteroidota	4587	P	2375	165	2540	0.00946
SRR11404590_1_kneaddata_paired	Cyanobacteria	9876	P	490	4	494	0.00184
SRR11404590_1_kneaddata_paired	Campylobacterota	8700	P	80	0	80	0.00030
SRR11404590_1_kneaddata_paired	Actinobacteriota	615	P	67	1	68	0.00025
SRR11404590_1_kneaddata_paired	Firmicutes_I	18140	P	28	0	28	0.00010
SRR11404590_1_kneaddata_paired	Spirochaetota	32587	P	26	0	26	0.00010
SRR11404590_1_kneaddata_paired	Deferribacterota	10822	P	13	0	13	0.00005
SRR11404590_1_kneaddata_paired	Desulfobacterota_A	11509	P	7	4	11	0.00004
SRR11404590_1_kneaddata_paired	Verrucomicrobiota	33333	P	2	0	2	0.00001
SRR11404591_1_kneaddata_paired	Firmicutes	12188	P	237841	7275	245116	0.98813
SRR11404591_1_kneaddata_paired	Firmicutes_A	14608	P	2408	53	2461	0.00992
SRR11404591_1_kneaddata_paired	Bacteroidota	4587	P	337	5	342	0.00138
SRR11404591_1_kneaddata_paired	Cyanobacteria	9876	P	122	0	122	0.00050
SRR11404591_1_kneaddata_paired	Actinobacteriota	615	P	5	0	5	0.00002
SRR11404591_1_kneaddata_paired	Proteobacteria	22518	P	3	0	3	0.00001
SRR11404591_1_kneaddata_paired	Verrucomicrobiota	33333	P	3	0	3	0.00001
SRR11404591_1_kneaddata_paired	Deferribacterota	10822	P	2	0	2	0.00001
SRR11404591_1_kneaddata_paired	Spirochaetota	32587	P	2	0	2	0.00001
SRR11404591_1_kneaddata_paired	Desulfobacterota_A	11509	P	1	0	1	0.00000
SRR11404592_1_kneaddata_paired	Firmicutes	12188	P	188789	5681	194470	0.98479
SRR11404592_1_kneaddata_paired	Firmicutes_A	14608	P	2455	78	2533	0.01283
SRR11404592_1_kneaddata_paired	Bacteroidota	4587	P	334	5	339	0.00172
SRR11404592_1_kneaddata_paired	Cyanobacteria	9876	P	109	0	109	0.00056
SRR11404592_1_kneaddata_paired	Actinobacteriota	615	P	7	0	7	0.00004
SRR11404592_1_kneaddata_paired	Proteobacteria	22518	P	6	0	6	0.00003
SRR11404592_1_kneaddata_paired	Spirochaetota	32587	P	3	0	3	0.00002
SRR11404592_1_kneaddata_paired	Deferribacterota	10822	P	2	0	2	0.00001
SRR11404592_1_kneaddata_paired	Desulfobacterota_A	11509	P	1	0	1	0.00001
SRR11404592_1_kneaddata_paired	Firmicutes_I	18140	P	1	0	1	0.00001
SRR11404593_1_kneaddata_paired	Firmicutes	12188	P	355289	9218	364507	0.93391
SRR11404593_1_kneaddata_paired	Proteobacteria	22518	P	20544	142	20686	0.05300
SRR11404593_1_kneaddata_paired	Firmicutes_A	14608	P	3893	89	3982	0.01020
SRR11404593_1_kneaddata_paired	Bacteroidota	4587	P	723	10	733	0.00188
SRR11404593_1_kneaddata_paired	Cyanobacteria	9876	P	326	1	327	0.00084
SRR11404593_1_kneaddata_paired	Actinobacteriota	615	P	34	0	34	0.00009
SRR11404593_1_kneaddata_paired	Spirochaetota	32587	P	10	0	10	0.00003
SRR11404593_1_kneaddata_paired	Desulfobacterota_A	11509	P	6	1	7	0.00002
SRR11404593_1_kneaddata_paired	Firmicutes_I	18140	P	5	0	5	0.00001
SRR11404593_1_kneaddata_paired	Campylobacterota	8700	P	4	0	4	0.00001
SRR11404593_1_kneaddata_paired	Verrucomicrobiota	33333	P	3	0	3	0.00001
SRR11404593_1_kneaddata_paired	Elusimicrobiota	11888	P	1	0	1	0.00000
SRR11404594_1_kneaddata_paired	Firmicutes_A	14608	P	559907	4142	564049	0.53712
SRR11404594_1_kneaddata_paired	Bacteroidota	4587	P	433453	2518	435971	0.41516
SRR11404594_1_kneaddata_paired	Firmicutes	12188	P	24206	709	24915	0.02373
SRR11404594_1_kneaddata_paired	Actinobacteriota	615	P	13342	107	13449	0.01281
SRR11404594_1_kneaddata_paired	Proteobacteria	22518	P	6693	205	6898	0.00657
SRR11404594_1_kneaddata_paired	Cyanobacteria	9876	P	3250	3	3253	0.00310
SRR11404594_1_kneaddata_paired	Firmicutes_B	17289	P	1124	59	1183	0.00113
SRR11404594_1_kneaddata_paired	Verrucomicrobiota	33333	P	211	16	227	0.00022
SRR11404594_1_kneaddata_paired	Campylobacterota	8700	P	92	0	92	0.00009
SRR11404594_1_kneaddata_paired	Desulfobacterota_A	11509	P	59	10	69	0.00007
SRR11404594_1_kneaddata_paired	Spirochaetota	32587	P	10	0	10	0.00001
SRR11404594_1_kneaddata_paired	Firmicutes_C	17613	P	4	0	4	0.00000
SRR11404594_1_kneaddata_paired	Deferribacterota	10822	P	3	0	3	0.00000
SRR11404594_1_kneaddata_paired	Firmicutes_I	18140	P	3	0	3	0.00000
SRR11404594_1_kneaddata_paired	Elusimicrobiota	11888	P	1	0	1	0.00000
SRR11404594_1_kneaddata_paired	Thermotogota	33086	P	1	0	1	0.00000
SRR11404595_1_kneaddata_paired	Bacteroidota	4587	P	2118191	20348	2138539	0.81803
SRR11404595_1_kneaddata_paired	Firmicutes_A	14608	P	176297	2662	178959	0.06846
SRR11404595_1_kneaddata_paired	Campylobacterota	8700	P	139998	7	140005	0.05355
SRR11404595_1_kneaddata_paired	Firmicutes	12188	P	103684	590	104274	0.03989
SRR11404595_1_kneaddata_paired	Proteobacteria	22518	P	31033	85	31118	0.01190
SRR11404595_1_kneaddata_paired	Actinobacteriota	615	P	17469	61	17530	0.00671
SRR11404595_1_kneaddata_paired	Desulfobacterota_A	11509	P	2945	9	2954	0.00113
SRR11404595_1_kneaddata_paired	Cyanobacteria	9876	P	261	5	266	0.00010
SRR11404595_1_kneaddata_paired	Deferribacterota	10822	P	214	0	214	0.00008
SRR11404595_1_kneaddata_paired	Verrucomicrobiota	33333	P	185	13	198	0.00008
SRR11404595_1_kneaddata_paired	Firmicutes_B	17289	P	139	7	146	0.00006
SRR11404595_1_kneaddata_paired	Spirochaetota	32587	P	23	0	23	0.00001
SRR11404595_1_kneaddata_paired	Firmicutes_I	18140	P	10	0	10	0.00000
SRR11404595_1_kneaddata_paired	Elusimicrobiota	11888	P	3	0	3	0.00000
SRR11404596_1_kneaddata_paired	Bacteroidota	4587	P	2482987	17924	2500911	0.67982
SRR11404596_1_kneaddata_paired	Firmicutes_A	14608	P	939310	11514	950824	0.25846
SRR11404596_1_kneaddata_paired	Firmicutes	12188	P	109669	3172	112841	0.03067
SRR11404596_1_kneaddata_paired	Actinobacteriota	615	P	62279	937	63216	0.01718
SRR11404596_1_kneaddata_paired	Proteobacteria	22518	P	34910	1381	36291	0.00987
SRR11404596_1_kneaddata_paired	Cyanobacteria	9876	P	7347	13	7360	0.00200
SRR11404596_1_kneaddata_paired	Firmicutes_B	17289	P	5681	396	6077	0.00165
SRR11404596_1_kneaddata_paired	Verrucomicrobiota	33333	P	976	102	1078	0.00029
SRR11404596_1_kneaddata_paired	Desulfobacterota_A	11509	P	85	13	98	0.00003
SRR11404596_1_kneaddata_paired	Firmicutes_I	18140	P	19	0	19	0.00001
SRR11404596_1_kneaddata_paired	Campylobacterota	8700	P	17	0	17	0.00000
SRR11404596_1_kneaddata_paired	Spirochaetota	32587	P	15	0	15	0.00000
SRR11404596_1_kneaddata_paired	Deferribacterota	10822	P	10	0	10	0.00000
SRR11404596_1_kneaddata_paired	Firmicutes_C	17613	P	9	0	9	0.00000
SRR11404596_1_kneaddata_paired	Elusimicrobiota	11888	P	5	0	5	0.00000
SRR11404597_1_kneaddata_paired	Firmicutes_A	14608	P	931759	7570	939329	0.61067
SRR11404597_1_kneaddata_paired	Bacteroidota	4587	P	553378	3200	556578	0.36184
SRR11404597_1_kneaddata_paired	Firmicutes	12188	P	19675	549	20224	0.01315
SRR11404597_1_kneaddata_paired	Actinobacteriota	615	P	12032	105	12137	0.00789
SRR11404597_1_kneaddata_paired	Cyanobacteria	9876	P	4789	8	4797	0.00312
SRR11404597_1_kneaddata_paired	Proteobacteria	22518	P	3459	103	3562	0.00232
SRR11404597_1_kneaddata_paired	Firmicutes_B	17289	P	1195	62	1257	0.00082
SRR11404597_1_kneaddata_paired	Verrucomicrobiota	33333	P	170	13	183	0.00012
SRR11404597_1_kneaddata_paired	Desulfobacterota_A	11509	P	73	12	85	0.00006
SRR11404597_1_kneaddata_paired	Spirochaetota	32587	P	15	0	15	0.00001
SRR11404597_1_kneaddata_paired	Firmicutes_I	18140	P	6	0	6	0.00000
SRR11404597_1_kneaddata_paired	Campylobacterota	8700	P	5	0	5	0.00000
SRR11404597_1_kneaddata_paired	Deferribacterota	10822	P	4	0	4	0.00000
SRR11404597_1_kneaddata_paired	Elusimicrobiota	11888	P	3	0	3	0.00000
SRR11404597_1_kneaddata_paired	Firmicutes_C	17613	P	3	0	3	0.00000
SRR11404598_1_kneaddata_paired	Firmicutes_A	14608	P	1312352	8204	1320556	0.70440
SRR11404598_1_kneaddata_paired	Bacteroidota	4587	P	501158	2653	503811	0.26874
SRR11404598_1_kneaddata_paired	Firmicutes	12188	P	25353	480	25833	0.01378
SRR11404598_1_kneaddata_paired	Cyanobacteria	9876	P	10054	11	10065	0.00537
SRR11404598_1_kneaddata_paired	Actinobacteriota	615	P	8853	67	8920	0.00476
SRR11404598_1_kneaddata_paired	Proteobacteria	22518	P	3664	89	3753	0.00200
SRR11404598_1_kneaddata_paired	Firmicutes_B	17289	P	1547	64	1611	0.00086
SRR11404598_1_kneaddata_paired	Verrucomicrobiota	33333	P	85	4	89	0.00005
SRR11404598_1_kneaddata_paired	Desulfobacterota_A	11509	P	39	5	44	0.00002
SRR11404598_1_kneaddata_paired	Spirochaetota	32587	P	10	0	10	0.00001
SRR11404598_1_kneaddata_paired	Firmicutes_I	18140	P	8	0	8	0.00000
SRR11404598_1_kneaddata_paired	Campylobacterota	8700	P	7	0	7	0.00000
SRR11404598_1_kneaddata_paired	Deferribacterota	10822	P	5	0	5	0.00000
SRR11404598_1_kneaddata_paired	Firmicutes_C	17613	P	5	0	5	0.00000
SRR11404598_1_kneaddata_paired	Elusimicrobiota	11888	P	2	0	2	0.00000
SRR11404598_1_kneaddata_paired	Thermotogota	33086	P	1	0	1	0.00000
SRR11404599_1_kneaddata_paired	Firmicutes	12188	P	76625	2549	79174	0.94831
SRR11404599_1_kneaddata_paired	Firmicutes_A	14608	P	1971	140	2111	0.02529
SRR11404599_1_kneaddata_paired	Proteobacteria	22518	P	1120	39	1159	0.01389
SRR11404599_1_kneaddata_paired	Bacteroidota	4587	P	775	46	821	0.00984
SRR11404599_1_kneaddata_paired	Cyanobacteria	9876	P	177	1	178	0.00214
SRR11404599_1_kneaddata_paired	Campylobacterota	8700	P	19	0	19	0.00023
SRR11404599_1_kneaddata_paired	Actinobacteriota	615	P	15	0	15	0.00018
SRR11404599_1_kneaddata_paired	Firmicutes_I	18140	P	4	0	4	0.00005
SRR11404599_1_kneaddata_paired	Spirochaetota	32587	P	3	0	3	0.00004
SRR11404599_1_kneaddata_paired	Verrucomicrobiota	33333	P	2	0	2	0.00002
SRR11404599_1_kneaddata_paired	Desulfobacterota_A	11509	P	1	0	1	0.00002
SRR11404600_1_kneaddata_paired	Firmicutes	12188	P	78713	2708	81421	0.93614
SRR11404600_1_kneaddata_paired	Firmicutes_A	14608	P	2497	204	2701	0.03106
SRR11404600_1_kneaddata_paired	Proteobacteria	22518	P	1379	56	1435	0.01650
SRR11404600_1_kneaddata_paired	Bacteroidota	4587	P	1041	67	1108	0.01275
SRR11404600_1_kneaddata_paired	Cyanobacteria	9876	P	259	2	261	0.00301
SRR11404600_1_kneaddata_paired	Campylobacterota	8700	P	26	0	26	0.00030
SRR11404600_1_kneaddata_paired	Actinobacteriota	615	P	11	0	11	0.00013
SRR11404600_1_kneaddata_paired	Spirochaetota	32587	P	6	0	6	0.00007
SRR11404600_1_kneaddata_paired	Firmicutes_I	18140	P	4	0	4	0.00005
SRR11404601_1_kneaddata_paired	Firmicutes	12188	P	416328	16449	432777	0.57447
SRR11404601_1_kneaddata_paired	Proteobacteria	22518	P	305080	1227	306307	0.40659
SRR11404601_1_kneaddata_paired	Firmicutes_A	14608	P	7176	639	7815	0.01037
SRR11404601_1_kneaddata_paired	Bacteroidota	4587	P	4723	435	5158	0.00685
SRR11404601_1_kneaddata_paired	Cyanobacteria	9876	P	778	6	784	0.00104
SRR11404601_1_kneaddata_paired	Campylobacterota	8700	P	183	1	184	0.00024
SRR11404601_1_kneaddata_paired	Desulfobacterota_A	11509	P	96	83	179	0.00024
SRR11404601_1_kneaddata_paired	Actinobacteriota	615	P	87	0	87	0.00012
SRR11404601_1_kneaddata_paired	Firmicutes_I	18140	P	30	0	30	0.00004
SRR11404601_1_kneaddata_paired	Spirochaetota	32587	P	16	0	16	0.00002
SRR11404601_1_kneaddata_paired	Firmicutes_B	17289	P	8	1	9	0.00001
SRR11404601_1_kneaddata_paired	Verrucomicrobiota	33333	P	4	0	4	0.00001
SRR11404601_1_kneaddata_paired	Deferribacterota	10822	P	1	0	1	0.00000
SRR11404602_1_kneaddata_paired	Proteobacteria	22518	P	285210	161	285371	0.73405
SRR11404602_1_kneaddata_paired	Firmicutes	12188	P	77367	1974	79341	0.20409
SRR11404602_1_kneaddata_paired	Firmicutes_A	14608	P	14610	325	14935	0.03842
SRR11404602_1_kneaddata_paired	Bacteroidota	4587	P	7546	173	7719	0.01986
SRR11404602_1_kneaddata_paired	Campylobacterota	8700	P	409	0	409	0.00105
SRR11404602_1_kneaddata_paired	Cyanobacteria	9876	P	298	2	300	0.00077
SRR11404602_1_kneaddata_paired	Deferribacterota	10822	P	215	2	217	0.00056
SRR11404602_1_kneaddata_paired	Desulfobacterota_A	11509	P	187	43	230	0.00059
SRR11404602_1_kneaddata_paired	Actinobacteriota	615	P	155	1	156	0.00040
SRR11404602_1_kneaddata_paired	Verrucomicrobiota	33333	P	42	7	49	0.00013
SRR11404602_1_kneaddata_paired	Spirochaetota	32587	P	19	0	19	0.00005
SRR11404602_1_kneaddata_paired	Firmicutes_I	18140	P	8	0	8	0.00002
SRR11404602_1_kneaddata_paired	Firmicutes_B	17289	P	2	0	2	0.00001
SRR11404603_1_kneaddata_paired	Proteobacteria	22518	P	121827	81	121908	0.68577
SRR11404603_1_kneaddata_paired	Firmicutes	12188	P	49869	1276	51145	0.28771
SRR11404603_1_kneaddata_paired	Firmicutes_A	14608	P	3308	240	3548	0.01996
SRR11404603_1_kneaddata_paired	Bacteroidota	4587	P	762	29	791	0.00445
SRR11404603_1_kneaddata_paired	Cyanobacteria	9876	P	231	2	233	0.00131
SRR11404603_1_kneaddata_paired	Desulfobacterota_A	11509	P	44	30	74	0.00042
SRR11404603_1_kneaddata_paired	Campylobacterota	8700	P	34	0	34	0.00019
SRR11404603_1_kneaddata_paired	Actinobacteriota	615	P	25	0	25	0.00014
SRR11404603_1_kneaddata_paired	Firmicutes_I	18140	P	3	0	3	0.00002
SRR11404603_1_kneaddata_paired	Spirochaetota	32587	P	3	0	3	0.00002
SRR11404603_1_kneaddata_paired	Deferribacterota	10822	P	1	0	1	0.00001
SRR11404603_1_kneaddata_paired	Firmicutes_B	17289	P	1	0	1	0.00001
SRR11404604_1_kneaddata_paired	Firmicutes_A	14608	P	1510	26	1536	0.46746
SRR11404604_1_kneaddata_paired	Firmicutes	12188	P	1229	6	1235	0.37603
SRR11404604_1_kneaddata_paired	Bacteroidota	4587	P	378	2	380	0.11565
SRR11404604_1_kneaddata_paired	Cyanobacteria	9876	P	115	0	115	0.03507
SRR11404604_1_kneaddata_paired	Actinobacteriota	615	P	10	0	10	0.00304
SRR11404604_1_kneaddata_paired	Proteobacteria	22518	P	4	0	4	0.00122
SRR11404604_1_kneaddata_paired	Verrucomicrobiota	33333	P	3	0	3	0.00092
SRR11404604_1_kneaddata_paired	Spirochaetota	32587	P	2	0	2	0.00061
SRR11404605_1_kneaddata_paired	Firmicutes	12188	P	102748	2886	105634	0.98238
SRR11404605_1_kneaddata_paired	Firmicutes_A	14608	P	1369	31	1400	0.01302
SRR11404605_1_kneaddata_paired	Bacteroidota	4587	P	350	5	355	0.00330
SRR11404605_1_kneaddata_paired	Cyanobacteria	9876	P	117	0	117	0.00110
SRR11404605_1_kneaddata_paired	Proteobacteria	22518	P	11	0	11	0.00010
SRR11404605_1_kneaddata_paired	Actinobacteriota	615	P	7	0	7	0.00007
SRR11404605_1_kneaddata_paired	Spirochaetota	32587	P	2	0	2	0.00002
SRR11404605_1_kneaddata_paired	Firmicutes_I	18140	P	1	0	1	0.00001
SRR11404606_1_kneaddata_paired	Firmicutes_A	14608	P	1313	25	1338	0.62780
SRR11404606_1_kneaddata_paired	Bacteroidota	4587	P	353	2	355	0.16664
SRR11404606_1_kneaddata_paired	Firmicutes	12188	P	274	3	277	0.13028
SRR11404606_1_kneaddata_paired	Cyanobacteria	9876	P	138	0	138	0.06492
SRR11404606_1_kneaddata_paired	Spirochaetota	32587	P	7	0	7	0.00329
SRR11404606_1_kneaddata_paired	Verrucomicrobiota	33333	P	6	0	6	0.00283
SRR11404606_1_kneaddata_paired	Proteobacteria	22518	P	5	0	5	0.00235
SRR11404606_1_kneaddata_paired	Actinobacteriota	615	P	4	0	4	0.00189
SRR11404607_1_kneaddata_paired	Firmicutes	12188	P	278552	8552	287104	0.98747
SRR11404607_1_kneaddata_paired	Firmicutes_A	14608	P	3084	89	3173	0.01092
SRR11404607_1_kneaddata_paired	Bacteroidota	4587	P	319	4	323	0.00111
SRR11404607_1_kneaddata_paired	Cyanobacteria	9876	P	109	0	109	0.00038
SRR11404607_1_kneaddata_paired	Actinobacteriota	615	P	29	0	29	0.00010
SRR11404607_1_kneaddata_paired	Proteobacteria	22518	P	2	0	2	0.00001
SRR11404607_1_kneaddata_paired	Elusimicrobiota	11888	P	1	0	1	0.00000
SRR11404607_1_kneaddata_paired	Firmicutes_C	17613	P	1	0	1	0.00000
SRR11404607_1_kneaddata_paired	Firmicutes_I	18140	P	1	0	1	0.00000
SRR11404607_1_kneaddata_paired	Spirochaetota	32587	P	1	0	1	0.00000
SRR11404608_1_kneaddata_paired	Firmicutes	12188	P	103528	3158	106686	0.97231
SRR11404608_1_kneaddata_paired	Firmicutes_A	14608	P	2355	95	2450	0.02233
SRR11404608_1_kneaddata_paired	Bacteroidota	4587	P	408	6	414	0.00378
SRR11404608_1_kneaddata_paired	Cyanobacteria	9876	P	150	1	151	0.00138
SRR11404608_1_kneaddata_paired	Spirochaetota	32587	P	11	0	11	0.00010
SRR11404608_1_kneaddata_paired	Actinobacteriota	615	P	8	0	8	0.00007
SRR11404608_1_kneaddata_paired	Proteobacteria	22518	P	2	0	2	0.00002
SRR11404608_1_kneaddata_paired	Firmicutes_I	18140	P	1	0	1	0.00001
SRR11404609_1_kneaddata_paired	Firmicutes	12188	P	157769	4762	162531	0.98589
SRR11404609_1_kneaddata_paired	Firmicutes_A	14608	P	1808	41	1849	0.01122
SRR11404609_1_kneaddata_paired	Bacteroidota	4587	P	340	5	345	0.00210
SRR11404609_1_kneaddata_paired	Cyanobacteria	9876	P	119	0	119	0.00073
SRR11404609_1_kneaddata_paired	Actinobacteriota	615	P	4	0	4	0.00002
SRR11404609_1_kneaddata_paired	Proteobacteria	22518	P	3	0	3	0.00002
SRR11404609_1_kneaddata_paired	Spirochaetota	32587	P	3	0	3	0.00002
SRR11404609_1_kneaddata_paired	Campylobacterota	8700	P	2	0	2	0.00001
SRR11404610_1_kneaddata_paired	Firmicutes	12188	P	219776	6947	226723	0.98761
SRR11404610_1_kneaddata_paired	Firmicutes_A	14608	P	2277	49	2326	0.01013
SRR11404610_1_kneaddata_paired	Bacteroidota	4587	P	350	5	355	0.00155
SRR11404610_1_kneaddata_paired	Cyanobacteria	9876	P	134	1	135	0.00059
SRR11404610_1_kneaddata_paired	Actinobacteriota	615	P	10	0	10	0.00004
SRR11404610_1_kneaddata_paired	Spirochaetota	32587	P	7	0	7	0.00003
SRR11404610_1_kneaddata_paired	Proteobacteria	22518	P	4	0	4	0.00002
SRR11404610_1_kneaddata_paired	Verrucomicrobiota	33333	P	4	0	4	0.00002
SRR11404610_1_kneaddata_paired	Campylobacterota	8700	P	1	0	1	0.00000
SRR11404610_1_kneaddata_paired	Deferribacterota	10822	P	1	0	1	0.00000
SRR11404611_1_kneaddata_paired	Firmicutes	12188	P	217504	6487	223991	0.98213
SRR11404611_1_kneaddata_paired	Firmicutes_A	14608	P	2898	96	2994	0.01313
SRR11404611_1_kneaddata_paired	Bacteroidota	4587	P	942	7	949	0.00416
SRR11404611_1_kneaddata_paired	Cyanobacteria	9876	P	110	0	110	0.00049
SRR11404611_1_kneaddata_paired	Proteobacteria	22518	P	13	0	13	0.00006
SRR11404611_1_kneaddata_paired	Actinobacteriota	615	P	4	0	4	0.00002
SRR11404611_1_kneaddata_paired	Spirochaetota	32587	P	2	0	2	0.00001
SRR11404611_1_kneaddata_paired	Campylobacterota	8700	P	1	0	1	0.00000
SRR11404611_1_kneaddata_paired	Firmicutes_I	18140	P	1	0	1	0.00000
SRR11404612_1_kneaddata_paired	Firmicutes	12188	P	101323	3128	104451	0.66577
SRR11404612_1_kneaddata_paired	Proteobacteria	22518	P	46893	152	47045	0.29987
SRR11404612_1_kneaddata_paired	Firmicutes_A	14608	P	3287	214	3501	0.02232
SRR11404612_1_kneaddata_paired	Bacteroidota	4587	P	1348	67	1415	0.00902
SRR11404612_1_kneaddata_paired	Cyanobacteria	9876	P	366	4	370	0.00236
SRR11404612_1_kneaddata_paired	Campylobacterota	8700	P	46	0	46	0.00030
SRR11404612_1_kneaddata_paired	Actinobacteriota	615	P	21	0	21	0.00014
SRR11404612_1_kneaddata_paired	Desulfobacterota_A	11509	P	13	9	22	0.00014
SRR11404612_1_kneaddata_paired	Spirochaetota	32587	P	10	0	10	0.00006
SRR11404612_1_kneaddata_paired	Firmicutes_I	18140	P	3	0	3	0.00002
SRR11404613_1_kneaddata_paired	Proteobacteria	22518	P	135345	266	135611	0.77356
SRR11404613_1_kneaddata_paired	Firmicutes	12188	P	34912	1024	35936	0.20499
SRR11404613_1_kneaddata_paired	Firmicutes_A	14608	P	2936	140	3076	0.01755
SRR11404613_1_kneaddata_paired	Bacteroidota	4587	P	433	20	453	0.00259
SRR11404613_1_kneaddata_paired	Cyanobacteria	9876	P	101	0	101	0.00058
SRR11404613_1_kneaddata_paired	Desulfobacterota_A	11509	P	40	25	65	0.00038
SRR11404613_1_kneaddata_paired	Campylobacterota	8700	P	39	0	39	0.00022
SRR11404613_1_kneaddata_paired	Actinobacteriota	615	P	16	0	16	0.00009
SRR11404613_1_kneaddata_paired	Firmicutes_I	18140	P	4	0	4	0.00002
SRR11404613_1_kneaddata_paired	Spirochaetota	32587	P	3	0	3	0.00002
SRR11404614_1_kneaddata_paired	Firmicutes	12188	P	155155	5116	160271	0.92601
SRR11404614_1_kneaddata_paired	Proteobacteria	22518	P	7147	310	7457	0.04309
SRR11404614_1_kneaddata_paired	Firmicutes_A	14608	P	3277	305	3582	0.02070
SRR11404614_1_kneaddata_paired	Bacteroidota	4587	P	1347	100	1447	0.00836
SRR11404614_1_kneaddata_paired	Cyanobacteria	9876	P	229	2	231	0.00133
SRR11404614_1_kneaddata_paired	Campylobacterota	8700	P	54	0	54	0.00031
SRR11404614_1_kneaddata_paired	Actinobacteriota	615	P	16	0	16	0.00010
SRR11404614_1_kneaddata_paired	Firmicutes_I	18140	P	8	0	8	0.00005
SRR11404614_1_kneaddata_paired	Spirochaetota	32587	P	7	0	7	0.00004
SRR11404614_1_kneaddata_paired	Deferribacterota	10822	P	1	0	1	0.00001
SRR11404614_1_kneaddata_paired	Desulfobacterota_A	11509	P	1	0	1	0.00001
SRR11404615_1_kneaddata_paired	Proteobacteria	22518	P	200743	320	201063	0.52004
SRR11404615_1_kneaddata_paired	Firmicutes	12188	P	173199	6425	179624	0.46459
SRR11404615_1_kneaddata_paired	Firmicutes_A	14608	P	4184	339	4523	0.01170
SRR11404615_1_kneaddata_paired	Bacteroidota	4587	P	976	79	1055	0.00273
SRR11404615_1_kneaddata_paired	Cyanobacteria	9876	P	128	1	129	0.00034
SRR11404615_1_kneaddata_paired	Campylobacterota	8700	P	92	0	92	0.00024
SRR11404615_1_kneaddata_paired	Desulfobacterota_A	11509	P	58	51	109	0.00028
SRR11404615_1_kneaddata_paired	Actinobacteriota	615	P	17	0	17	0.00004
SRR11404615_1_kneaddata_paired	Firmicutes_I	18140	P	7	0	7	0.00002
SRR11404615_1_kneaddata_paired	Spirochaetota	32587	P	4	0	4	0.00001
SRR11404616_1_kneaddata_paired	Proteobacteria	22518	P	184170	174	184344	0.67278
SRR11404616_1_kneaddata_paired	Firmicutes	12188	P	82183	2429	84612	0.30880
SRR11404616_1_kneaddata_paired	Firmicutes_A	14608	P	3792	103	3895	0.01422
SRR11404616_1_kneaddata_paired	Bacteroidota	4587	P	755	16	771	0.00282
SRR11404616_1_kneaddata_paired	Cyanobacteria	9876	P	246	1	247	0.00090
SRR11404616_1_kneaddata_paired	Desulfobacterota_A	11509	P	52	24	76	0.00028
SRR11404616_1_kneaddata_paired	Campylobacterota	8700	P	32	0	32	0.00012
SRR11404616_1_kneaddata_paired	Spirochaetota	32587	P	8	0	8	0.00003
SRR11404616_1_kneaddata_paired	Actinobacteriota	615	P	7	0	7	0.00003
SRR11404616_1_kneaddata_paired	Firmicutes_I	18140	P	4	0	4	0.00001
SRR11404616_1_kneaddata_paired	Firmicutes_B	17289	P	1	0	1	0.00000
SRR11404616_1_kneaddata_paired	Thermotogota	33086	P	1	0	1	0.00000
SRR11404617_1_kneaddata_paired	Firmicutes	12188	P	8337	143	8480	0.60201
SRR11404617_1_kneaddata_paired	Proteobacteria	22518	P	4010	96	4106	0.29152
SRR11404617_1_kneaddata_paired	Firmicutes_A	14608	P	1098	56	1154	0.08197
SRR11404617_1_kneaddata_paired	Bacteroidota	4587	P	247	5	252	0.01790
SRR11404617_1_kneaddata_paired	Cyanobacteria	9876	P	78	0	78	0.00557
SRR11404617_1_kneaddata_paired	Verrucomicrobiota	33333	P	4	0	4	0.00029
SRR11404617_1_kneaddata_paired	Actinobacteriota	615	P	3	0	3	0.00021
SRR11404617_1_kneaddata_paired	Campylobacterota	8700	P	3	0	3	0.00021
SRR11404617_1_kneaddata_paired	Spirochaetota	32587	P	2	0	2	0.00014
SRR11404617_1_kneaddata_paired	Desulfobacterota_A	11509	P	1	0	1	0.00010
SRR11404617_1_kneaddata_paired	Firmicutes_I	18140	P	1	0	1	0.00007
SRR11404618_1_kneaddata_paired	Firmicutes	12188	P	252709	6336	259045	0.78887
SRR11404618_1_kneaddata_paired	Proteobacteria	22518	P	60462	439	60901	0.18546
SRR11404618_1_kneaddata_paired	Firmicutes_A	14608	P	6321	204	6525	0.01987
SRR11404618_1_kneaddata_paired	Bacteroidota	4587	P	1266	18	1284	0.00391
SRR11404618_1_kneaddata_paired	Cyanobacteria	9876	P	511	2	513	0.00156
SRR11404618_1_kneaddata_paired	Actinobacteriota	615	P	43	0	43	0.00013
SRR11404618_1_kneaddata_paired	Firmicutes_I	18140	P	17	0	17	0.00005
SRR11404618_1_kneaddata_paired	Spirochaetota	32587	P	16	0	16	0.00005
SRR11404618_1_kneaddata_paired	Campylobacterota	8700	P	14	0	14	0.00004
SRR11404618_1_kneaddata_paired	Desulfobacterota_A	11509	P	9	2	11	0.00003
SRR11404618_1_kneaddata_paired	Deferribacterota	10822	P	3	0	3	0.00001
SRR11404618_1_kneaddata_paired	Elusimicrobiota	11888	P	1	0	1	0.00000
SRR11404618_1_kneaddata_paired	Thermotogota	33086	P	1	0	1	0.00000
SRR11404619_1_kneaddata_paired	Firmicutes	12188	P	387410	12625	400035	0.81062
SRR11404619_1_kneaddata_paired	Proteobacteria	22518	P	84002	563	84565	0.17136
SRR11404619_1_kneaddata_paired	Firmicutes_A	14608	P	5845	440	6285	0.01274
SRR11404619_1_kneaddata_paired	Bacteroidota	4587	P	1875	131	2006	0.00407
SRR11404619_1_kneaddata_paired	Cyanobacteria	9876	P	350	3	353	0.00072
SRR11404619_1_kneaddata_paired	Campylobacterota	8700	P	155	1	156	0.00032
SRR11404619_1_kneaddata_paired	Desulfobacterota_A	11509	P	29	21	50	0.00010
SRR11404619_1_kneaddata_paired	Actinobacteriota	615	P	11	0	11	0.00002
SRR11404619_1_kneaddata_paired	Firmicutes_I	18140	P	11	0	11	0.00002
SRR11404619_1_kneaddata_paired	Spirochaetota	32587	P	6	0	6	0.00001
SRR11404619_1_kneaddata_paired	Verrucomicrobiota	33333	P	6	0	6	0.00001
SRR11404619_1_kneaddata_paired	Deferribacterota	10822	P	4	0	4	0.00001
SRR11404619_1_kneaddata_paired	Firmicutes_B	17289	P	1	0	1	0.00000
SRR11404619_1_kneaddata_paired	Thermotogota	33086	P	1	0	1	0.00000
SRR11404620_1_kneaddata_paired	Firmicutes	12188	P	62895	1859	64754	0.76806
SRR11404620_1_kneaddata_paired	Proteobacteria	22518	P	15282	61	15343	0.18199
SRR11404620_1_kneaddata_paired	Firmicutes_A	14608	P	2078	167	2245	0.02664
SRR11404620_1_kneaddata_paired	Actinobacteriota	615	P	1129	4	1133	0.01345
SRR11404620_1_kneaddata_paired	Bacteroidota	4587	P	614	28	642	0.00763
SRR11404620_1_kneaddata_paired	Cyanobacteria	9876	P	154	1	155	0.00185
SRR11404620_1_kneaddata_paired	Campylobacterota	8700	P	14	0	14	0.00017
SRR11404620_1_kneaddata_paired	Desulfobacterota_A	11509	P	8	5	13	0.00016
SRR11404620_1_kneaddata_paired	Firmicutes_I	18140	P	3	0	3	0.00004
SRR11404620_1_kneaddata_paired	Spirochaetota	32587	P	2	0	2	0.00002
SRR11404620_1_kneaddata_paired	Deferribacterota	10822	P	1	0	1	0.00001
SRR1648444_1_kneaddata_paired	Bacteroidota	4587	P	37355519	467049	37822568	0.56765
SRR1648444_1_kneaddata_paired	Firmicutes_A	14608	P	18765617	166734	18932351	0.28414
SRR1648444_1_kneaddata_paired	Firmicutes	12188	P	7514229	47120	7561349	0.11348
SRR1648444_1_kneaddata_paired	Campylobacterota	8700	P	652631	136	652767	0.00980
SRR1648444_1_kneaddata_paired	Proteobacteria	22518	P	603744	1363	605107	0.00908
SRR1648444_1_kneaddata_paired	Verrucomicrobiota	33333	P	296317	5288	301605	0.00453
SRR1648444_1_kneaddata_paired	Desulfobacterota_A	11509	P	249079	2890	251969	0.00378
SRR1648444_1_kneaddata_paired	Actinobacteriota	615	P	242166	749	242915	0.00365
SRR1648444_1_kneaddata_paired	Deferribacterota	10822	P	143776	279	144055	0.00216
SRR1648444_1_kneaddata_paired	Cyanobacteria	9876	P	106292	2314	108606	0.00163
SRR1648444_1_kneaddata_paired	Spirochaetota	32587	P	5044	25	5069	0.00008
SRR1648444_1_kneaddata_paired	Firmicutes_B	17289	P	1008	42	1050	0.00002
SRR1648444_1_kneaddata_paired	Firmicutes_I	18140	P	421	0	421	0.00001
SRR1648444_1_kneaddata_paired	Firmicutes_C	17613	P	238	0	238	0.00000
SRR1648444_1_kneaddata_paired	Thermotogota	33086	P	116	0	116	0.00000
SRR1648444_1_kneaddata_paired	Elusimicrobiota	11888	P	57	0	57	0.00000
SRR2167611_1_kneaddata_paired	Bacteroidota	4587	P	14826482	94175	14920657	0.55669
SRR2167611_1_kneaddata_paired	Firmicutes_A	14608	P	9949155	29246	9978401	0.37229
SRR2167611_1_kneaddata_paired	Verrucomicrobiota	33333	P	594605	3234	597839	0.02231
SRR2167611_1_kneaddata_paired	Campylobacterota	8700	P	587679	133	587812	0.02193
SRR2167611_1_kneaddata_paired	Desulfobacterota_A	11509	P	264522	1864	266386	0.00994
SRR2167611_1_kneaddata_paired	Firmicutes	12188	P	145762	1381	147143	0.00549
SRR2167611_1_kneaddata_paired	Proteobacteria	22518	P	139554	107	139661	0.00521
SRR2167611_1_kneaddata_paired	Actinobacteriota	615	P	93708	250	93958	0.00351
SRR2167611_1_kneaddata_paired	Cyanobacteria	9876	P	68716	586	69302	0.00259
SRR2167611_1_kneaddata_paired	Firmicutes_B	17289	P	484	12	496	0.00002
SRR2167611_1_kneaddata_paired	Firmicutes_I	18140	P	231	0	231	0.00001
SRR2167611_1_kneaddata_paired	Spirochaetota	32587	P	230	0	230	0.00001
SRR2167611_1_kneaddata_paired	Firmicutes_C	17613	P	207	0	207	0.00001
SRR2167611_1_kneaddata_paired	Deferribacterota	10822	P	155	0	155	0.00001
SRR2167611_1_kneaddata_paired	Thermotogota	33086	P	50	0	50	0.00000
SRR2167611_1_kneaddata_paired	Elusimicrobiota	11888	P	46	0	46	0.00000
SRR2167614_1_kneaddata_paired	Bacteroidota	4587	P	15536005	96744	15632749	0.61367
SRR2167614_1_kneaddata_paired	Firmicutes_A	14608	P	8733290	25020	8758310	0.34381
SRR2167614_1_kneaddata_paired	Firmicutes	12188	P	298136	1178	299314	0.01175
SRR2167614_1_kneaddata_paired	Campylobacterota	8700	P	264862	82	264944	0.01040
SRR2167614_1_kneaddata_paired	Desulfobacterota_A	11509	P	235061	1762	236823	0.00930
SRR2167614_1_kneaddata_paired	Proteobacteria	22518	P	123748	107	123855	0.00486
SRR2167614_1_kneaddata_paired	Cyanobacteria	9876	P	70130	391	70521	0.00277
SRR2167614_1_kneaddata_paired	Actinobacteriota	615	P	55479	238	55717	0.00219
SRR2167614_1_kneaddata_paired	Deferribacterota	10822	P	26363	3	26366	0.00104
SRR2167614_1_kneaddata_paired	Verrucomicrobiota	33333	P	4120	48	4168	0.00016
SRR2167614_1_kneaddata_paired	Firmicutes_B	17289	P	451	11	462	0.00002
SRR2167614_1_kneaddata_paired	Firmicutes_I	18140	P	311	0	311	0.00001
SRR2167614_1_kneaddata_paired	Spirochaetota	32587	P	288	0	288	0.00001
SRR2167614_1_kneaddata_paired	Firmicutes_C	17613	P	181	0	181	0.00001
SRR2167614_1_kneaddata_paired	Thermotogota	33086	P	54	0	54	0.00000
SRR2167614_1_kneaddata_paired	Elusimicrobiota	11888	P	36	0	36	0.00000
SRR2167615_1_kneaddata_paired	Bacteroidota	4587	P	16440934	98584	16539518	0.67051
SRR2167615_1_kneaddata_paired	Firmicutes_A	14608	P	7099247	20914	7120161	0.28865
SRR2167615_1_kneaddata_paired	Campylobacterota	8700	P	484279	67	484346	0.01964
SRR2167615_1_kneaddata_paired	Desulfobacterota_A	11509	P	210653	1211	211864	0.00859
SRR2167615_1_kneaddata_paired	Proteobacteria	22518	P	114987	113	115100	0.00467
SRR2167615_1_kneaddata_paired	Firmicutes	12188	P	91130	898	92028	0.00373
SRR2167615_1_kneaddata_paired	Cyanobacteria	9876	P	52158	224	52382	0.00212
SRR2167615_1_kneaddata_paired	Actinobacteriota	615	P	49296	95	49391	0.00200
SRR2167615_1_kneaddata_paired	Verrucomicrobiota	33333	P	1139	16	1155	0.00005
SRR2167615_1_kneaddata_paired	Firmicutes_B	17289	P	376	8	384	0.00002
SRR2167615_1_kneaddata_paired	Spirochaetota	32587	P	217	0	217	0.00001
SRR2167615_1_kneaddata_paired	Firmicutes_I	18140	P	190	0	190	0.00001
SRR2167615_1_kneaddata_paired	Firmicutes_C	17613	P	137	0	137	0.00001
SRR2167615_1_kneaddata_paired	Deferribacterota	10822	P	97	0	97	0.00000
SRR2167615_1_kneaddata_paired	Thermotogota	33086	P	62	0	62	0.00000
SRR2167615_1_kneaddata_paired	Elusimicrobiota	11888	P	48	0	48	0.00000
SRR2167616_1_kneaddata_paired	Bacteroidota	4587	P	17086674	86167	17172841	0.62866
SRR2167616_1_kneaddata_paired	Firmicutes_A	14608	P	6165260	33946	6199206	0.22694
SRR2167616_1_kneaddata_paired	Verrucomicrobiota	33333	P	2071459	17035	2088494	0.07646
SRR2167616_1_kneaddata_paired	Firmicutes	12188	P	1052236	15472	1067708	0.03909
SRR2167616_1_kneaddata_paired	Campylobacterota	8700	P	322189	43	322232	0.01180
SRR2167616_1_kneaddata_paired	Actinobacteriota	615	P	220025	1418	221443	0.00811
SRR2167616_1_kneaddata_paired	Proteobacteria	22518	P	133714	198	133912	0.00490
SRR2167616_1_kneaddata_paired	Desulfobacterota_A	11509	P	83074	947	84021	0.00308
SRR2167616_1_kneaddata_paired	Deferribacterota	10822	P	13931	2	13933	0.00051
SRR2167616_1_kneaddata_paired	Cyanobacteria	9876	P	11167	315	11482	0.00042
SRR2167616_1_kneaddata_paired	Firmicutes_I	18140	P	357	0	357	0.00001
SRR2167616_1_kneaddata_paired	Firmicutes_B	17289	P	342	13	355	0.00001
SRR2167616_1_kneaddata_paired	Spirochaetota	32587	P	223	0	223	0.00001
SRR2167616_1_kneaddata_paired	Firmicutes_C	17613	P	139	0	139	0.00001
SRR2167616_1_kneaddata_paired	Thermotogota	33086	P	96	0	96	0.00000
SRR2167616_1_kneaddata_paired	Elusimicrobiota	11888	P	55	0	55	0.00000
SRR2167618_1_kneaddata_paired	Bacteroidota	4587	P	14768084	89070	14857154	0.63726
SRR2167618_1_kneaddata_paired	Firmicutes_A	14608	P	6807453	17014	6824467	0.29272
SRR2167618_1_kneaddata_paired	Campylobacterota	8700	P	714508	79	714587	0.03065
SRR2167618_1_kneaddata_paired	Desulfobacterota_A	11509	P	304582	1726	306308	0.01314
SRR2167618_1_kneaddata_paired	Verrucomicrobiota	33333	P	243349	1039	244388	0.01048
SRR2167618_1_kneaddata_paired	Proteobacteria	22518	P	128006	69	128075	0.00549
SRR2167618_1_kneaddata_paired	Firmicutes	12188	P	125088	1275	126363	0.00542
SRR2167618_1_kneaddata_paired	Cyanobacteria	9876	P	73678	455	74133	0.00318
SRR2167618_1_kneaddata_paired	Actinobacteriota	615	P	37010	76	37086	0.00159
SRR2167618_1_kneaddata_paired	Firmicutes_B	17289	P	522	10	532	0.00002
SRR2167618_1_kneaddata_paired	Spirochaetota	32587	P	257	0	257	0.00001
SRR2167618_1_kneaddata_paired	Firmicutes_I	18140	P	232	0	232	0.00001
SRR2167618_1_kneaddata_paired	Firmicutes_C	17613	P	142	0	142	0.00001
SRR2167618_1_kneaddata_paired	Deferribacterota	10822	P	112	0	112	0.00000
SRR2167618_1_kneaddata_paired	Thermotogota	33086	P	67	0	67	0.00000
SRR2167618_1_kneaddata_paired	Elusimicrobiota	11888	P	52	0	52	0.00000
SRR2174313_1_kneaddata_paired	Firmicutes_A	14608	P	2490427	26513	2516940	0.62932
SRR2174313_1_kneaddata_paired	Bacteroidota	4587	P	1313142	18031	1331173	0.33284
SRR2174313_1_kneaddata_paired	Campylobacterota	8700	P	68364	6	68370	0.01710
SRR2174313_1_kneaddata_paired	Firmicutes	12188	P	25688	1136	26824	0.00671
SRR2174313_1_kneaddata_paired	Deferribacterota	10822	P	15727	149	15876	0.00397
SRR2174313_1_kneaddata_paired	Proteobacteria	22518	P	12548	99	12647	0.00316
SRR2174313_1_kneaddata_paired	Cyanobacteria	9876	P	11238	350	11588	0.00290
SRR2174313_1_kneaddata_paired	Desulfobacterota_A	11509	P	9226	218	9444	0.00236
SRR2174313_1_kneaddata_paired	Actinobacteriota	615	P	5160	24	5184	0.00130
SRR2174313_1_kneaddata_paired	Spirochaetota	32587	P	605	1	606	0.00015
SRR2174313_1_kneaddata_paired	Verrucomicrobiota	33333	P	376	44	420	0.00011
SRR2174313_1_kneaddata_paired	Firmicutes_B	17289	P	246	23	269	0.00007
SRR2174313_1_kneaddata_paired	Firmicutes_I	18140	P	47	0	47	0.00001
SRR2174313_1_kneaddata_paired	Firmicutes_C	17613	P	26	0	26	0.00001
SRR2174313_1_kneaddata_paired	Thermotogota	33086	P	8	0	8	0.00000
SRR2174313_1_kneaddata_paired	Elusimicrobiota	11888	P	1	0	1	0.00000
SRR2174314_1_kneaddata_paired	Bacteroidota	4587	P	7411121	73755	7484876	0.53216
SRR2174314_1_kneaddata_paired	Firmicutes_A	14608	P	6222732	63513	6286245	0.44694
SRR2174314_1_kneaddata_paired	Campylobacterota	8700	P	81834	5	81839	0.00582
SRR2174314_1_kneaddata_paired	Firmicutes	12188	P	65881	1763	67644	0.00481
SRR2174314_1_kneaddata_paired	Desulfobacterota_A	11509	P	61765	397	62162	0.00442
SRR2174314_1_kneaddata_paired	Proteobacteria	22518	P	40433	222	40655	0.00289
SRR2174314_1_kneaddata_paired	Actinobacteriota	615	P	13351	120	13471	0.00096
SRR2174314_1_kneaddata_paired	Cyanobacteria	9876	P	12925	273	13198	0.00094
SRR2174314_1_kneaddata_paired	Verrucomicrobiota	33333	P	8051	822	8873	0.00063
SRR2174314_1_kneaddata_paired	Deferribacterota	10822	P	4488	31	4519	0.00032
SRR2174314_1_kneaddata_paired	Spirochaetota	32587	P	838	1	839	0.00006
SRR2174314_1_kneaddata_paired	Firmicutes_B	17289	P	475	33	508	0.00004
SRR2174314_1_kneaddata_paired	Firmicutes_C	17613	P	137	0	137	0.00001
SRR2174314_1_kneaddata_paired	Firmicutes_I	18140	P	87	0	87	0.00001
SRR2174314_1_kneaddata_paired	Thermotogota	33086	P	11	0	11	0.00000
SRR2174314_1_kneaddata_paired	Elusimicrobiota	11888	P	9	0	9	0.00000
SRR2174315_1_kneaddata_paired	Firmicutes_A	14608	P	3657280	42920	3700200	0.69006
SRR2174315_1_kneaddata_paired	Bacteroidota	4587	P	1447149	20071	1467220	0.27363
SRR2174315_1_kneaddata_paired	Firmicutes	12188	P	61426	2135	63561	0.01185
SRR2174315_1_kneaddata_paired	Campylobacterota	8700	P	48622	4	48626	0.00907
SRR2174315_1_kneaddata_paired	Proteobacteria	22518	P	19977	127	20104	0.00375
SRR2174315_1_kneaddata_paired	Desulfobacterota_A	11509	P	15668	214	15882	0.00296
SRR2174315_1_kneaddata_paired	Cyanobacteria	9876	P	15369	436	15805	0.00295
SRR2174315_1_kneaddata_paired	Actinobacteriota	615	P	13508	66	13574	0.00253
SRR2174315_1_kneaddata_paired	Deferribacterota	10822	P	13067	106	13173	0.00246
SRR2174315_1_kneaddata_paired	Firmicutes_I	18140	P	2099	2	2101	0.00039
SRR2174315_1_kneaddata_paired	Spirochaetota	32587	P	874	1	875	0.00016
SRR2174315_1_kneaddata_paired	Verrucomicrobiota	33333	P	551	56	607	0.00011
SRR2174315_1_kneaddata_paired	Firmicutes_B	17289	P	291	23	314	0.00006
SRR2174315_1_kneaddata_paired	Firmicutes_C	17613	P	52	0	52	0.00001
SRR2174315_1_kneaddata_paired	Thermotogota	33086	P	20	0	20	0.00000
SRR2174315_1_kneaddata_paired	Elusimicrobiota	11888	P	5	0	5	0.00000
SRR2174317_1_kneaddata_paired	Bacteroidota	4587	P	7724496	76498	7800994	0.58423
SRR2174317_1_kneaddata_paired	Firmicutes_A	14608	P	4798330	41380	4839710	0.36246
SRR2174317_1_kneaddata_paired	Desulfobacterota_A	11509	P	184420	398	184818	0.01384
SRR2174317_1_kneaddata_paired	Firmicutes	12188	P	164294	1706	166000	0.01243
SRR2174317_1_kneaddata_paired	Proteobacteria	22518	P	118448	405	118853	0.00890
SRR2174317_1_kneaddata_paired	Campylobacterota	8700	P	98201	6	98207	0.00735
SRR2174317_1_kneaddata_paired	Verrucomicrobiota	33333	P	62725	5713	68438	0.00513
SRR2174317_1_kneaddata_paired	Deferribacterota	10822	P	40518	248	40766	0.00305
SRR2174317_1_kneaddata_paired	Actinobacteriota	615	P	19010	195	19205	0.00144
SRR2174317_1_kneaddata_paired	Cyanobacteria	9876	P	13054	515	13569	0.00102
SRR2174317_1_kneaddata_paired	Spirochaetota	32587	P	1153	1	1154	0.00009
SRR2174317_1_kneaddata_paired	Firmicutes_B	17289	P	532	32	564	0.00004
SRR2174317_1_kneaddata_paired	Firmicutes_C	17613	P	142	0	142	0.00001
SRR2174317_1_kneaddata_paired	Firmicutes_I	18140	P	85	0	85	0.00001
SRR2174317_1_kneaddata_paired	Thermotogota	33086	P	27	0	27	0.00000
SRR2174317_1_kneaddata_paired	Elusimicrobiota	11888	P	12	0	12	0.00000
SRR2665308_1_kneaddata_paired	Proteobacteria	22518	P	3070955	10001	3080956	0.54086
SRR2665308_1_kneaddata_paired	Firmicutes	12188	P	2460949	42221	2503170	0.43943
SRR2665308_1_kneaddata_paired	Firmicutes_A	14608	P	54225	1827	56052	0.00984
SRR2665308_1_kneaddata_paired	Bacteroidota	4587	P	43964	1492	45456	0.00798
SRR2665308_1_kneaddata_paired	Campylobacterota	8700	P	3723	2	3725	0.00065
SRR2665308_1_kneaddata_paired	Cyanobacteria	9876	P	3137	17	3154	0.00055
SRR2665308_1_kneaddata_paired	Actinobacteriota	615	P	2184	11	2195	0.00039
SRR2665308_1_kneaddata_paired	Desulfobacterota_A	11509	P	457	136	593	0.00010
SRR2665308_1_kneaddata_paired	Spirochaetota	32587	P	357	0	357	0.00006
SRR2665308_1_kneaddata_paired	Firmicutes_I	18140	P	305	0	305	0.00005
SRR2665308_1_kneaddata_paired	Verrucomicrobiota	33333	P	287	8	295	0.00005
SRR2665308_1_kneaddata_paired	Firmicutes_B	17289	P	60	6	66	0.00001
SRR2665308_1_kneaddata_paired	Deferribacterota	10822	P	43	0	43	0.00001
SRR2665308_1_kneaddata_paired	Elusimicrobiota	11888	P	4	0	4	0.00000
SRR2665308_1_kneaddata_paired	Firmicutes_C	17613	P	1	0	1	0.00000
SRR2665308_1_kneaddata_paired	Thermotogota	33086	P	1	0	1	0.00000
SRR2665507_1_kneaddata_paired	Proteobacteria	22518	P	659342	5155	664497	0.71297
SRR2665507_1_kneaddata_paired	Firmicutes	12188	P	195031	5515	200546	0.21517
SRR2665507_1_kneaddata_paired	Firmicutes_A	14608	P	45520	1781	47301	0.05075
SRR2665507_1_kneaddata_paired	Bacteroidota	4587	P	11236	250	11486	0.01232
SRR2665507_1_kneaddata_paired	Campylobacterota	8700	P	4429	1	4430	0.00475
SRR2665507_1_kneaddata_paired	Actinobacteriota	615	P	1795	31	1826	0.00196
SRR2665507_1_kneaddata_paired	Cyanobacteria	9876	P	1250	20	1270	0.00136
SRR2665507_1_kneaddata_paired	Verrucomicrobiota	33333	P	209	5	214	0.00023
SRR2665507_1_kneaddata_paired	Spirochaetota	32587	P	162	0	162	0.00017
SRR2665507_1_kneaddata_paired	Desulfobacterota_A	11509	P	105	60	165	0.00018
SRR2665507_1_kneaddata_paired	Firmicutes_I	18140	P	43	0	43	0.00005
SRR2665507_1_kneaddata_paired	Firmicutes_B	17289	P	41	7	48	0.00005
SRR2665507_1_kneaddata_paired	Deferribacterota	10822	P	9	0	9	0.00001
SRR2665507_1_kneaddata_paired	Firmicutes_C	17613	P	5	0	5	0.00001
SRR2665507_1_kneaddata_paired	Thermotogota	33086	P	4	0	4	0.00000
SRR2665507_1_kneaddata_paired	Elusimicrobiota	11888	P	3	0	3	0.00000
SRR3223201_1_kneaddata_paired	Firmicutes_A	14608	P	26915677	42554	26958231	0.50006
SRR3223201_1_kneaddata_paired	Bacteroidota	4587	P	10690080	70757	10760837	0.19961
SRR3223201_1_kneaddata_paired	Firmicutes	12188	P	7858908	93113	7952021	0.14751
SRR3223201_1_kneaddata_paired	Verrucomicrobiota	33333	P	7719913	48981	7768894	0.14411
SRR3223201_1_kneaddata_paired	Proteobacteria	22518	P	345362	257	345619	0.00641
SRR3223201_1_kneaddata_paired	Actinobacteriota	615	P	87435	440	87875	0.00163
SRR3223201_1_kneaddata_paired	Cyanobacteria	9876	P	16713	354	17067	0.00032
SRR3223201_1_kneaddata_paired	Firmicutes_B	17289	P	7070	193	7263	0.00013
SRR3223201_1_kneaddata_paired	Campylobacterota	8700	P	3454	1	3455	0.00006
SRR3223201_1_kneaddata_paired	Desulfobacterota_A	11509	P	3219	87	3306	0.00006
SRR3223201_1_kneaddata_paired	Spirochaetota	32587	P	2606	5	2611	0.00005
SRR3223201_1_kneaddata_paired	Deferribacterota	10822	P	2094	2	2096	0.00004
SRR3223201_1_kneaddata_paired	Firmicutes_I	18140	P	605	0	605	0.00001
SRR3223201_1_kneaddata_paired	Thermotogota	33086	P	92	0	92	0.00000
SRR3223201_1_kneaddata_paired	Firmicutes_C	17613	P	88	0	88	0.00000
SRR3223201_1_kneaddata_paired	Elusimicrobiota	11888	P	27	0	27	0.00000
SRR3223202_1_kneaddata_paired	Firmicutes	12188	P	22165657	132364	22298021	0.49602
SRR3223202_1_kneaddata_paired	Firmicutes_A	14608	P	19443983	26074	19470057	0.43312
SRR3223202_1_kneaddata_paired	Bacteroidota	4587	P	2577594	20782	2598376	0.05780
SRR3223202_1_kneaddata_paired	Actinobacteriota	615	P	497463	2613	500076	0.01112
SRR3223202_1_kneaddata_paired	Verrucomicrobiota	33333	P	73820	284	74104	0.00165
SRR3223202_1_kneaddata_paired	Cyanobacteria	9876	P	4782	40	4822	0.00011
SRR3223202_1_kneaddata_paired	Proteobacteria	22518	P	3077	6	3083	0.00007
SRR3223202_1_kneaddata_paired	Firmicutes_B	17289	P	1528	25	1553	0.00003
SRR3223202_1_kneaddata_paired	Firmicutes_I	18140	P	1060	0	1060	0.00002
SRR3223202_1_kneaddata_paired	Desulfobacterota_A	11509	P	715	37	752	0.00002
SRR3223202_1_kneaddata_paired	Spirochaetota	32587	P	528	0	528	0.00001
SRR3223202_1_kneaddata_paired	Deferribacterota	10822	P	454	0	454	0.00001
SRR3223202_1_kneaddata_paired	Campylobacterota	8700	P	375	0	375	0.00001
SRR3223202_1_kneaddata_paired	Thermotogota	33086	P	160	0	160	0.00000
SRR3223202_1_kneaddata_paired	Firmicutes_C	17613	P	29	0	29	0.00000
SRR3223202_1_kneaddata_paired	Elusimicrobiota	11888	P	5	0	5	0.00000
SRR3539628_kneaddata	Firmicutes_A	14608	P	8409841	35171	8445012	0.61994
SRR3539628_kneaddata	Bacteroidota	4587	P	3619018	20965	3639983	0.26721
SRR3539628_kneaddata	Firmicutes	12188	P	740187	4449	744636	0.05466
SRR3539628_kneaddata	Verrucomicrobiota	33333	P	390661	14320	404981	0.02973
SRR3539628_kneaddata	Actinobacteriota	615	P	149734	200	149934	0.01101
SRR3539628_kneaddata	Deferribacterota	10822	P	81278	193	81471	0.00598
SRR3539628_kneaddata	Cyanobacteria	9876	P	80890	164	81054	0.00595
SRR3539628_kneaddata	Firmicutes_B	17289	P	46712	1090	47802	0.00351
SRR3539628_kneaddata	Proteobacteria	22518	P	14811	28	14839	0.00109
SRR3539628_kneaddata	Desulfobacterota_A	11509	P	10220	375	10595	0.00078
SRR3539628_kneaddata	Spirochaetota	32587	P	1228	3	1231	0.00009
SRR3539628_kneaddata	Campylobacterota	8700	P	408	0	408	0.00003
SRR3539628_kneaddata	Firmicutes_I	18140	P	155	0	155	0.00001
SRR3539628_kneaddata	Firmicutes_C	17613	P	148	0	148	0.00001
SRR3539628_kneaddata	Elusimicrobiota	11888	P	43	0	43	0.00000
SRR3539628_kneaddata	Thermotogota	33086	P	17	0	17	0.00000
SRR3539764_kneaddata	Bacteroidota	4587	P	7844449	37802	7882251	0.49473
SRR3539764_kneaddata	Firmicutes_A	14608	P	6101251	21906	6123157	0.38432
SRR3539764_kneaddata	Firmicutes	12188	P	1021652	4321	1025973	0.06440
SRR3539764_kneaddata	Proteobacteria	22518	P	539117	490	539607	0.03387
SRR3539764_kneaddata	Firmicutes_B	17289	P	171688	3281	174969	0.01098
SRR3539764_kneaddata	Actinobacteriota	615	P	115493	98	115591	0.00726
SRR3539764_kneaddata	Cyanobacteria	9876	P	33666	71	33737	0.00212
SRR3539764_kneaddata	Deferribacterota	10822	P	30411	59	30470	0.00191
SRR3539764_kneaddata	Desulfobacterota_A	11509	P	3116	231	3347	0.00021
SRR3539764_kneaddata	Spirochaetota	32587	P	1596	4	1600	0.00010
SRR3539764_kneaddata	Verrucomicrobiota	33333	P	1085	32	1117	0.00007
SRR3539764_kneaddata	Campylobacterota	8700	P	216	0	216	0.00001
SRR3539764_kneaddata	Firmicutes_C	17613	P	125	0	125	0.00001
SRR3539764_kneaddata	Firmicutes_I	18140	P	102	0	102	0.00001
SRR3539764_kneaddata	Elusimicrobiota	11888	P	14	0	14	0.00000
SRR3539764_kneaddata	Thermotogota	33086	P	8	0	8	0.00000
SRR3539773_kneaddata	Firmicutes_A	14608	P	7587901	29667	7617568	0.55225
SRR3539773_kneaddata	Bacteroidota	4587	P	4979977	29006	5008983	0.36313
SRR3539773_kneaddata	Firmicutes	12188	P	741711	5358	747069	0.05416
SRR3539773_kneaddata	Deferribacterota	10822	P	156702	336	157038	0.01138
SRR3539773_kneaddata	Firmicutes_B	17289	P	98360	2071	100431	0.00728
SRR3539773_kneaddata	Actinobacteriota	615	P	83018	83	83101	0.00602
SRR3539773_kneaddata	Cyanobacteria	9876	P	65222	124	65346	0.00474
SRR3539773_kneaddata	Desulfobacterota_A	11509	P	6346	391	6737	0.00049
SRR3539773_kneaddata	Proteobacteria	22518	P	4547	9	4556	0.00033
SRR3539773_kneaddata	Verrucomicrobiota	33333	P	1275	43	1318	0.00010
SRR3539773_kneaddata	Spirochaetota	32587	P	1051	2	1053	0.00008
SRR3539773_kneaddata	Campylobacterota	8700	P	239	0	239	0.00002
SRR3539773_kneaddata	Firmicutes_I	18140	P	139	0	139	0.00001
SRR3539773_kneaddata	Firmicutes_C	17613	P	135	0	135	0.00001
SRR3539773_kneaddata	Elusimicrobiota	11888	P	19	0	19	0.00000
SRR3539773_kneaddata	Thermotogota	33086	P	11	0	11	0.00000
SRR3539774_kneaddata	Firmicutes_A	14608	P	9734726	30462	9765188	0.48396
SRR3539774_kneaddata	Bacteroidota	4587	P	9728054	85166	9813220	0.48634
SRR3539774_kneaddata	Firmicutes	12188	P	414261	2758	417019	0.02067
SRR3539774_kneaddata	Firmicutes_B	17289	P	102142	2776	104918	0.00520
SRR3539774_kneaddata	Deferribacterota	10822	P	34005	93	34098	0.00169
SRR3539774_kneaddata	Cyanobacteria	9876	P	19477	165	19642	0.00097
SRR3539774_kneaddata	Actinobacteriota	615	P	15079	45	15124	0.00075
SRR3539774_kneaddata	Proteobacteria	22518	P	4924	25	4949	0.00025
SRR3539774_kneaddata	Desulfobacterota_A	11509	P	1496	108	1604	0.00008
SRR3539774_kneaddata	Spirochaetota	32587	P	635	1	636	0.00003
SRR3539774_kneaddata	Campylobacterota	8700	P	560	0	560	0.00003
SRR3539774_kneaddata	Verrucomicrobiota	33333	P	392	14	406	0.00002
SRR3539774_kneaddata	Firmicutes_I	18140	P	171	0	171	0.00001
SRR3539774_kneaddata	Firmicutes_C	17613	P	118	0	118	0.00001
SRR3539774_kneaddata	Thermotogota	33086	P	66	0	66	0.00000
SRR3539774_kneaddata	Elusimicrobiota	11888	P	15	0	15	0.00000
SRR4116657_1_kneaddata_paired	Bacteroidota	4587	P	8580157	72260	8652417	0.66867
SRR4116657_1_kneaddata_paired	Firmicutes_A	14608	P	3028330	20018	3048348	0.23558
SRR4116657_1_kneaddata_paired	Campylobacterota	8700	P	337334	312	337646	0.02609
SRR4116657_1_kneaddata_paired	Firmicutes	12188	P	300875	4631	305506	0.02361
SRR4116657_1_kneaddata_paired	Proteobacteria	22518	P	261679	251	261930	0.02024
SRR4116657_1_kneaddata_paired	Spirochaetota	32587	P	110025	547	110572	0.00855
SRR4116657_1_kneaddata_paired	Desulfobacterota_A	11509	P	95553	552	96105	0.00743
SRR4116657_1_kneaddata_paired	Deferribacterota	10822	P	56898	11	56909	0.00440
SRR4116657_1_kneaddata_paired	Firmicutes_C	17613	P	36499	74	36573	0.00283
SRR4116657_1_kneaddata_paired	Cyanobacteria	9876	P	28485	248	28733	0.00222
SRR4116657_1_kneaddata_paired	Actinobacteriota	615	P	3673	12	3685	0.00028
SRR4116657_1_kneaddata_paired	Verrucomicrobiota	33333	P	671	16	687	0.00005
SRR4116657_1_kneaddata_paired	Firmicutes_B	17289	P	337	11	348	0.00003
SRR4116657_1_kneaddata_paired	Firmicutes_I	18140	P	239	0	239	0.00002
SRR4116657_1_kneaddata_paired	Thermotogota	33086	P	48	0	48	0.00000
SRR4116657_1_kneaddata_paired	Elusimicrobiota	11888	P	25	0	25	0.00000
SRR4116658_1_kneaddata_paired	Bacteroidota	4587	P	7923317	57721	7981038	0.51692
SRR4116658_1_kneaddata_paired	Firmicutes_A	14608	P	6058598	27547	6086145	0.39419
SRR4116658_1_kneaddata_paired	Firmicutes	12188	P	390292	2964	393256	0.02547
SRR4116658_1_kneaddata_paired	Desulfobacterota_A	11509	P	334224	2079	336303	0.02178
SRR4116658_1_kneaddata_paired	Spirochaetota	32587	P	171100	716	171816	0.01113
SRR4116658_1_kneaddata_paired	Campylobacterota	8700	P	139537	109	139646	0.00904
SRR4116658_1_kneaddata_paired	Deferribacterota	10822	P	133672	23	133695	0.00866
SRR4116658_1_kneaddata_paired	Cyanobacteria	9876	P	95126	119	95245	0.00617
SRR4116658_1_kneaddata_paired	Actinobacteriota	615	P	46648	152	46800	0.00303
SRR4116658_1_kneaddata_paired	Proteobacteria	22518	P	45214	106	45320	0.00294
SRR4116658_1_kneaddata_paired	Firmicutes_C	17613	P	8561	14	8575	0.00056
SRR4116658_1_kneaddata_paired	Verrucomicrobiota	33333	P	770	32	802	0.00005
SRR4116658_1_kneaddata_paired	Firmicutes_B	17289	P	655	19	674	0.00004
SRR4116658_1_kneaddata_paired	Firmicutes_I	18140	P	245	0	245	0.00002
SRR4116658_1_kneaddata_paired	Elusimicrobiota	11888	P	22	0	22	0.00000
SRR4116658_1_kneaddata_paired	Thermotogota	33086	P	8	0	8	0.00000
SRR4116659_1_kneaddata_paired	Firmicutes_A	14608	P	10098946	56572	10155518	0.56815
SRR4116659_1_kneaddata_paired	Bacteroidota	4587	P	4560934	16555	4577489	0.25609
SRR4116659_1_kneaddata_paired	Desulfobacterota_A	11509	P	1413508	8717	1422225	0.07957
SRR4116659_1_kneaddata_paired	Deferribacterota	10822	P	668953	123	669076	0.03743
SRR4116659_1_kneaddata_paired	Cyanobacteria	9876	P	247773	363	248136	0.01388
SRR4116659_1_kneaddata_paired	Verrucomicrobiota	33333	P	230362	8082	238444	0.01334
SRR4116659_1_kneaddata_paired	Firmicutes	12188	P	229301	1625	230926	0.01292
SRR4116659_1_kneaddata_paired	Spirochaetota	32587	P	197061	630	197691	0.01106
SRR4116659_1_kneaddata_paired	Campylobacterota	8700	P	84568	3	84571	0.00473
SRR4116659_1_kneaddata_paired	Proteobacteria	22518	P	33860	36	33896	0.00190
SRR4116659_1_kneaddata_paired	Actinobacteriota	615	P	13799	37	13836	0.00077
SRR4116659_1_kneaddata_paired	Firmicutes_B	17289	P	2332	51	2383	0.00013
SRR4116659_1_kneaddata_paired	Firmicutes_I	18140	P	327	0	327	0.00002
SRR4116659_1_kneaddata_paired	Firmicutes_C	17613	P	251	0	251	0.00001
SRR4116659_1_kneaddata_paired	Elusimicrobiota	11888	P	28	0	28	0.00000
SRR4116659_1_kneaddata_paired	Thermotogota	33086	P	17	0	17	0.00000
SRR4116660_1_kneaddata_paired	Firmicutes_A	14608	P	10077902	41247	10119149	0.59402
SRR4116660_1_kneaddata_paired	Bacteroidota	4587	P	5239842	37333	5277175	0.30979
SRR4116660_1_kneaddata_paired	Desulfobacterota_A	11509	P	768874	4771	773645	0.04542
SRR4116660_1_kneaddata_paired	Campylobacterota	8700	P	267122	3	267125	0.01568
SRR4116660_1_kneaddata_paired	Deferribacterota	10822	P	205932	32	205964	0.01209
SRR4116660_1_kneaddata_paired	Firmicutes	12188	P	142666	1048	143714	0.00844
SRR4116660_1_kneaddata_paired	Spirochaetota	32587	P	131625	545	132170	0.00776
SRR4116660_1_kneaddata_paired	Cyanobacteria	9876	P	93951	253	94204	0.00553
SRR4116660_1_kneaddata_paired	Proteobacteria	22518	P	14245	54	14299	0.00084
SRR4116660_1_kneaddata_paired	Verrucomicrobiota	33333	P	3141	142	3283	0.00019
SRR4116660_1_kneaddata_paired	Actinobacteriota	615	P	2674	8	2682	0.00016
SRR4116660_1_kneaddata_paired	Firmicutes_B	17289	P	862	24	886	0.00005
SRR4116660_1_kneaddata_paired	Firmicutes_C	17613	P	352	0	352	0.00002
SRR4116660_1_kneaddata_paired	Firmicutes_I	18140	P	221	0	221	0.00001
SRR4116660_1_kneaddata_paired	Elusimicrobiota	11888	P	29	0	29	0.00000
SRR4116660_1_kneaddata_paired	Thermotogota	33086	P	18	0	18	0.00000
SRR4116661_1_kneaddata_paired	Firmicutes_A	14608	P	10704325	45358	10749683	0.70417
SRR4116661_1_kneaddata_paired	Bacteroidota	4587	P	3004225	33994	3038219	0.19902
SRR4116661_1_kneaddata_paired	Desulfobacterota_A	11509	P	686451	5093	691544	0.04530
SRR4116661_1_kneaddata_paired	Campylobacterota	8700	P	300525	24	300549	0.01969
SRR4116661_1_kneaddata_paired	Deferribacterota	10822	P	268350	48	268398	0.01758
SRR4116661_1_kneaddata_paired	Firmicutes	12188	P	102169	1242	103411	0.00677
SRR4116661_1_kneaddata_paired	Spirochaetota	32587	P	78519	344	78863	0.00517
SRR4116661_1_kneaddata_paired	Proteobacteria	22518	P	16396	34	16430	0.00108
SRR4116661_1_kneaddata_paired	Cyanobacteria	9876	P	7432	38	7470	0.00049
SRR4116661_1_kneaddata_paired	Actinobacteriota	615	P	6763	26	6789	0.00044
SRR4116661_1_kneaddata_paired	Verrucomicrobiota	33333	P	2827	133	2960	0.00019
SRR4116661_1_kneaddata_paired	Firmicutes_B	17289	P	807	24	831	0.00005
SRR4116661_1_kneaddata_paired	Firmicutes_I	18140	P	320	0	320	0.00002
SRR4116661_1_kneaddata_paired	Firmicutes_C	17613	P	272	0	272	0.00002
SRR4116661_1_kneaddata_paired	Thermotogota	33086	P	15	0	15	0.00000
SRR4116661_1_kneaddata_paired	Elusimicrobiota	11888	P	12	0	12	0.00000
SRR4116662_1_kneaddata_paired	Firmicutes_A	14608	P	13454596	49365	13503961	0.60890
SRR4116662_1_kneaddata_paired	Bacteroidota	4587	P	5689178	38865	5728043	0.25828
SRR4116662_1_kneaddata_paired	Desulfobacterota_A	11509	P	1463163	7429	1470592	0.06631
SRR4116662_1_kneaddata_paired	Campylobacterota	8700	P	614473	9	614482	0.02771
SRR4116662_1_kneaddata_paired	Deferribacterota	10822	P	351294	49	351343	0.01584
SRR4116662_1_kneaddata_paired	Spirochaetota	32587	P	286543	1079	287622	0.01297
SRR4116662_1_kneaddata_paired	Firmicutes	12188	P	137546	869	138415	0.00624
SRR4116662_1_kneaddata_paired	Cyanobacteria	9876	P	57637	220	57857	0.00261
SRR4116662_1_kneaddata_paired	Proteobacteria	22518	P	15548	14	15562	0.00070
SRR4116662_1_kneaddata_paired	Verrucomicrobiota	33333	P	4038	166	4204	0.00019
SRR4116662_1_kneaddata_paired	Actinobacteriota	615	P	3911	7	3918	0.00018
SRR4116662_1_kneaddata_paired	Firmicutes_B	17289	P	1014	26	1040	0.00005
SRR4116662_1_kneaddata_paired	Firmicutes_C	17613	P	310	0	310	0.00001
SRR4116662_1_kneaddata_paired	Firmicutes_I	18140	P	230	0	230	0.00001
SRR4116662_1_kneaddata_paired	Elusimicrobiota	11888	P	26	0	26	0.00000
SRR4116662_1_kneaddata_paired	Thermotogota	33086	P	14	0	14	0.00000
SRR4116663_1_kneaddata_paired	Firmicutes_A	14608	P	12058933	53912	12112845	0.61397
SRR4116663_1_kneaddata_paired	Bacteroidota	4587	P	5007747	35112	5042859	0.25561
SRR4116663_1_kneaddata_paired	Desulfobacterota_A	11509	P	1467943	9141	1477084	0.07487
SRR4116663_1_kneaddata_paired	Deferribacterota	10822	P	429293	73	429366	0.02176
SRR4116663_1_kneaddata_paired	Firmicutes	12188	P	223254	1658	224912	0.01140
SRR4116663_1_kneaddata_paired	Spirochaetota	32587	P	174220	796	175016	0.00887
SRR4116663_1_kneaddata_paired	Campylobacterota	8700	P	145213	40	145253	0.00736
SRR4116663_1_kneaddata_paired	Firmicutes_C	17613	P	50090	94	50184	0.00254
SRR4116663_1_kneaddata_paired	Cyanobacteria	9876	P	42495	82	42577	0.00216
SRR4116663_1_kneaddata_paired	Proteobacteria	22518	P	16131	57	16188	0.00082
SRR4116663_1_kneaddata_paired	Actinobacteriota	615	P	8071	24	8095	0.00041
SRR4116663_1_kneaddata_paired	Verrucomicrobiota	33333	P	2391	115	2506	0.00013
SRR4116663_1_kneaddata_paired	Firmicutes_B	17289	P	1355	43	1398	0.00007
SRR4116663_1_kneaddata_paired	Firmicutes_I	18140	P	491	0	491	0.00002
SRR4116663_1_kneaddata_paired	Elusimicrobiota	11888	P	34	0	34	0.00000
SRR4116663_1_kneaddata_paired	Thermotogota	33086	P	21	0	21	0.00000
SRR4116664_1_kneaddata_paired	Firmicutes_A	14608	P	8584668	38145	8622813	0.57104
SRR4116664_1_kneaddata_paired	Bacteroidota	4587	P	4629672	34825	4664497	0.30890
SRR4116664_1_kneaddata_paired	Desulfobacterota_A	11509	P	741696	5013	746709	0.04945
SRR4116664_1_kneaddata_paired	Campylobacterota	8700	P	467055	60	467115	0.03093
SRR4116664_1_kneaddata_paired	Deferribacterota	10822	P	290912	54	290966	0.01927
SRR4116664_1_kneaddata_paired	Firmicutes	12188	P	125266	1420	126686	0.00839
SRR4116664_1_kneaddata_paired	Spirochaetota	32587	P	85191	383	85574	0.00567
SRR4116664_1_kneaddata_paired	Proteobacteria	22518	P	49379	59	49438	0.00327
SRR4116664_1_kneaddata_paired	Cyanobacteria	9876	P	22866	413	23279	0.00154
SRR4116664_1_kneaddata_paired	Firmicutes_C	17613	P	14500	26	14526	0.00096
SRR4116664_1_kneaddata_paired	Actinobacteriota	615	P	5847	21	5868	0.00039
SRR4116664_1_kneaddata_paired	Verrucomicrobiota	33333	P	1496	71	1567	0.00010
SRR4116664_1_kneaddata_paired	Firmicutes_B	17289	P	763	23	786	0.00005
SRR4116664_1_kneaddata_paired	Firmicutes_I	18140	P	320	0	320	0.00002
SRR4116664_1_kneaddata_paired	Elusimicrobiota	11888	P	42	0	42	0.00000
SRR4116664_1_kneaddata_paired	Thermotogota	33086	P	24	0	24	0.00000
SRR4116665_1_kneaddata_paired	Firmicutes_A	14608	P	11979404	44069	12023473	0.46210
SRR4116665_1_kneaddata_paired	Bacteroidota	4587	P	10070141	85720	10155861	0.39032
SRR4116665_1_kneaddata_paired	Desulfobacterota_A	11509	P	1600842	7325	1608167	0.06181
SRR4116665_1_kneaddata_paired	Campylobacterota	8700	P	783661	154	783815	0.03012
SRR4116665_1_kneaddata_paired	Deferribacterota	10822	P	602950	79	603029	0.02318
SRR4116665_1_kneaddata_paired	Spirochaetota	32587	P	493068	1647	494715	0.01901
SRR4116665_1_kneaddata_paired	Firmicutes	12188	P	207460	1211	208671	0.00802
SRR4116665_1_kneaddata_paired	Proteobacteria	22518	P	62927	140	63067	0.00242
SRR4116665_1_kneaddata_paired	Firmicutes_C	17613	P	53293	73	53366	0.00205
SRR4116665_1_kneaddata_paired	Cyanobacteria	9876	P	13030	73	13103	0.00050
SRR4116665_1_kneaddata_paired	Actinobacteriota	615	P	5652	14	5666	0.00022
SRR4116665_1_kneaddata_paired	Verrucomicrobiota	33333	P	4227	156	4383	0.00017
SRR4116665_1_kneaddata_paired	Firmicutes_B	17289	P	1547	35	1582	0.00006
SRR4116665_1_kneaddata_paired	Firmicutes_I	18140	P	464	0	464	0.00002
SRR4116665_1_kneaddata_paired	Thermotogota	33086	P	35	0	35	0.00000
SRR4116665_1_kneaddata_paired	Elusimicrobiota	11888	P	21	0	21	0.00000
SRR4116674_1_kneaddata_paired	Bacteroidota	4587	P	9376914	70045	9446959	0.55747
SRR4116674_1_kneaddata_paired	Firmicutes_A	14608	P	6036818	30606	6067424	0.35804
SRR4116674_1_kneaddata_paired	Firmicutes	12188	P	623873	5103	628976	0.03712
SRR4116674_1_kneaddata_paired	Proteobacteria	22518	P	282265	231	282496	0.01667
SRR4116674_1_kneaddata_paired	Desulfobacterota_A	11509	P	126100	782	126882	0.00749
SRR4116674_1_kneaddata_paired	Firmicutes_C	17613	P	111335	210	111545	0.00658
SRR4116674_1_kneaddata_paired	Deferribacterota	10822	P	105279	20	105299	0.00621
SRR4116674_1_kneaddata_paired	Campylobacterota	8700	P	103919	106	104025	0.00614
SRR4116674_1_kneaddata_paired	Spirochaetota	32587	P	28231	126	28357	0.00167
SRR4116674_1_kneaddata_paired	Actinobacteriota	615	P	27527	68	27595	0.00163
SRR4116674_1_kneaddata_paired	Cyanobacteria	9876	P	13908	155	14063	0.00083
SRR4116674_1_kneaddata_paired	Verrucomicrobiota	33333	P	1592	15	1607	0.00009
SRR4116674_1_kneaddata_paired	Firmicutes_B	17289	P	439	13	452	0.00003
SRR4116674_1_kneaddata_paired	Firmicutes_I	18140	P	376	0	376	0.00002
SRR4116674_1_kneaddata_paired	Thermotogota	33086	P	39	0	39	0.00000
SRR4116674_1_kneaddata_paired	Elusimicrobiota	11888	P	33	0	33	0.00000
SRR4116675_1_kneaddata_paired	Firmicutes_A	14608	P	12294654	50025	12344679	0.52224
SRR4116675_1_kneaddata_paired	Bacteroidota	4587	P	9381110	79297	9460407	0.40022
SRR4116675_1_kneaddata_paired	Campylobacterota	8700	P	544681	318	544999	0.02306
SRR4116675_1_kneaddata_paired	Firmicutes	12188	P	370381	2907	373288	0.01579
SRR4116675_1_kneaddata_paired	Deferribacterota	10822	P	296544	51	296595	0.01255
SRR4116675_1_kneaddata_paired	Spirochaetota	32587	P	228761	1021	229782	0.00972
SRR4116675_1_kneaddata_paired	Desulfobacterota_A	11509	P	201483	1298	202781	0.00858
SRR4116675_1_kneaddata_paired	Firmicutes_C	17613	P	111505	205	111710	0.00473
SRR4116675_1_kneaddata_paired	Cyanobacteria	9876	P	35991	134	36125	0.00153
SRR4116675_1_kneaddata_paired	Proteobacteria	22518	P	30255	80	30335	0.00128
SRR4116675_1_kneaddata_paired	Actinobacteriota	615	P	4922	17	4939	0.00021
SRR4116675_1_kneaddata_paired	Verrucomicrobiota	33333	P	1098	45	1143	0.00005
SRR4116675_1_kneaddata_paired	Firmicutes_B	17289	P	972	30	1002	0.00004
SRR4116675_1_kneaddata_paired	Firmicutes_I	18140	P	316	0	316	0.00001
SRR4116675_1_kneaddata_paired	Elusimicrobiota	11888	P	24	0	24	0.00000
SRR4116675_1_kneaddata_paired	Thermotogota	33086	P	18	0	18	0.00000
SRR4116676_1_kneaddata_paired	Firmicutes_A	14608	P	9717030	50852	9767882	0.65219
SRR4116676_1_kneaddata_paired	Bacteroidota	4587	P	4185518	29011	4214529	0.28140
SRR4116676_1_kneaddata_paired	Desulfobacterota_A	11509	P	323318	1631	324949	0.02170
SRR4116676_1_kneaddata_paired	Firmicutes	12188	P	186334	1696	188030	0.01255
SRR4116676_1_kneaddata_paired	Campylobacterota	8700	P	182354	161	182515	0.01219
SRR4116676_1_kneaddata_paired	Firmicutes_C	17613	P	140642	266	140908	0.00941
SRR4116676_1_kneaddata_paired	Proteobacteria	22518	P	84639	100	84739	0.00566
SRR4116676_1_kneaddata_paired	Deferribacterota	10822	P	44218	8	44226	0.00295
SRR4116676_1_kneaddata_paired	Spirochaetota	32587	P	11716	52	11768	0.00079
SRR4116676_1_kneaddata_paired	Cyanobacteria	9876	P	8457	105	8562	0.00057
SRR4116676_1_kneaddata_paired	Actinobacteriota	615	P	7327	24	7351	0.00049
SRR4116676_1_kneaddata_paired	Verrucomicrobiota	33333	P	728	29	757	0.00005
SRR4116676_1_kneaddata_paired	Firmicutes_B	17289	P	429	13	442	0.00003
SRR4116676_1_kneaddata_paired	Firmicutes_I	18140	P	310	0	310	0.00002
SRR4116676_1_kneaddata_paired	Thermotogota	33086	P	59	0	59	0.00000
SRR4116676_1_kneaddata_paired	Elusimicrobiota	11888	P	29	0	29	0.00000
SRR4116677_1_kneaddata_paired	Bacteroidota	4587	P	10656562	81507	10738069	0.62053
SRR4116677_1_kneaddata_paired	Firmicutes_A	14608	P	4952467	19356	4971823	0.28731
SRR4116677_1_kneaddata_paired	Desulfobacterota_A	11509	P	539622	2727	542349	0.03134
SRR4116677_1_kneaddata_paired	Firmicutes	12188	P	322196	2118	324314	0.01874
SRR4116677_1_kneaddata_paired	Campylobacterota	8700	P	215657	128	215785	0.01247
SRR4116677_1_kneaddata_paired	Proteobacteria	22518	P	153852	164	154016	0.00890
SRR4116677_1_kneaddata_paired	Spirochaetota	32587	P	128570	509	129079	0.00746
SRR4116677_1_kneaddata_paired	Deferribacterota	10822	P	115556	18	115574	0.00668
SRR4116677_1_kneaddata_paired	Firmicutes_C	17613	P	81961	134	82095	0.00474
SRR4116677_1_kneaddata_paired	Cyanobacteria	9876	P	20448	94	20542	0.00119
SRR4116677_1_kneaddata_paired	Actinobacteriota	615	P	9569	16	9585	0.00055
SRR4116677_1_kneaddata_paired	Verrucomicrobiota	33333	P	586	20	606	0.00004
SRR4116677_1_kneaddata_paired	Firmicutes_B	17289	P	432	11	443	0.00003
SRR4116677_1_kneaddata_paired	Firmicutes_I	18140	P	292	0	292	0.00002
SRR4116677_1_kneaddata_paired	Thermotogota	33086	P	32	0	32	0.00000
SRR4116677_1_kneaddata_paired	Elusimicrobiota	11888	P	17	0	17	0.00000
SRR4116678_1_kneaddata_paired	Firmicutes_A	14608	P	6053658	43834	6097492	0.51764
SRR4116678_1_kneaddata_paired	Bacteroidota	4587	P	5070636	22962	5093598	0.43242
SRR4116678_1_kneaddata_paired	Deferribacterota	10822	P	154012	523	154535	0.01312
SRR4116678_1_kneaddata_paired	Firmicutes	12188	P	144228	2363	146591	0.01244
SRR4116678_1_kneaddata_paired	Cyanobacteria	9876	P	111319	1702	113021	0.00959
SRR4116678_1_kneaddata_paired	Proteobacteria	22518	P	52809	174	52983	0.00450
SRR4116678_1_kneaddata_paired	Desulfobacterota_A	11509	P	46471	238	46709	0.00397
SRR4116678_1_kneaddata_paired	Campylobacterota	8700	P	35418	25	35443	0.00301
SRR4116678_1_kneaddata_paired	Verrucomicrobiota	33333	P	32479	1699	34178	0.00290
SRR4116678_1_kneaddata_paired	Actinobacteriota	615	P	3330	13	3343	0.00028
SRR4116678_1_kneaddata_paired	Firmicutes_B	17289	P	587	19	606	0.00005
SRR4116678_1_kneaddata_paired	Spirochaetota	32587	P	484	1	485	0.00004
SRR4116678_1_kneaddata_paired	Firmicutes_C	17613	P	133	0	133	0.00001
SRR4116678_1_kneaddata_paired	Firmicutes_I	18140	P	99	0	99	0.00001
SRR4116678_1_kneaddata_paired	Thermotogota	33086	P	88	0	88	0.00001
SRR4116678_1_kneaddata_paired	Elusimicrobiota	11888	P	17	0	17	0.00000
SRR5574474_1_kneaddata_paired	Firmicutes_A	14608	P	5062080	20276	5082356	0.60827
SRR5574474_1_kneaddata_paired	Bacteroidota	4587	P	2405750	13280	2419030	0.28952
SRR5574474_1_kneaddata_paired	Firmicutes	12188	P	359539	3584	363123	0.04346
SRR5574474_1_kneaddata_paired	Verrucomicrobiota	33333	P	188849	6994	195843	0.02344
SRR5574474_1_kneaddata_paired	Campylobacterota	8700	P	140117	72	140189	0.01678
SRR5574474_1_kneaddata_paired	Actinobacteriota	615	P	70950	128	71078	0.00851
SRR5574474_1_kneaddata_paired	Proteobacteria	22518	P	50811	61	50872	0.00609
SRR5574474_1_kneaddata_paired	Desulfobacterota_A	11509	P	23289	76	23365	0.00280
SRR5574474_1_kneaddata_paired	Cyanobacteria	9876	P	4870	132	5002	0.00060
SRR5574474_1_kneaddata_paired	Deferribacterota	10822	P	2461	5	2466	0.00030
SRR5574474_1_kneaddata_paired	Firmicutes_B	17289	P	1473	34	1507	0.00018
SRR5574474_1_kneaddata_paired	Spirochaetota	32587	P	349	0	349	0.00004
SRR5574474_1_kneaddata_paired	Firmicutes_I	18140	P	93	0	93	0.00001
SRR5574474_1_kneaddata_paired	Firmicutes_C	17613	P	50	0	50	0.00001
SRR5574474_1_kneaddata_paired	Thermotogota	33086	P	20	0	20	0.00000
SRR5574474_1_kneaddata_paired	Elusimicrobiota	11888	P	12	0	12	0.00000
SRR5574481_1_kneaddata_paired	Firmicutes_A	14608	P	16398388	65361	16463749	0.61491
SRR5574481_1_kneaddata_paired	Bacteroidota	4587	P	7518500	41656	7560156	0.28237
SRR5574481_1_kneaddata_paired	Firmicutes	12188	P	1170771	11490	1182261	0.04416
SRR5574481_1_kneaddata_paired	Verrucomicrobiota	33333	P	603554	22217	625771	0.02337
SRR5574481_1_kneaddata_paired	Campylobacterota	8700	P	461994	238	462232	0.01726
SRR5574481_1_kneaddata_paired	Actinobacteriota	615	P	212020	380	212400	0.00793
SRR5574481_1_kneaddata_paired	Proteobacteria	22518	P	162798	197	162995	0.00609
SRR5574481_1_kneaddata_paired	Desulfobacterota_A	11509	P	72375	241	72616	0.00271
SRR5574481_1_kneaddata_paired	Cyanobacteria	9876	P	16441	446	16887	0.00063
SRR5574481_1_kneaddata_paired	Deferribacterota	10822	P	8432	20	8452	0.00032
SRR5574481_1_kneaddata_paired	Firmicutes_B	17289	P	4705	111	4816	0.00018
SRR5574481_1_kneaddata_paired	Spirochaetota	32587	P	1193	3	1196	0.00004
SRR5574481_1_kneaddata_paired	Firmicutes_I	18140	P	288	0	288	0.00001
SRR5574481_1_kneaddata_paired	Firmicutes_C	17613	P	144	0	144	0.00001
SRR5574481_1_kneaddata_paired	Thermotogota	33086	P	58	0	58	0.00000
SRR5574481_1_kneaddata_paired	Elusimicrobiota	11888	P	47	0	47	0.00000
SRR5574491_1_kneaddata_paired	Firmicutes_A	14608	P	5062078	20277	5082355	0.60828
SRR5574491_1_kneaddata_paired	Bacteroidota	4587	P	2405742	13280	2419022	0.28952
SRR5574491_1_kneaddata_paired	Firmicutes	12188	P	359541	3584	363125	0.04346
SRR5574491_1_kneaddata_paired	Verrucomicrobiota	33333	P	188851	6994	195845	0.02344
SRR5574491_1_kneaddata_paired	Campylobacterota	8700	P	140117	72	140189	0.01678
SRR5574491_1_kneaddata_paired	Actinobacteriota	615	P	70950	128	71078	0.00851
SRR5574491_1_kneaddata_paired	Proteobacteria	22518	P	50811	61	50872	0.00609
SRR5574491_1_kneaddata_paired	Desulfobacterota_A	11509	P	23289	76	23365	0.00280
SRR5574491_1_kneaddata_paired	Cyanobacteria	9876	P	4869	132	5001	0.00060
SRR5574491_1_kneaddata_paired	Deferribacterota	10822	P	2461	5	2466	0.00030
SRR5574491_1_kneaddata_paired	Firmicutes_B	17289	P	1473	34	1507	0.00018
SRR5574491_1_kneaddata_paired	Spirochaetota	32587	P	349	0	349	0.00004
SRR5574491_1_kneaddata_paired	Firmicutes_I	18140	P	93	0	93	0.00001
SRR5574491_1_kneaddata_paired	Firmicutes_C	17613	P	50	0	50	0.00001
SRR5574491_1_kneaddata_paired	Thermotogota	33086	P	20	0	20	0.00000
SRR5574491_1_kneaddata_paired	Elusimicrobiota	11888	P	12	0	12	0.00000
SRR5574493_1_kneaddata_paired	Firmicutes_A	14608	P	5130285	20451	5150736	0.61638
SRR5574493_1_kneaddata_paired	Bacteroidota	4587	P	2330435	12854	2343289	0.28042
SRR5574493_1_kneaddata_paired	Firmicutes	12188	P	367365	3609	370974	0.04439
SRR5574493_1_kneaddata_paired	Verrucomicrobiota	33333	P	190507	7008	197515	0.02364
SRR5574493_1_kneaddata_paired	Campylobacterota	8700	P	142684	73	142757	0.01708
SRR5574493_1_kneaddata_paired	Actinobacteriota	615	P	67136	120	67256	0.00805
SRR5574493_1_kneaddata_paired	Proteobacteria	22518	P	51202	61	51263	0.00613
SRR5574493_1_kneaddata_paired	Desulfobacterota_A	11509	P	22691	74	22765	0.00272
SRR5574493_1_kneaddata_paired	Cyanobacteria	9876	P	5029	137	5166	0.00062
SRR5574493_1_kneaddata_paired	Deferribacterota	10822	P	2553	6	2559	0.00031
SRR5574493_1_kneaddata_paired	Firmicutes_B	17289	P	1507	35	1542	0.00018
SRR5574493_1_kneaddata_paired	Spirochaetota	32587	P	365	1	366	0.00004
SRR5574493_1_kneaddata_paired	Firmicutes_I	18140	P	86	0	86	0.00001
SRR5574493_1_kneaddata_paired	Firmicutes_C	17613	P	39	0	39	0.00000
SRR5574493_1_kneaddata_paired	Thermotogota	33086	P	26	0	26	0.00000
SRR5574493_1_kneaddata_paired	Elusimicrobiota	11888	P	21	0	21	0.00000
SRR5574494_1_kneaddata_paired	Bacteroidota	4587	P	3247015	9227	3256242	0.40099
SRR5574494_1_kneaddata_paired	Firmicutes_A	14608	P	3195483	6706	3202189	0.39434
SRR5574494_1_kneaddata_paired	Firmicutes	12188	P	574710	2687	577397	0.07110
SRR5574494_1_kneaddata_paired	Verrucomicrobiota	33333	P	558048	13100	571148	0.07033
SRR5574494_1_kneaddata_paired	Proteobacteria	22518	P	212397	139	212536	0.02617
SRR5574494_1_kneaddata_paired	Campylobacterota	8700	P	170743	22	170765	0.02103
SRR5574494_1_kneaddata_paired	Desulfobacterota_A	11509	P	66327	222	66549	0.00820
SRR5574494_1_kneaddata_paired	Actinobacteriota	615	P	33971	58	34029	0.00419
SRR5574494_1_kneaddata_paired	Cyanobacteria	9876	P	24428	128	24556	0.00302
SRR5574494_1_kneaddata_paired	Firmicutes_B	17289	P	2556	38	2594	0.00032
SRR5574494_1_kneaddata_paired	Deferribacterota	10822	P	1975	0	1975	0.00024
SRR5574494_1_kneaddata_paired	Spirochaetota	32587	P	265	0	265	0.00003
SRR5574494_1_kneaddata_paired	Firmicutes_I	18140	P	70	0	70	0.00001
SRR5574494_1_kneaddata_paired	Firmicutes_C	17613	P	51	0	51	0.00001
SRR5574494_1_kneaddata_paired	Thermotogota	33086	P	28	0	28	0.00000
SRR5574494_1_kneaddata_paired	Elusimicrobiota	11888	P	7	0	7	0.00000
SRR5574495_1_kneaddata_paired	Firmicutes_A	14608	P	3575754	7525	3583279	0.39972
SRR5574495_1_kneaddata_paired	Bacteroidota	4587	P	3507050	10063	3517113	0.39234
SRR5574495_1_kneaddata_paired	Firmicutes	12188	P	656044	3063	659107	0.07352
SRR5574495_1_kneaddata_paired	Verrucomicrobiota	33333	P	614705	14468	629173	0.07018
SRR5574495_1_kneaddata_paired	Proteobacteria	22518	P	233299	153	233452	0.02604
SRR5574495_1_kneaddata_paired	Campylobacterota	8700	P	198185	25	198210	0.02211
SRR5574495_1_kneaddata_paired	Desulfobacterota_A	11509	P	73810	248	74058	0.00826
SRR5574495_1_kneaddata_paired	Actinobacteriota	615	P	35456	60	35516	0.00396
SRR5574495_1_kneaddata_paired	Cyanobacteria	9876	P	28752	150	28902	0.00322
SRR5574495_1_kneaddata_paired	Firmicutes_B	17289	P	2797	42	2839	0.00032
SRR5574495_1_kneaddata_paired	Deferribacterota	10822	P	2411	0	2411	0.00027
SRR5574495_1_kneaddata_paired	Spirochaetota	32587	P	284	0	284	0.00003
SRR5574495_1_kneaddata_paired	Firmicutes_I	18140	P	89	0	89	0.00001
SRR5574495_1_kneaddata_paired	Firmicutes_C	17613	P	62	0	62	0.00001
SRR5574495_1_kneaddata_paired	Thermotogota	33086	P	30	0	30	0.00000
SRR5574495_1_kneaddata_paired	Elusimicrobiota	11888	P	4	0	4	0.00000
SRR5574496_1_kneaddata_paired	Firmicutes_A	14608	P	3367453	7058	3374511	0.40005
SRR5574496_1_kneaddata_paired	Bacteroidota	4587	P	3293226	9386	3302612	0.39152
SRR5574496_1_kneaddata_paired	Firmicutes	12188	P	625355	2889	628244	0.07448
SRR5574496_1_kneaddata_paired	Verrucomicrobiota	33333	P	574251	13440	587691	0.06967
SRR5574496_1_kneaddata_paired	Proteobacteria	22518	P	219643	143	219786	0.02606
SRR5574496_1_kneaddata_paired	Campylobacterota	8700	P	186624	24	186648	0.02213
SRR5574496_1_kneaddata_paired	Desulfobacterota_A	11509	P	69935	232	70167	0.00832
SRR5574496_1_kneaddata_paired	Actinobacteriota	615	P	33047	56	33103	0.00392
SRR5574496_1_kneaddata_paired	Cyanobacteria	9876	P	27051	141	27192	0.00322
SRR5574496_1_kneaddata_paired	Firmicutes_B	17289	P	2568	38	2606	0.00031
SRR5574496_1_kneaddata_paired	Deferribacterota	10822	P	2314	0	2314	0.00027
SRR5574496_1_kneaddata_paired	Spirochaetota	32587	P	271	0	271	0.00003
SRR5574496_1_kneaddata_paired	Firmicutes_I	18140	P	71	0	71	0.00001
SRR5574496_1_kneaddata_paired	Firmicutes_C	17613	P	63	0	63	0.00001
SRR5574496_1_kneaddata_paired	Thermotogota	33086	P	25	0	25	0.00000
SRR5574496_1_kneaddata_paired	Elusimicrobiota	11888	P	8	0	8	0.00000
SRR5574497_1_kneaddata_paired	Firmicutes_A	14608	P	6206033	24631	6230664	0.61921
SRR5574497_1_kneaddata_paired	Bacteroidota	4587	P	2782310	15523	2797833	0.27805
SRR5574497_1_kneaddata_paired	Firmicutes	12188	P	443874	4296	448170	0.04454
SRR5574497_1_kneaddata_paired	Verrucomicrobiota	33333	P	224196	8215	232411	0.02310
SRR5574497_1_kneaddata_paired	Campylobacterota	8700	P	179190	92	179282	0.01782
SRR5574497_1_kneaddata_paired	Actinobacteriota	615	P	73933	130	74063	0.00736
SRR5574497_1_kneaddata_paired	Proteobacteria	22518	P	60784	74	60858	0.00605
SRR5574497_1_kneaddata_paired	Desulfobacterota_A	11509	P	26395	89	26484	0.00263
SRR5574497_1_kneaddata_paired	Cyanobacteria	9876	P	6538	176	6714	0.00067
SRR5574497_1_kneaddata_paired	Deferribacterota	10822	P	3418	8	3426	0.00034
SRR5574497_1_kneaddata_paired	Firmicutes_B	17289	P	1725	40	1765	0.00018
SRR5574497_1_kneaddata_paired	Spirochaetota	32587	P	479	1	480	0.00005
SRR5574497_1_kneaddata_paired	Firmicutes_I	18140	P	109	0	109	0.00001
SRR5574497_1_kneaddata_paired	Firmicutes_C	17613	P	55	0	55	0.00001
SRR5574497_1_kneaddata_paired	Elusimicrobiota	11888	P	14	0	14	0.00000
SRR5574497_1_kneaddata_paired	Thermotogota	33086	P	12	0	12	0.00000
SRR5574499_1_kneaddata_paired	Firmicutes_A	14608	P	5062084	20276	5082360	0.60828
SRR5574499_1_kneaddata_paired	Bacteroidota	4587	P	2405746	13280	2419026	0.28952
SRR5574499_1_kneaddata_paired	Firmicutes	12188	P	359538	3584	363122	0.04346
SRR5574499_1_kneaddata_paired	Verrucomicrobiota	33333	P	188851	6994	195845	0.02344
SRR5574499_1_kneaddata_paired	Campylobacterota	8700	P	140117	72	140189	0.01678
SRR5574499_1_kneaddata_paired	Actinobacteriota	615	P	70950	128	71078	0.00851
SRR5574499_1_kneaddata_paired	Proteobacteria	22518	P	50811	61	50872	0.00609
SRR5574499_1_kneaddata_paired	Desulfobacterota_A	11509	P	23289	76	23365	0.00280
SRR5574499_1_kneaddata_paired	Cyanobacteria	9876	P	4869	132	5001	0.00060
SRR5574499_1_kneaddata_paired	Deferribacterota	10822	P	2461	5	2466	0.00030
SRR5574499_1_kneaddata_paired	Firmicutes_B	17289	P	1473	34	1507	0.00018
SRR5574499_1_kneaddata_paired	Spirochaetota	32587	P	349	0	349	0.00004
SRR5574499_1_kneaddata_paired	Firmicutes_I	18140	P	93	0	93	0.00001
SRR5574499_1_kneaddata_paired	Firmicutes_C	17613	P	50	0	50	0.00001
SRR5574499_1_kneaddata_paired	Thermotogota	33086	P	20	0	20	0.00000
SRR5574499_1_kneaddata_paired	Elusimicrobiota	11888	P	12	0	12	0.00000
SRR5574500_1_kneaddata_paired	Bacteroidota	4587	P	2723936	11505	2735441	0.41761
SRR5574500_1_kneaddata_paired	Firmicutes_A	14608	P	2507958	6972	2514930	0.38394
SRR5574500_1_kneaddata_paired	Proteobacteria	22518	P	518082	411	518493	0.07916
SRR5574500_1_kneaddata_paired	Firmicutes	12188	P	311133	1556	312689	0.04774
SRR5574500_1_kneaddata_paired	Verrucomicrobiota	33333	P	224834	7201	232035	0.03542
SRR5574500_1_kneaddata_paired	Campylobacterota	8700	P	97090	4	97094	0.01482
SRR5574500_1_kneaddata_paired	Desulfobacterota_A	11509	P	76877	368	77245	0.01179
SRR5574500_1_kneaddata_paired	Actinobacteriota	615	P	45385	85	45470	0.00694
SRR5574500_1_kneaddata_paired	Cyanobacteria	9876	P	15406	206	15612	0.00238
SRR5574500_1_kneaddata_paired	Deferribacterota	10822	P	458	0	458	0.00007
SRR5574500_1_kneaddata_paired	Spirochaetota	32587	P	413	0	413	0.00006
SRR5574500_1_kneaddata_paired	Firmicutes_B	17289	P	256	5	261	0.00004
SRR5574500_1_kneaddata_paired	Thermotogota	33086	P	54	0	54	0.00001
SRR5574500_1_kneaddata_paired	Firmicutes_I	18140	P	42	0	42	0.00001
SRR5574500_1_kneaddata_paired	Firmicutes_C	17613	P	34	0	34	0.00001
SRR5574500_1_kneaddata_paired	Elusimicrobiota	11888	P	5	0	5	0.00000
SRR5574501_1_kneaddata_paired	Bacteroidota	4587	P	2596366	10953	2607319	0.42149
SRR5574501_1_kneaddata_paired	Firmicutes_A	14608	P	2380118	6757	2386875	0.38586
SRR5574501_1_kneaddata_paired	Proteobacteria	22518	P	445808	352	446160	0.07213
SRR5574501_1_kneaddata_paired	Firmicutes	12188	P	291305	1455	292760	0.04733
SRR5574501_1_kneaddata_paired	Verrucomicrobiota	33333	P	220562	7010	227572	0.03679
SRR5574501_1_kneaddata_paired	Campylobacterota	8700	P	96204	4	96208	0.01555
SRR5574501_1_kneaddata_paired	Desulfobacterota_A	11509	P	70740	341	71081	0.01149
SRR5574501_1_kneaddata_paired	Actinobacteriota	615	P	40748	77	40825	0.00660
SRR5574501_1_kneaddata_paired	Cyanobacteria	9876	P	15705	207	15912	0.00257
SRR5574501_1_kneaddata_paired	Deferribacterota	10822	P	444	0	444	0.00007
SRR5574501_1_kneaddata_paired	Spirochaetota	32587	P	328	0	328	0.00005
SRR5574501_1_kneaddata_paired	Firmicutes_B	17289	P	252	5	257	0.00004
SRR5574501_1_kneaddata_paired	Thermotogota	33086	P	56	0	56	0.00001
SRR5574501_1_kneaddata_paired	Firmicutes_I	18140	P	51	0	51	0.00001
SRR5574501_1_kneaddata_paired	Firmicutes_C	17613	P	31	0	31	0.00001
SRR5574501_1_kneaddata_paired	Elusimicrobiota	11888	P	9	0	9	0.00000
SRR5574502_1_kneaddata_paired	Bacteroidota	4587	P	2504400	10425	2514825	0.43156
SRR5574502_1_kneaddata_paired	Firmicutes_A	14608	P	2209055	6328	2215383	0.38018
SRR5574502_1_kneaddata_paired	Proteobacteria	22518	P	399069	316	399385	0.06854
SRR5574502_1_kneaddata_paired	Firmicutes	12188	P	264516	1364	265880	0.04563
SRR5574502_1_kneaddata_paired	Verrucomicrobiota	33333	P	217125	6926	224051	0.03845
SRR5574502_1_kneaddata_paired	Campylobacterota	8700	P	84397	3	84400	0.01448
SRR5574502_1_kneaddata_paired	Desulfobacterota_A	11509	P	64593	310	64903	0.01114
SRR5574502_1_kneaddata_paired	Actinobacteriota	615	P	43261	81	43342	0.00744
SRR5574502_1_kneaddata_paired	Cyanobacteria	9876	P	13884	187	14071	0.00241
SRR5574502_1_kneaddata_paired	Deferribacterota	10822	P	397	0	397	0.00007
SRR5574502_1_kneaddata_paired	Spirochaetota	32587	P	297	0	297	0.00005
SRR5574502_1_kneaddata_paired	Firmicutes_B	17289	P	194	3	197	0.00003
SRR5574502_1_kneaddata_paired	Firmicutes_I	18140	P	49	0	49	0.00001
SRR5574502_1_kneaddata_paired	Thermotogota	33086	P	42	0	42	0.00001
SRR5574502_1_kneaddata_paired	Firmicutes_C	17613	P	26	0	26	0.00000
SRR5574502_1_kneaddata_paired	Elusimicrobiota	11888	P	6	0	6	0.00000
SRR5574503_1_kneaddata_paired	Bacteroidota	4587	P	4009503	17155	4026658	0.54854
SRR5574503_1_kneaddata_paired	Firmicutes_A	14608	P	2558700	13242	2571942	0.35037
SRR5574503_1_kneaddata_paired	Firmicutes	12188	P	362737	1965	364702	0.04968
SRR5574503_1_kneaddata_paired	Actinobacteriota	615	P	168092	888	168980	0.02302
SRR5574503_1_kneaddata_paired	Campylobacterota	8700	P	88857	17	88874	0.01211
SRR5574503_1_kneaddata_paired	Desulfobacterota_A	11509	P	54924	364	55288	0.00753
SRR5574503_1_kneaddata_paired	Cyanobacteria	9876	P	31575	226	31801	0.00433
SRR5574503_1_kneaddata_paired	Proteobacteria	22518	P	14347	30	14377	0.00196
SRR5574503_1_kneaddata_paired	Verrucomicrobiota	33333	P	14075	733	14808	0.00202
SRR5574503_1_kneaddata_paired	Deferribacterota	10822	P	2354	0	2354	0.00032
SRR5574503_1_kneaddata_paired	Firmicutes_B	17289	P	454	15	469	0.00006
SRR5574503_1_kneaddata_paired	Spirochaetota	32587	P	184	0	184	0.00003
SRR5574503_1_kneaddata_paired	Firmicutes_I	18140	P	85	0	85	0.00001
SRR5574503_1_kneaddata_paired	Firmicutes_C	17613	P	84	0	84	0.00001
SRR5574503_1_kneaddata_paired	Thermotogota	33086	P	24	0	24	0.00000
SRR5574503_1_kneaddata_paired	Elusimicrobiota	11888	P	8	0	8	0.00000
SRR5574504_1_kneaddata_paired	Bacteroidota	4587	P	4597906	19698	4617604	0.55342
SRR5574504_1_kneaddata_paired	Firmicutes_A	14608	P	2871524	14738	2886262	0.34592
SRR5574504_1_kneaddata_paired	Firmicutes	12188	P	402954	2156	405110	0.04855
SRR5574504_1_kneaddata_paired	Actinobacteriota	615	P	203822	1035	204857	0.02455
SRR5574504_1_kneaddata_paired	Campylobacterota	8700	P	98046	19	98065	0.01175
SRR5574504_1_kneaddata_paired	Desulfobacterota_A	11509	P	61305	396	61701	0.00739
SRR5574504_1_kneaddata_paired	Cyanobacteria	9876	P	34039	263	34302	0.00411
SRR5574504_1_kneaddata_paired	Proteobacteria	22518	P	15853	31	15884	0.00190
SRR5574504_1_kneaddata_paired	Verrucomicrobiota	33333	P	15839	822	16661	0.00200
SRR5574504_1_kneaddata_paired	Deferribacterota	10822	P	2437	0	2437	0.00029
SRR5574504_1_kneaddata_paired	Firmicutes_B	17289	P	522	17	539	0.00006
SRR5574504_1_kneaddata_paired	Spirochaetota	32587	P	189	0	189	0.00002
SRR5574504_1_kneaddata_paired	Firmicutes_C	17613	P	99	0	99	0.00001
SRR5574504_1_kneaddata_paired	Firmicutes_I	18140	P	82	0	82	0.00001
SRR5574504_1_kneaddata_paired	Thermotogota	33086	P	20	0	20	0.00000
SRR5574504_1_kneaddata_paired	Elusimicrobiota	11888	P	7	0	7	0.00000
SRR5574505_1_kneaddata_paired	Bacteroidota	4587	P	4522992	19235	4542227	0.55204
SRR5574505_1_kneaddata_paired	Firmicutes_A	14608	P	2837358	14731	2852089	0.34663
SRR5574505_1_kneaddata_paired	Firmicutes	12188	P	411535	2228	413763	0.05029
SRR5574505_1_kneaddata_paired	Actinobacteriota	615	P	193864	1014	194878	0.02368
SRR5574505_1_kneaddata_paired	Campylobacterota	8700	P	96446	20	96466	0.01172
SRR5574505_1_kneaddata_paired	Desulfobacterota_A	11509	P	60306	400	60706	0.00738
SRR5574505_1_kneaddata_paired	Cyanobacteria	9876	P	31732	242	31974	0.00389
SRR5574505_1_kneaddata_paired	Verrucomicrobiota	33333	P	15910	833	16743	0.00203
SRR5574505_1_kneaddata_paired	Proteobacteria	22518	P	15816	33	15849	0.00193
SRR5574505_1_kneaddata_paired	Deferribacterota	10822	P	2435	0	2435	0.00030
SRR5574505_1_kneaddata_paired	Firmicutes_B	17289	P	531	17	548	0.00007
SRR5574505_1_kneaddata_paired	Spirochaetota	32587	P	174	0	174	0.00002
SRR5574505_1_kneaddata_paired	Firmicutes_I	18140	P	96	0	96	0.00001
SRR5574505_1_kneaddata_paired	Firmicutes_C	17613	P	75	0	75	0.00001
SRR5574505_1_kneaddata_paired	Thermotogota	33086	P	13	0	13	0.00000
SRR5574505_1_kneaddata_paired	Elusimicrobiota	11888	P	10	0	10	0.00000
SRR5574506_1_kneaddata_paired	Bacteroidota	4587	P	3804819	12363	3817182	0.48879
SRR5574506_1_kneaddata_paired	Firmicutes_A	14608	P	3007294	10378	3017672	0.38641
SRR5574506_1_kneaddata_paired	Firmicutes	12188	P	302988	4835	307823	0.03942
SRR5574506_1_kneaddata_paired	Verrucomicrobiota	33333	P	226205	7920	234125	0.02998
SRR5574506_1_kneaddata_paired	Campylobacterota	8700	P	142132	9	142141	0.01820
SRR5574506_1_kneaddata_paired	Actinobacteriota	615	P	123777	238	124015	0.01588
SRR5574506_1_kneaddata_paired	Proteobacteria	22518	P	81432	150	81582	0.01045
SRR5574506_1_kneaddata_paired	Desulfobacterota_A	11509	P	56219	180	56399	0.00722
SRR5574506_1_kneaddata_paired	Cyanobacteria	9876	P	20846	351	21197	0.00271
SRR5574506_1_kneaddata_paired	Deferribacterota	10822	P	5420	0	5420	0.00069
SRR5574506_1_kneaddata_paired	Firmicutes_B	17289	P	1362	30	1392	0.00018
SRR5574506_1_kneaddata_paired	Spirochaetota	32587	P	259	0	259	0.00003
SRR5574506_1_kneaddata_paired	Firmicutes_I	18140	P	99	0	99	0.00001
SRR5574506_1_kneaddata_paired	Firmicutes_C	17613	P	87	0	87	0.00001
SRR5574506_1_kneaddata_paired	Thermotogota	33086	P	48	0	48	0.00001
SRR5574506_1_kneaddata_paired	Elusimicrobiota	11888	P	5	0	5	0.00000
SRR5574507_1_kneaddata_paired	Bacteroidota	4587	P	4068780	13218	4081998	0.49073
SRR5574507_1_kneaddata_paired	Firmicutes_A	14608	P	3182848	10952	3193800	0.38395
SRR5574507_1_kneaddata_paired	Firmicutes	12188	P	320376	5338	325714	0.03916
SRR5574507_1_kneaddata_paired	Verrucomicrobiota	33333	P	248496	8698	257194	0.03092
SRR5574507_1_kneaddata_paired	Campylobacterota	8700	P	146647	10	146657	0.01763
SRR5574507_1_kneaddata_paired	Actinobacteriota	615	P	137061	261	137322	0.01651
SRR5574507_1_kneaddata_paired	Proteobacteria	22518	P	85995	159	86154	0.01036
SRR5574507_1_kneaddata_paired	Desulfobacterota_A	11509	P	59825	195	60020	0.00722
SRR5574507_1_kneaddata_paired	Cyanobacteria	9876	P	21549	355	21904	0.00263
SRR5574507_1_kneaddata_paired	Deferribacterota	10822	P	5443	0	5443	0.00065
SRR5574507_1_kneaddata_paired	Firmicutes_B	17289	P	1392	31	1423	0.00017
SRR5574507_1_kneaddata_paired	Spirochaetota	32587	P	297	0	297	0.00004
SRR5574507_1_kneaddata_paired	Firmicutes_I	18140	P	139	0	139	0.00002
SRR5574507_1_kneaddata_paired	Firmicutes_C	17613	P	77	0	77	0.00001
SRR5574507_1_kneaddata_paired	Thermotogota	33086	P	53	0	53	0.00001
SRR5574507_1_kneaddata_paired	Elusimicrobiota	11888	P	9	0	9	0.00000
SRR5574508_1_kneaddata_paired	Bacteroidota	4587	P	3873009	12644	3885653	0.48468
SRR5574508_1_kneaddata_paired	Firmicutes_A	14608	P	3115569	10872	3126441	0.38998
SRR5574508_1_kneaddata_paired	Firmicutes	12188	P	313104	5247	318351	0.03971
SRR5574508_1_kneaddata_paired	Verrucomicrobiota	33333	P	238106	8455	246561	0.03075
SRR5574508_1_kneaddata_paired	Campylobacterota	8700	P	144001	10	144011	0.01796
SRR5574508_1_kneaddata_paired	Actinobacteriota	615	P	131626	255	131881	0.01645
SRR5574508_1_kneaddata_paired	Proteobacteria	22518	P	75818	139	75957	0.00947
SRR5574508_1_kneaddata_paired	Desulfobacterota_A	11509	P	58351	187	58538	0.00730
SRR5574508_1_kneaddata_paired	Cyanobacteria	9876	P	21559	362	21921	0.00273
SRR5574508_1_kneaddata_paired	Deferribacterota	10822	P	5671	0	5671	0.00071
SRR5574508_1_kneaddata_paired	Firmicutes_B	17289	P	1492	34	1526	0.00019
SRR5574508_1_kneaddata_paired	Spirochaetota	32587	P	269	0	269	0.00003
SRR5574508_1_kneaddata_paired	Firmicutes_I	18140	P	103	0	103	0.00001
SRR5574508_1_kneaddata_paired	Firmicutes_C	17613	P	71	0	71	0.00001
SRR5574508_1_kneaddata_paired	Thermotogota	33086	P	40	0	40	0.00000
SRR5574508_1_kneaddata_paired	Elusimicrobiota	11888	P	7	0	7	0.00000
SRR5574509_1_kneaddata_paired	Bacteroidota	4587	P	4174614	17186	4191800	0.47468
SRR5574509_1_kneaddata_paired	Firmicutes_A	14608	P	3956254	20529	3976783	0.45033
SRR5574509_1_kneaddata_paired	Firmicutes	12188	P	294626	2249	296875	0.03362
SRR5574509_1_kneaddata_paired	Campylobacterota	8700	P	143958	14	143972	0.01630
SRR5574509_1_kneaddata_paired	Actinobacteriota	615	P	119133	324	119457	0.01353
SRR5574509_1_kneaddata_paired	Desulfobacterota_A	11509	P	50547	261	50808	0.00575
SRR5574509_1_kneaddata_paired	Verrucomicrobiota	33333	P	20985	955	21940	0.00248
SRR5574509_1_kneaddata_paired	Cyanobacteria	9876	P	12766	102	12868	0.00146
SRR5574509_1_kneaddata_paired	Proteobacteria	22518	P	10128	33	10161	0.00115
SRR5574509_1_kneaddata_paired	Deferribacterota	10822	P	5271	0	5271	0.00060
SRR5574509_1_kneaddata_paired	Firmicutes_B	17289	P	544	15	559	0.00006
SRR5574509_1_kneaddata_paired	Spirochaetota	32587	P	183	0	183	0.00002
SRR5574509_1_kneaddata_paired	Firmicutes_C	17613	P	91	0	91	0.00001
SRR5574509_1_kneaddata_paired	Firmicutes_I	18140	P	63	0	63	0.00001
SRR5574509_1_kneaddata_paired	Elusimicrobiota	11888	P	7	0	7	0.00000
SRR5574509_1_kneaddata_paired	Thermotogota	33086	P	5	0	5	0.00000
SRR5574510_1_kneaddata_paired	Bacteroidota	4587	P	3973119	16421	3989540	0.47871
SRR5574510_1_kneaddata_paired	Firmicutes_A	14608	P	3693544	19404	3712948	0.44552
SRR5574510_1_kneaddata_paired	Firmicutes	12188	P	279402	2109	281511	0.03378
SRR5574510_1_kneaddata_paired	Campylobacterota	8700	P	137423	13	137436	0.01649
SRR5574510_1_kneaddata_paired	Actinobacteriota	615	P	111168	299	111467	0.01338
SRR5574510_1_kneaddata_paired	Desulfobacterota_A	11509	P	48819	247	49066	0.00589
SRR5574510_1_kneaddata_paired	Verrucomicrobiota	33333	P	21732	993	22725	0.00273
SRR5574510_1_kneaddata_paired	Cyanobacteria	9876	P	12980	108	13088	0.00157
SRR5574510_1_kneaddata_paired	Proteobacteria	22518	P	10097	31	10128	0.00122
SRR5574510_1_kneaddata_paired	Deferribacterota	10822	P	5138	0	5138	0.00062
SRR5574510_1_kneaddata_paired	Firmicutes_B	17289	P	544	16	560	0.00007
SRR5574510_1_kneaddata_paired	Spirochaetota	32587	P	178	0	178	0.00002
SRR5574510_1_kneaddata_paired	Firmicutes_C	17613	P	71	0	71	0.00001
SRR5574510_1_kneaddata_paired	Firmicutes_I	18140	P	70	0	70	0.00001
SRR5574510_1_kneaddata_paired	Elusimicrobiota	11888	P	6	0	6	0.00000
SRR5574510_1_kneaddata_paired	Thermotogota	33086	P	2	0	2	0.00000
SRR5574511_1_kneaddata_paired	Bacteroidota	4587	P	4175047	17297	4192344	0.47357
SRR5574511_1_kneaddata_paired	Firmicutes_A	14608	P	3973873	20799	3994672	0.45124
SRR5574511_1_kneaddata_paired	Firmicutes	12188	P	292777	2199	294976	0.03332
SRR5574511_1_kneaddata_paired	Campylobacterota	8700	P	149673	14	149687	0.01691
SRR5574511_1_kneaddata_paired	Actinobacteriota	615	P	112764	303	113067	0.01277
SRR5574511_1_kneaddata_paired	Desulfobacterota_A	11509	P	51879	262	52141	0.00589
SRR5574511_1_kneaddata_paired	Verrucomicrobiota	33333	P	22790	1035	23825	0.00269
SRR5574511_1_kneaddata_paired	Cyanobacteria	9876	P	14323	118	14441	0.00163
SRR5574511_1_kneaddata_paired	Proteobacteria	22518	P	10950	35	10985	0.00124
SRR5574511_1_kneaddata_paired	Deferribacterota	10822	P	5665	0	5665	0.00064
SRR5574511_1_kneaddata_paired	Firmicutes_B	17289	P	519	15	534	0.00006
SRR5574511_1_kneaddata_paired	Spirochaetota	32587	P	190	0	190	0.00002
SRR5574511_1_kneaddata_paired	Firmicutes_C	17613	P	100	0	100	0.00001
SRR5574511_1_kneaddata_paired	Firmicutes_I	18140	P	71	0	71	0.00001
SRR5574511_1_kneaddata_paired	Elusimicrobiota	11888	P	9	0	9	0.00000
SRR5574511_1_kneaddata_paired	Thermotogota	33086	P	8	0	8	0.00000
SRR5574512_1_kneaddata_paired	Bacteroidota	4587	P	3395287	14751	3410038	0.45539
SRR5574512_1_kneaddata_paired	Firmicutes_A	14608	P	3307269	16575	3323844	0.44388
SRR5574512_1_kneaddata_paired	Firmicutes	12188	P	335907	2150	338057	0.04515
SRR5574512_1_kneaddata_paired	Actinobacteriota	615	P	153001	440	153441	0.02049
SRR5574512_1_kneaddata_paired	Campylobacterota	8700	P	137843	13	137856	0.01841
SRR5574512_1_kneaddata_paired	Desulfobacterota_A	11509	P	57390	346	57736	0.00771
SRR5574512_1_kneaddata_paired	Verrucomicrobiota	33333	P	30692	1468	32160	0.00429
SRR5574512_1_kneaddata_paired	Cyanobacteria	9876	P	17868	122	17990	0.00240
SRR5574512_1_kneaddata_paired	Proteobacteria	22518	P	10641	64	10705	0.00143
SRR5574512_1_kneaddata_paired	Deferribacterota	10822	P	5030	0	5030	0.00067
SRR5574512_1_kneaddata_paired	Firmicutes_B	17289	P	863	26	889	0.00012
SRR5574512_1_kneaddata_paired	Spirochaetota	32587	P	200	0	200	0.00003
SRR5574512_1_kneaddata_paired	Firmicutes_I	18140	P	92	0	92	0.00001
SRR5574512_1_kneaddata_paired	Firmicutes_C	17613	P	62	0	62	0.00001
SRR5574512_1_kneaddata_paired	Elusimicrobiota	11888	P	12	0	12	0.00000
SRR5574512_1_kneaddata_paired	Thermotogota	33086	P	8	0	8	0.00000
SRR5574513_1_kneaddata_paired	Bacteroidota	4587	P	3563198	15809	3579007	0.46594
SRR5574513_1_kneaddata_paired	Firmicutes_A	14608	P	3317254	16999	3334253	0.43407
SRR5574513_1_kneaddata_paired	Firmicutes	12188	P	334485	2182	336667	0.04383
SRR5574513_1_kneaddata_paired	Actinobacteriota	615	P	179018	523	179541	0.02337
SRR5574513_1_kneaddata_paired	Campylobacterota	8700	P	127817	13	127830	0.01664
SRR5574513_1_kneaddata_paired	Desulfobacterota_A	11509	P	57546	355	57901	0.00754
SRR5574513_1_kneaddata_paired	Verrucomicrobiota	33333	P	31862	1576	33438	0.00435
SRR5574513_1_kneaddata_paired	Cyanobacteria	9876	P	15982	117	16099	0.00210
SRR5574513_1_kneaddata_paired	Proteobacteria	22518	P	10909	69	10978	0.00143
SRR5574513_1_kneaddata_paired	Deferribacterota	10822	P	4418	0	4418	0.00058
SRR5574513_1_kneaddata_paired	Firmicutes_B	17289	P	799	25	824	0.00011
SRR5574513_1_kneaddata_paired	Spirochaetota	32587	P	166	0	166	0.00002
SRR5574513_1_kneaddata_paired	Firmicutes_I	18140	P	94	0	94	0.00001
SRR5574513_1_kneaddata_paired	Firmicutes_C	17613	P	72	0	72	0.00001
SRR5574513_1_kneaddata_paired	Elusimicrobiota	11888	P	8	0	8	0.00000
SRR5574513_1_kneaddata_paired	Thermotogota	33086	P	8	0	8	0.00000
SRR5574514_1_kneaddata_paired	Bacteroidota	4587	P	3436089	14948	3451037	0.46112
SRR5574514_1_kneaddata_paired	Firmicutes_A	14608	P	3270808	16483	3287291	0.43924
SRR5574514_1_kneaddata_paired	Firmicutes	12188	P	328911	2107	331018	0.04423
SRR5574514_1_kneaddata_paired	Actinobacteriota	615	P	160817	461	161278	0.02155
SRR5574514_1_kneaddata_paired	Campylobacterota	8700	P	131769	13	131782	0.01761
SRR5574514_1_kneaddata_paired	Desulfobacterota_A	11509	P	56318	342	56660	0.00757
SRR5574514_1_kneaddata_paired	Verrucomicrobiota	33333	P	29966	1445	31411	0.00420
SRR5574514_1_kneaddata_paired	Cyanobacteria	9876	P	16966	121	17087	0.00228
SRR5574514_1_kneaddata_paired	Proteobacteria	22518	P	10588	67	10655	0.00142
SRR5574514_1_kneaddata_paired	Deferribacterota	10822	P	4666	0	4666	0.00062
SRR5574514_1_kneaddata_paired	Firmicutes_B	17289	P	786	24	810	0.00011
SRR5574514_1_kneaddata_paired	Spirochaetota	32587	P	209	0	209	0.00003
SRR5574514_1_kneaddata_paired	Firmicutes_I	18140	P	96	0	96	0.00001
SRR5574514_1_kneaddata_paired	Firmicutes_C	17613	P	60	0	60	0.00001
SRR5574514_1_kneaddata_paired	Thermotogota	33086	P	11	0	11	0.00000
SRR5574514_1_kneaddata_paired	Elusimicrobiota	11888	P	9	0	9	0.00000
SRR5574516_1_kneaddata_paired	Bacteroidota	4587	P	5062355	16245	5078600	0.62170
SRR5574516_1_kneaddata_paired	Firmicutes_A	14608	P	2393928	13465	2407393	0.29470
SRR5574516_1_kneaddata_paired	Firmicutes	12188	P	276855	2139	278994	0.03415
SRR5574516_1_kneaddata_paired	Verrucomicrobiota	33333	P	112539	5436	117975	0.01444
SRR5574516_1_kneaddata_paired	Actinobacteriota	615	P	100482	252	100734	0.01233
SRR5574516_1_kneaddata_paired	Campylobacterota	8700	P	76539	26	76565	0.00937
SRR5574516_1_kneaddata_paired	Desulfobacterota_A	11509	P	56997	128	57125	0.00699
SRR5574516_1_kneaddata_paired	Proteobacteria	22518	P	43845	72	43917	0.00538
SRR5574516_1_kneaddata_paired	Cyanobacteria	9876	P	6572	237	6809	0.00083
SRR5574516_1_kneaddata_paired	Spirochaetota	32587	P	247	0	247	0.00003
SRR5574516_1_kneaddata_paired	Firmicutes_B	17289	P	159	4	163	0.00002
SRR5574516_1_kneaddata_paired	Deferribacterota	10822	P	155	0	155	0.00002
SRR5574516_1_kneaddata_paired	Firmicutes_C	17613	P	98	0	98	0.00001
SRR5574516_1_kneaddata_paired	Firmicutes_I	18140	P	94	0	94	0.00001
SRR5574516_1_kneaddata_paired	Thermotogota	33086	P	9	0	9	0.00000
SRR5574516_1_kneaddata_paired	Elusimicrobiota	11888	P	4	0	4	0.00000
SRR5574517_1_kneaddata_paired	Bacteroidota	4587	P	4156918	13321	4170239	0.62813
SRR5574517_1_kneaddata_paired	Firmicutes_A	14608	P	1893496	10704	1904200	0.28681
SRR5574517_1_kneaddata_paired	Firmicutes	12188	P	224891	1761	226652	0.03414
SRR5574517_1_kneaddata_paired	Verrucomicrobiota	33333	P	97948	4740	102688	0.01547
SRR5574517_1_kneaddata_paired	Actinobacteriota	615	P	85532	215	85747	0.01292
SRR5574517_1_kneaddata_paired	Campylobacterota	8700	P	62450	21	62471	0.00941
SRR5574517_1_kneaddata_paired	Desulfobacterota_A	11509	P	46168	105	46273	0.00697
SRR5574517_1_kneaddata_paired	Proteobacteria	22518	P	34729	57	34786	0.00524
SRR5574517_1_kneaddata_paired	Cyanobacteria	9876	P	5317	201	5518	0.00083
SRR5574517_1_kneaddata_paired	Spirochaetota	32587	P	168	0	168	0.00003
SRR5574517_1_kneaddata_paired	Deferribacterota	10822	P	117	0	117	0.00002
SRR5574517_1_kneaddata_paired	Firmicutes_B	17289	P	108	3	111	0.00002
SRR5574517_1_kneaddata_paired	Firmicutes_C	17613	P	82	0	82	0.00001
SRR5574517_1_kneaddata_paired	Firmicutes_I	18140	P	67	0	67	0.00001
SRR5574517_1_kneaddata_paired	Thermotogota	33086	P	4	0	4	0.00000
SRR5574517_1_kneaddata_paired	Elusimicrobiota	11888	P	2	0	2	0.00000
SRR5574518_1_kneaddata_paired	Bacteroidota	4587	P	5465683	17349	5483032	0.63062
SRR5574518_1_kneaddata_paired	Firmicutes_A	14608	P	2472189	13881	2486070	0.28593
SRR5574518_1_kneaddata_paired	Firmicutes	12188	P	289627	2224	291851	0.03357
SRR5574518_1_kneaddata_paired	Verrucomicrobiota	33333	P	120520	5805	126325	0.01453
SRR5574518_1_kneaddata_paired	Actinobacteriota	615	P	116249	285	116534	0.01340
SRR5574518_1_kneaddata_paired	Campylobacterota	8700	P	77722	27	77749	0.00894
SRR5574518_1_kneaddata_paired	Desulfobacterota_A	11509	P	60367	138	60505	0.00696
SRR5574518_1_kneaddata_paired	Proteobacteria	22518	P	44973	75	45048	0.00518
SRR5574518_1_kneaddata_paired	Cyanobacteria	9876	P	6576	241	6817	0.00078
SRR5574518_1_kneaddata_paired	Spirochaetota	32587	P	235	0	235	0.00003
SRR5574518_1_kneaddata_paired	Deferribacterota	10822	P	165	0	165	0.00002
SRR5574518_1_kneaddata_paired	Firmicutes_B	17289	P	164	5	169	0.00002
SRR5574518_1_kneaddata_paired	Firmicutes_C	17613	P	89	0	89	0.00001
SRR5574518_1_kneaddata_paired	Firmicutes_I	18140	P	84	0	84	0.00001
SRR5574518_1_kneaddata_paired	Thermotogota	33086	P	5	0	5	0.00000
SRR5574518_1_kneaddata_paired	Elusimicrobiota	11888	P	4	0	4	0.00000
SRR5574519_1_kneaddata_paired	Bacteroidota	4587	P	3254396	11881	3266277	0.47059
SRR5574519_1_kneaddata_paired	Firmicutes_A	14608	P	3099050	16083	3115133	0.44882
SRR5574519_1_kneaddata_paired	Firmicutes	12188	P	240194	1776	241970	0.03486
SRR5574519_1_kneaddata_paired	Campylobacterota	8700	P	123430	13	123443	0.01779
SRR5574519_1_kneaddata_paired	Actinobacteriota	615	P	112207	175	112382	0.01619
SRR5574519_1_kneaddata_paired	Desulfobacterota_A	11509	P	40849	117	40966	0.00590
SRR5574519_1_kneaddata_paired	Proteobacteria	22518	P	19603	40	19643	0.00283
SRR5574519_1_kneaddata_paired	Verrucomicrobiota	33333	P	12075	520	12595	0.00181
SRR5574519_1_kneaddata_paired	Cyanobacteria	9876	P	7435	174	7609	0.00110
SRR5574519_1_kneaddata_paired	Deferribacterota	10822	P	420	0	420	0.00006
SRR5574519_1_kneaddata_paired	Spirochaetota	32587	P	127	0	127	0.00002
SRR5574519_1_kneaddata_paired	Firmicutes_B	17289	P	112	3	115	0.00002
SRR5574519_1_kneaddata_paired	Firmicutes_C	17613	P	51	0	51	0.00001
SRR5574519_1_kneaddata_paired	Firmicutes_I	18140	P	45	0	45	0.00001
SRR5574519_1_kneaddata_paired	Elusimicrobiota	11888	P	5	0	5	0.00000
SRR5574519_1_kneaddata_paired	Thermotogota	33086	P	1	0	1	0.00000
SRR5574520_1_kneaddata_paired	Bacteroidota	4587	P	4030743	14465	4045208	0.47795
SRR5574520_1_kneaddata_paired	Firmicutes_A	14608	P	3722959	19074	3742033	0.44213
SRR5574520_1_kneaddata_paired	Firmicutes	12188	P	291983	2167	294150	0.03475
SRR5574520_1_kneaddata_paired	Campylobacterota	8700	P	147207	16	147223	0.01739
SRR5574520_1_kneaddata_paired	Actinobacteriota	615	P	132858	206	133064	0.01572
SRR5574520_1_kneaddata_paired	Desulfobacterota_A	11509	P	49641	138	49779	0.00588
SRR5574520_1_kneaddata_paired	Proteobacteria	22518	P	25450	51	25501	0.00301
SRR5574520_1_kneaddata_paired	Verrucomicrobiota	33333	P	15589	661	16250	0.00192
SRR5574520_1_kneaddata_paired	Cyanobacteria	9876	P	9214	210	9424	0.00111
SRR5574520_1_kneaddata_paired	Deferribacterota	10822	P	490	0	490	0.00006
SRR5574520_1_kneaddata_paired	Spirochaetota	32587	P	196	0	196	0.00002
SRR5574520_1_kneaddata_paired	Firmicutes_B	17289	P	167	4	171	0.00002
SRR5574520_1_kneaddata_paired	Firmicutes_C	17613	P	81	0	81	0.00001
SRR5574520_1_kneaddata_paired	Firmicutes_I	18140	P	73	0	73	0.00001
SRR5574520_1_kneaddata_paired	Elusimicrobiota	11888	P	6	0	6	0.00000
SRR5574520_1_kneaddata_paired	Thermotogota	33086	P	1	0	1	0.00000
SRR5574521_1_kneaddata_paired	Bacteroidota	4587	P	4007754	14388	4022142	0.47366
SRR5574521_1_kneaddata_paired	Firmicutes_A	14608	P	3767147	19287	3786434	0.44591
SRR5574521_1_kneaddata_paired	Firmicutes	12188	P	295009	2171	297180	0.03500
SRR5574521_1_kneaddata_paired	Campylobacterota	8700	P	149743	16	149759	0.01764
SRR5574521_1_kneaddata_paired	Actinobacteriota	615	P	133292	208	133500	0.01572
SRR5574521_1_kneaddata_paired	Desulfobacterota_A	11509	P	50013	142	50155	0.00591
SRR5574521_1_kneaddata_paired	Proteobacteria	22518	P	25506	51	25557	0.00301
SRR5574521_1_kneaddata_paired	Verrucomicrobiota	33333	P	15789	670	16459	0.00194
SRR5574521_1_kneaddata_paired	Cyanobacteria	9876	P	9206	207	9413	0.00111
SRR5574521_1_kneaddata_paired	Deferribacterota	10822	P	480	0	480	0.00006
SRR5574521_1_kneaddata_paired	Spirochaetota	32587	P	178	0	178	0.00002
SRR5574521_1_kneaddata_paired	Firmicutes_B	17289	P	134	3	137	0.00002
SRR5574521_1_kneaddata_paired	Firmicutes_C	17613	P	88	0	88	0.00001
SRR5574521_1_kneaddata_paired	Firmicutes_I	18140	P	57	0	57	0.00001
SRR5574521_1_kneaddata_paired	Thermotogota	33086	P	6	0	6	0.00000
SRR5574521_1_kneaddata_paired	Elusimicrobiota	11888	P	4	0	4	0.00000
SRR5580762_1_kneaddata_paired	Bacteroidota	4587	P	29223222	94878	29318100	0.54575
SRR5580762_1_kneaddata_paired	Firmicutes_A	14608	P	10514225	56379	10570604	0.19677
SRR5580762_1_kneaddata_paired	Firmicutes	12188	P	9137839	73937	9211776	0.17147
SRR5580762_1_kneaddata_paired	Verrucomicrobiota	33333	P	1706527	21854	1728381	0.03217
SRR5580762_1_kneaddata_paired	Actinobacteriota	615	P	984344	2730	987074	0.01837
SRR5580762_1_kneaddata_paired	Proteobacteria	22518	P	791289	736	792025	0.01474
SRR5580762_1_kneaddata_paired	Desulfobacterota_A	11509	P	555476	2465	557941	0.01039
SRR5580762_1_kneaddata_paired	Deferribacterota	10822	P	244805	789	245594	0.00457
SRR5580762_1_kneaddata_paired	Campylobacterota	8700	P	153506	6	153512	0.00286
SRR5580762_1_kneaddata_paired	Cyanobacteria	9876	P	148960	1836	150796	0.00281
SRR5580762_1_kneaddata_paired	Spirochaetota	32587	P	2707	3	2710	0.00005
SRR5580762_1_kneaddata_paired	Firmicutes_C	17613	P	1265	2	1267	0.00002
SRR5580762_1_kneaddata_paired	Firmicutes_B	17289	P	920	29	949	0.00002
SRR5580762_1_kneaddata_paired	Firmicutes_I	18140	P	394	0	394	0.00001
SRR5580762_1_kneaddata_paired	Thermotogota	33086	P	45	0	45	0.00000
SRR5580762_1_kneaddata_paired	Elusimicrobiota	11888	P	29	0	29	0.00000
SRR5580763_1_kneaddata_paired	Bacteroidota	4587	P	10870534	52688	10923222	0.38269
SRR5580763_1_kneaddata_paired	Firmicutes_A	14608	P	5932404	29534	5961938	0.20887
SRR5580763_1_kneaddata_paired	Firmicutes	12188	P	4902941	34419	4937360	0.17298
SRR5580763_1_kneaddata_paired	Verrucomicrobiota	33333	P	3459739	40714	3500453	0.12264
SRR5580763_1_kneaddata_paired	Proteobacteria	22518	P	1271188	1058	1272246	0.04457
SRR5580763_1_kneaddata_paired	Actinobacteriota	615	P	1177503	2808	1180311	0.04135
SRR5580763_1_kneaddata_paired	Desulfobacterota_A	11509	P	373893	788	374681	0.01313
SRR5580763_1_kneaddata_paired	Deferribacterota	10822	P	251105	735	251840	0.00882
SRR5580763_1_kneaddata_paired	Campylobacterota	8700	P	84659	3	84662	0.00297
SRR5580763_1_kneaddata_paired	Cyanobacteria	9876	P	48306	286	48592	0.00170
SRR5580763_1_kneaddata_paired	Spirochaetota	32587	P	6429	18	6447	0.00023
SRR5580763_1_kneaddata_paired	Firmicutes_B	17289	P	957	27	984	0.00003
SRR5580763_1_kneaddata_paired	Firmicutes_I	18140	P	392	0	392	0.00001
SRR5580763_1_kneaddata_paired	Firmicutes_C	17613	P	370	0	370	0.00001
SRR5580763_1_kneaddata_paired	Thermotogota	33086	P	20	0	20	0.00000
SRR5580763_1_kneaddata_paired	Elusimicrobiota	11888	P	18	0	18	0.00000
SRR5865529_1_kneaddata_paired	Firmicutes_A	14608	P	4321414	66164	4387578	0.60550
SRR5865529_1_kneaddata_paired	Bacteroidota	4587	P	1802580	29480	1832060	0.25283
SRR5865529_1_kneaddata_paired	Firmicutes	12188	P	901254	20283	921537	0.12717
SRR5865529_1_kneaddata_paired	Desulfobacterota_A	11509	P	39988	1098	41086	0.00567
SRR5865529_1_kneaddata_paired	Deferribacterota	10822	P	37767	380	38147	0.00526
SRR5865529_1_kneaddata_paired	Actinobacteriota	615	P	15338	171	15509	0.00214
SRR5865529_1_kneaddata_paired	Proteobacteria	22518	P	6140	27	6167	0.00085
SRR5865529_1_kneaddata_paired	Cyanobacteria	9876	P	2736	255	2991	0.00041
SRR5865529_1_kneaddata_paired	Thermotogota	33086	P	388	0	388	0.00005
SRR5865529_1_kneaddata_paired	Firmicutes_B	17289	P	226	23	249	0.00003
SRR5865529_1_kneaddata_paired	Campylobacterota	8700	P	179	0	179	0.00002
SRR5865529_1_kneaddata_paired	Spirochaetota	32587	P	146	0	146	0.00002
SRR5865529_1_kneaddata_paired	Verrucomicrobiota	33333	P	112	14	126	0.00002
SRR5865529_1_kneaddata_paired	Firmicutes_I	18140	P	36	0	36	0.00000
SRR5865529_1_kneaddata_paired	Firmicutes_C	17613	P	26	0	26	0.00000
SRR5865529_1_kneaddata_paired	Elusimicrobiota	11888	P	7	0	7	0.00000
SRR5865530_1_kneaddata_paired	Bacteroidota	4587	P	4996435	79251	5075686	0.89871
SRR5865530_1_kneaddata_paired	Firmicutes_A	14608	P	310799	2848	313647	0.05553
SRR5865530_1_kneaddata_paired	Firmicutes	12188	P	94063	1167	95230	0.01686
SRR5865530_1_kneaddata_paired	Deferribacterota	10822	P	88283	431	88714	0.01571
SRR5865530_1_kneaddata_paired	Desulfobacterota_A	11509	P	23402	226	23628	0.00418
SRR5865530_1_kneaddata_paired	Proteobacteria	22518	P	17948	61	18009	0.00319
SRR5865530_1_kneaddata_paired	Verrucomicrobiota	33333	P	16509	352	16861	0.00299
SRR5865530_1_kneaddata_paired	Cyanobacteria	9876	P	12061	238	12299	0.00218
SRR5865530_1_kneaddata_paired	Actinobacteriota	615	P	3502	14	3516	0.00062
SRR5865530_1_kneaddata_paired	Spirochaetota	32587	P	98	0	98	0.00002
SRR5865530_1_kneaddata_paired	Campylobacterota	8700	P	53	0	53	0.00001
SRR5865530_1_kneaddata_paired	Firmicutes_B	17289	P	11	0	11	0.00000
SRR5865530_1_kneaddata_paired	Firmicutes_I	18140	P	9	0	9	0.00000
SRR5865530_1_kneaddata_paired	Firmicutes_C	17613	P	3	0	3	0.00000
SRR5865530_1_kneaddata_paired	Elusimicrobiota	11888	P	1	0	1	0.00000
SRR5865530_1_kneaddata_paired	Thermotogota	33086	P	1	0	1	0.00000
SRR5865531_1_kneaddata_paired	Bacteroidota	4587	P	477086	6363	483449	0.88440
SRR5865531_1_kneaddata_paired	Firmicutes_A	14608	P	36230	315	36545	0.06685
SRR5865531_1_kneaddata_paired	Cyanobacteria	9876	P	8360	69	8429	0.01542
SRR5865531_1_kneaddata_paired	Firmicutes	12188	P	8143	87	8230	0.01506
SRR5865531_1_kneaddata_paired	Deferribacterota	10822	P	6815	30	6845	0.01252
SRR5865531_1_kneaddata_paired	Desulfobacterota_A	11509	P	1397	11	1408	0.00258
SRR5865531_1_kneaddata_paired	Proteobacteria	22518	P	842	2	844	0.00154
SRR5865531_1_kneaddata_paired	Verrucomicrobiota	33333	P	575	11	586	0.00107
SRR5865531_1_kneaddata_paired	Actinobacteriota	615	P	283	0	283	0.00052
SRR5865531_1_kneaddata_paired	Spirochaetota	32587	P	10	0	10	0.00002
SRR5865531_1_kneaddata_paired	Campylobacterota	8700	P	8	0	8	0.00001
SRR5865531_1_kneaddata_paired	Thermotogota	33086	P	2	0	2	0.00000
SRR5865532_1_kneaddata_paired	Bacteroidota	4587	P	508031	5961	513992	0.63294
SRR5865532_1_kneaddata_paired	Firmicutes_A	14608	P	265117	1999	267116	0.32893
SRR5865532_1_kneaddata_paired	Firmicutes	12188	P	12748	182	12930	0.01592
SRR5865532_1_kneaddata_paired	Cyanobacteria	9876	P	6596	196	6792	0.00836
SRR5865532_1_kneaddata_paired	Deferribacterota	10822	P	4066	19	4085	0.00503
SRR5865532_1_kneaddata_paired	Desulfobacterota_A	11509	P	3967	50	4017	0.00495
SRR5865532_1_kneaddata_paired	Verrucomicrobiota	33333	P	1576	34	1610	0.00198
SRR5865532_1_kneaddata_paired	Proteobacteria	22518	P	1094	2	1096	0.00135
SRR5865532_1_kneaddata_paired	Actinobacteriota	615	P	394	2	396	0.00049
SRR5865532_1_kneaddata_paired	Campylobacterota	8700	P	10	0	10	0.00001
SRR5865532_1_kneaddata_paired	Spirochaetota	32587	P	9	0	9	0.00001
SRR5865532_1_kneaddata_paired	Firmicutes_I	18140	P	4	0	4	0.00000
SRR5865532_1_kneaddata_paired	Thermotogota	33086	P	3	0	3	0.00000
SRR5865532_1_kneaddata_paired	Firmicutes_B	17289	P	2	0	2	0.00000
SRR5865532_1_kneaddata_paired	Firmicutes_C	17613	P	2	0	2	0.00000
SRR5865533_1_kneaddata_paired	Firmicutes_A	14608	P	4099060	57475	4156535	0.55084
SRR5865533_1_kneaddata_paired	Bacteroidota	4587	P	2591056	35404	2626460	0.34807
SRR5865533_1_kneaddata_paired	Firmicutes	12188	P	636586	12718	649304	0.08605
SRR5865533_1_kneaddata_paired	Deferribacterota	10822	P	53454	473	53927	0.00715
SRR5865533_1_kneaddata_paired	Desulfobacterota_A	11509	P	27126	616	27742	0.00368
SRR5865533_1_kneaddata_paired	Proteobacteria	22518	P	11150	31	11181	0.00148
SRR5865533_1_kneaddata_paired	Cyanobacteria	9876	P	9793	333	10126	0.00134
SRR5865533_1_kneaddata_paired	Actinobacteriota	615	P	9293	104	9397	0.00125
SRR5865533_1_kneaddata_paired	Verrucomicrobiota	33333	P	337	20	357	0.00005
SRR5865533_1_kneaddata_paired	Firmicutes_B	17289	P	324	29	353	0.00005
SRR5865533_1_kneaddata_paired	Campylobacterota	8700	P	131	0	131	0.00002
SRR5865533_1_kneaddata_paired	Spirochaetota	32587	P	131	0	131	0.00002
SRR5865533_1_kneaddata_paired	Thermotogota	33086	P	64	0	64	0.00001
SRR5865533_1_kneaddata_paired	Firmicutes_I	18140	P	42	0	42	0.00001
SRR5865533_1_kneaddata_paired	Firmicutes_C	17613	P	22	0	22	0.00000
SRR5865533_1_kneaddata_paired	Elusimicrobiota	11888	P	2	0	2	0.00000
SRR5865534_1_kneaddata_paired	Bacteroidota	4587	P	438822	6027	444849	0.89493
SRR5865534_1_kneaddata_paired	Firmicutes_A	14608	P	30170	240	30410	0.06118
SRR5865534_1_kneaddata_paired	Firmicutes	12188	P	8736	95	8831	0.01777
SRR5865534_1_kneaddata_paired	Deferribacterota	10822	P	6938	29	6967	0.01402
SRR5865534_1_kneaddata_paired	Desulfobacterota_A	11509	P	1686	13	1699	0.00342
SRR5865534_1_kneaddata_paired	Proteobacteria	22518	P	1552	4	1556	0.00313
SRR5865534_1_kneaddata_paired	Verrucomicrobiota	33333	P	1252	23	1275	0.00257
SRR5865534_1_kneaddata_paired	Cyanobacteria	9876	P	1106	25	1131	0.00228
SRR5865534_1_kneaddata_paired	Actinobacteriota	615	P	350	1	351	0.00071
SRR5865534_1_kneaddata_paired	Spirochaetota	32587	P	2	0	2	0.00000
SRR5865534_1_kneaddata_paired	Campylobacterota	8700	P	1	0	1	0.00000
SRR5865534_1_kneaddata_paired	Firmicutes_B	17289	P	1	0	1	0.00000
SRR5865534_1_kneaddata_paired	Firmicutes_C	17613	P	1	0	1	0.00000
SRR5865535_1_kneaddata_paired	Bacteroidota	4587	P	1604965	21172	1626137	0.88813
SRR5865535_1_kneaddata_paired	Firmicutes_A	14608	P	124908	1006	125914	0.06877
SRR5865535_1_kneaddata_paired	Firmicutes	12188	P	25380	263	25643	0.01401
SRR5865535_1_kneaddata_paired	Cyanobacteria	9876	P	20986	174	21160	0.01156
SRR5865535_1_kneaddata_paired	Deferribacterota	10822	P	18666	81	18747	0.01024
SRR5865535_1_kneaddata_paired	Desulfobacterota_A	11509	P	6304	44	6348	0.00347
SRR5865535_1_kneaddata_paired	Proteobacteria	22518	P	3318	10	3328	0.00182
SRR5865535_1_kneaddata_paired	Verrucomicrobiota	33333	P	2383	45	2428	0.00133
SRR5865535_1_kneaddata_paired	Actinobacteriota	615	P	1204	3	1207	0.00066
SRR5865535_1_kneaddata_paired	Spirochaetota	32587	P	28	0	28	0.00002
SRR5865535_1_kneaddata_paired	Firmicutes_B	17289	P	6	0	6	0.00000
SRR5865535_1_kneaddata_paired	Campylobacterota	8700	P	5	0	5	0.00000
SRR5865535_1_kneaddata_paired	Firmicutes_I	18140	P	4	0	4	0.00000
SRR5865535_1_kneaddata_paired	Thermotogota	33086	P	1	0	1	0.00000
SRR5865536_1_kneaddata_paired	Firmicutes	12188	P	1312844	3453	1316297	0.62452
SRR5865536_1_kneaddata_paired	Proteobacteria	22518	P	500173	4986	505159	0.23968
SRR5865536_1_kneaddata_paired	Firmicutes_A	14608	P	173094	1046	174140	0.08262
SRR5865536_1_kneaddata_paired	Bacteroidota	4587	P	95917	926	96843	0.04595
SRR5865536_1_kneaddata_paired	Deferribacterota	10822	P	4902	19	4921	0.00233
SRR5865536_1_kneaddata_paired	Desulfobacterota_A	11509	P	3470	27	3497	0.00166
SRR5865536_1_kneaddata_paired	Actinobacteriota	615	P	3462	5	3467	0.00165
SRR5865536_1_kneaddata_paired	Cyanobacteria	9876	P	2158	20	2178	0.00103
SRR5865536_1_kneaddata_paired	Verrucomicrobiota	33333	P	964	17	981	0.00047
SRR5865536_1_kneaddata_paired	Firmicutes_I	18140	P	63	0	63	0.00003
SRR5865536_1_kneaddata_paired	Spirochaetota	32587	P	54	0	54	0.00003
SRR5865536_1_kneaddata_paired	Campylobacterota	8700	P	45	0	45	0.00002
SRR5865536_1_kneaddata_paired	Firmicutes_B	17289	P	22	0	22	0.00001
SRR5865536_1_kneaddata_paired	Elusimicrobiota	11888	P	5	0	5	0.00000
SRR5865536_1_kneaddata_paired	Firmicutes_C	17613	P	3	0	3	0.00000
SRR5865536_1_kneaddata_paired	Thermotogota	33086	P	3	0	3	0.00000
SRR5865538_1_kneaddata_paired	Firmicutes_A	14608	P	1790704	25427	1816131	0.78095
SRR5865538_1_kneaddata_paired	Bacteroidota	4587	P	304239	4529	308768	0.13277
SRR5865538_1_kneaddata_paired	Firmicutes	12188	P	126489	4542	131031	0.05634
SRR5865538_1_kneaddata_paired	Deferribacterota	10822	P	52539	538	53077	0.02282
SRR5865538_1_kneaddata_paired	Desulfobacterota_A	11509	P	10290	254	10544	0.00453
SRR5865538_1_kneaddata_paired	Actinobacteriota	615	P	2567	31	2598	0.00112
SRR5865538_1_kneaddata_paired	Proteobacteria	22518	P	1793	7	1800	0.00077
SRR5865538_1_kneaddata_paired	Cyanobacteria	9876	P	1052	42	1094	0.00047
SRR5865538_1_kneaddata_paired	Firmicutes_B	17289	P	185	19	204	0.00009
SRR5865538_1_kneaddata_paired	Campylobacterota	8700	P	92	0	92	0.00004
SRR5865538_1_kneaddata_paired	Spirochaetota	32587	P	78	0	78	0.00003
SRR5865538_1_kneaddata_paired	Verrucomicrobiota	33333	P	66	8	74	0.00003
SRR5865538_1_kneaddata_paired	Thermotogota	33086	P	20	0	20	0.00001
SRR5865538_1_kneaddata_paired	Firmicutes_I	18140	P	16	0	16	0.00001
SRR5865538_1_kneaddata_paired	Firmicutes_C	17613	P	11	0	11	0.00000
SRR5865538_1_kneaddata_paired	Elusimicrobiota	11888	P	3	0	3	0.00000
SRR5865540_1_kneaddata_paired	Bacteroidota	4587	P	5493655	77519	5571174	0.64366
SRR5865540_1_kneaddata_paired	Firmicutes_A	14608	P	2695808	23870	2719678	0.31422
SRR5865540_1_kneaddata_paired	Firmicutes	12188	P	163564	2477	166041	0.01918
SRR5865540_1_kneaddata_paired	Cyanobacteria	9876	P	66547	2100	68647	0.00793
SRR5865540_1_kneaddata_paired	Desulfobacterota_A	11509	P	47314	739	48053	0.00555
SRR5865540_1_kneaddata_paired	Deferribacterota	10822	P	42304	240	42544	0.00492
SRR5865540_1_kneaddata_paired	Verrucomicrobiota	33333	P	21011	530	21541	0.00249
SRR5865540_1_kneaddata_paired	Proteobacteria	22518	P	12702	27	12729	0.00147
SRR5865540_1_kneaddata_paired	Actinobacteriota	615	P	4685	26	4711	0.00054
SRR5865540_1_kneaddata_paired	Campylobacterota	8700	P	114	0	114	0.00001
SRR5865540_1_kneaddata_paired	Spirochaetota	32587	P	98	0	98	0.00001
SRR5865540_1_kneaddata_paired	Firmicutes_B	17289	P	45	2	47	0.00001
SRR5865540_1_kneaddata_paired	Thermotogota	33086	P	38	0	38	0.00000
SRR5865540_1_kneaddata_paired	Firmicutes_C	17613	P	16	0	16	0.00000
SRR5865540_1_kneaddata_paired	Firmicutes_I	18140	P	11	0	11	0.00000
SRR5865540_1_kneaddata_paired	Elusimicrobiota	11888	P	6	0	6	0.00000
SRR5865544_1_kneaddata_paired	Firmicutes_A	14608	P	1112143	13348	1125491	0.55595
SRR5865544_1_kneaddata_paired	Bacteroidota	4587	P	674818	7892	682710	0.33723
SRR5865544_1_kneaddata_paired	Firmicutes	12188	P	182629	3159	185788	0.09177
SRR5865544_1_kneaddata_paired	Deferribacterota	10822	P	15541	114	15655	0.00773
SRR5865544_1_kneaddata_paired	Desulfobacterota_A	11509	P	6422	135	6557	0.00324
SRR5865544_1_kneaddata_paired	Cyanobacteria	9876	P	3099	106	3205	0.00158
SRR5865544_1_kneaddata_paired	Proteobacteria	22518	P	2754	7	2761	0.00136
SRR5865544_1_kneaddata_paired	Actinobacteriota	615	P	1968	18	1986	0.00098
SRR5865544_1_kneaddata_paired	Firmicutes_B	17289	P	89	6	95	0.00005
SRR5865544_1_kneaddata_paired	Verrucomicrobiota	33333	P	65	4	69	0.00003
SRR5865544_1_kneaddata_paired	Campylobacterota	8700	P	49	0	49	0.00002
SRR5865544_1_kneaddata_paired	Spirochaetota	32587	P	46	0	46	0.00002
SRR5865544_1_kneaddata_paired	Thermotogota	33086	P	13	0	13	0.00001
SRR5865544_1_kneaddata_paired	Firmicutes_I	18140	P	12	0	12	0.00001
SRR5865544_1_kneaddata_paired	Firmicutes_C	17613	P	10	0	10	0.00000
SRR5865544_1_kneaddata_paired	Elusimicrobiota	11888	P	2	0	2	0.00000
SRR5925326_1_kneaddata_paired	Bacteroidota	4587	P	7273303	49207	7322510	0.77176
SRR5925326_1_kneaddata_paired	Firmicutes_A	14608	P	1476261	10792	1487053	0.15673
SRR5925326_1_kneaddata_paired	Campylobacterota	8700	P	209258	4	209262	0.02206
SRR5925326_1_kneaddata_paired	Firmicutes	12188	P	164859	1210	166069	0.01750
SRR5925326_1_kneaddata_paired	Actinobacteriota	615	P	106358	110	106468	0.01122
SRR5925326_1_kneaddata_paired	Deferribacterota	10822	P	89832	7	89839	0.00947
SRR5925326_1_kneaddata_paired	Proteobacteria	22518	P	64431	122	64553	0.00680
SRR5925326_1_kneaddata_paired	Desulfobacterota_A	11509	P	33128	206	33334	0.00351
SRR5925326_1_kneaddata_paired	Cyanobacteria	9876	P	7084	266	7350	0.00077
SRR5925326_1_kneaddata_paired	Verrucomicrobiota	33333	P	1097	49	1146	0.00012
SRR5925326_1_kneaddata_paired	Spirochaetota	32587	P	200	0	200	0.00002
SRR5925326_1_kneaddata_paired	Firmicutes_B	17289	P	130	3	133	0.00001
SRR5925326_1_kneaddata_paired	Firmicutes_I	18140	P	65	0	65	0.00001
SRR5925326_1_kneaddata_paired	Firmicutes_C	17613	P	19	0	19	0.00000
SRR5925326_1_kneaddata_paired	Elusimicrobiota	11888	P	18	0	18	0.00000
SRR5925326_1_kneaddata_paired	Thermotogota	33086	P	11	0	11	0.00000
SRR5925327_1_kneaddata_paired	Firmicutes_A	14608	P	3397679	18597	3416276	0.47644
SRR5925327_1_kneaddata_paired	Bacteroidota	4587	P	3106286	22398	3128684	0.43633
SRR5925327_1_kneaddata_paired	Campylobacterota	8700	P	240400	4	240404	0.03353
SRR5925327_1_kneaddata_paired	Deferribacterota	10822	P	202005	17	202022	0.02817
SRR5925327_1_kneaddata_paired	Firmicutes	12188	P	90523	667	91190	0.01272
SRR5925327_1_kneaddata_paired	Desulfobacterota_A	11509	P	51561	324	51885	0.00724
SRR5925327_1_kneaddata_paired	Actinobacteriota	615	P	16984	31	17015	0.00237
SRR5925327_1_kneaddata_paired	Proteobacteria	22518	P	14280	46	14326	0.00200
SRR5925327_1_kneaddata_paired	Cyanobacteria	9876	P	6473	168	6641	0.00093
SRR5925327_1_kneaddata_paired	Verrucomicrobiota	33333	P	841	38	879	0.00012
SRR5925327_1_kneaddata_paired	Firmicutes_B	17289	P	516	16	532	0.00007
SRR5925327_1_kneaddata_paired	Spirochaetota	32587	P	332	0	332	0.00005
SRR5925327_1_kneaddata_paired	Firmicutes_I	18140	P	87	0	87	0.00001
SRR5925327_1_kneaddata_paired	Thermotogota	33086	P	64	0	64	0.00001
SRR5925327_1_kneaddata_paired	Firmicutes_C	17613	P	52	0	52	0.00001
SRR5925327_1_kneaddata_paired	Elusimicrobiota	11888	P	16	0	16	0.00000
SRR5925328_1_kneaddata_paired	Bacteroidota	4587	P	6540217	49020	6589237	0.57029
SRR5925328_1_kneaddata_paired	Firmicutes_A	14608	P	4544412	28045	4572457	0.39574
SRR5925328_1_kneaddata_paired	Desulfobacterota_A	11509	P	97713	753	98466	0.00852
SRR5925328_1_kneaddata_paired	Firmicutes	12188	P	82136	757	82893	0.00717
SRR5925328_1_kneaddata_paired	Deferribacterota	10822	P	79103	7	79110	0.00685
SRR5925328_1_kneaddata_paired	Proteobacteria	22518	P	73906	97	74003	0.00640
SRR5925328_1_kneaddata_paired	Actinobacteriota	615	P	28948	75	29023	0.00251
SRR5925328_1_kneaddata_paired	Campylobacterota	8700	P	17451	0	17451	0.00151
SRR5925328_1_kneaddata_paired	Cyanobacteria	9876	P	9389	287	9676	0.00084
SRR5925328_1_kneaddata_paired	Verrucomicrobiota	33333	P	832	41	873	0.00008
SRR5925328_1_kneaddata_paired	Firmicutes_B	17289	P	535	18	553	0.00005
SRR5925328_1_kneaddata_paired	Spirochaetota	32587	P	245	0	245	0.00002
SRR5925328_1_kneaddata_paired	Firmicutes_I	18140	P	71	0	71	0.00001
SRR5925328_1_kneaddata_paired	Firmicutes_C	17613	P	54	0	54	0.00000
SRR5925328_1_kneaddata_paired	Thermotogota	33086	P	52	0	52	0.00000
SRR5925328_1_kneaddata_paired	Elusimicrobiota	11888	P	21	0	21	0.00000
SRR5925329_1_kneaddata_paired	Firmicutes_A	14608	P	5554529	30124	5584653	0.67219
SRR5925329_1_kneaddata_paired	Bacteroidota	4587	P	1893783	13289	1907072	0.22954
SRR5925329_1_kneaddata_paired	Deferribacterota	10822	P	297050	26	297076	0.03576
SRR5925329_1_kneaddata_paired	Campylobacterota	8700	P	291277	5	291282	0.03506
SRR5925329_1_kneaddata_paired	Desulfobacterota_A	11509	P	97241	437	97678	0.01176
SRR5925329_1_kneaddata_paired	Firmicutes	12188	P	96595	773	97368	0.01172
SRR5925329_1_kneaddata_paired	Proteobacteria	22518	P	15710	33	15743	0.00189
SRR5925329_1_kneaddata_paired	Actinobacteriota	615	P	8218	24	8242	0.00099
SRR5925329_1_kneaddata_paired	Cyanobacteria	9876	P	6640	130	6770	0.00081
SRR5925329_1_kneaddata_paired	Firmicutes_B	17289	P	899	29	928	0.00011
SRR5925329_1_kneaddata_paired	Verrucomicrobiota	33333	P	600	27	627	0.00008
SRR5925329_1_kneaddata_paired	Spirochaetota	32587	P	414	0	414	0.00005
SRR5925329_1_kneaddata_paired	Thermotogota	33086	P	106	0	106	0.00001
SRR5925329_1_kneaddata_paired	Firmicutes_I	18140	P	100	0	100	0.00001
SRR5925329_1_kneaddata_paired	Firmicutes_C	17613	P	73	0	73	0.00001
SRR5925329_1_kneaddata_paired	Elusimicrobiota	11888	P	24	0	24	0.00000
SRR5925330_1_kneaddata_paired	Bacteroidota	4587	P	3993397	18831	4012228	0.47055
SRR5925330_1_kneaddata_paired	Firmicutes_A	14608	P	3908248	25691	3933939	0.46137
SRR5925330_1_kneaddata_paired	Campylobacterota	8700	P	298334	48	298382	0.03499
SRR5925330_1_kneaddata_paired	Deferribacterota	10822	P	95540	272	95812	0.01124
SRR5925330_1_kneaddata_paired	Desulfobacterota_A	11509	P	86609	517	87126	0.01022
SRR5925330_1_kneaddata_paired	Verrucomicrobiota	33333	P	45641	2042	47683	0.00559
SRR5925330_1_kneaddata_paired	Firmicutes	12188	P	20055	393	20448	0.00240
SRR5925330_1_kneaddata_paired	Proteobacteria	22518	P	17001	62	17063	0.00200
SRR5925330_1_kneaddata_paired	Cyanobacteria	9876	P	6642	208	6850	0.00080
SRR5925330_1_kneaddata_paired	Actinobacteriota	615	P	6542	17	6559	0.00077
SRR5925330_1_kneaddata_paired	Firmicutes_B	17289	P	244	6	250	0.00003
SRR5925330_1_kneaddata_paired	Spirochaetota	32587	P	163	0	163	0.00002
SRR5925330_1_kneaddata_paired	Firmicutes_C	17613	P	87	0	87	0.00001
SRR5925330_1_kneaddata_paired	Firmicutes_I	18140	P	66	0	66	0.00001
SRR5925330_1_kneaddata_paired	Thermotogota	33086	P	28	0	28	0.00000
SRR5925330_1_kneaddata_paired	Elusimicrobiota	11888	P	11	0	11	0.00000
SRR5925331_1_kneaddata_paired	Bacteroidota	4587	P	4346244	18692	4364936	0.46000
SRR5925331_1_kneaddata_paired	Firmicutes_A	14608	P	4273733	22438	4296171	0.45275
SRR5925331_1_kneaddata_paired	Campylobacterota	8700	P	402968	40	403008	0.04247
SRR5925331_1_kneaddata_paired	Deferribacterota	10822	P	181497	386	181883	0.01917
SRR5925331_1_kneaddata_paired	Desulfobacterota_A	11509	P	114548	455	115003	0.01212
SRR5925331_1_kneaddata_paired	Verrucomicrobiota	33333	P	62996	2110	65106	0.00686
SRR5925331_1_kneaddata_paired	Cyanobacteria	9876	P	23001	165	23166	0.00244
SRR5925331_1_kneaddata_paired	Proteobacteria	22518	P	16546	43	16589	0.00175
SRR5925331_1_kneaddata_paired	Firmicutes	12188	P	14796	238	15034	0.00158
SRR5925331_1_kneaddata_paired	Actinobacteriota	615	P	7537	13	7550	0.00080
SRR5925331_1_kneaddata_paired	Spirochaetota	32587	P	224	0	224	0.00002
SRR5925331_1_kneaddata_paired	Firmicutes_B	17289	P	193	4	197	0.00002
SRR5925331_1_kneaddata_paired	Firmicutes_I	18140	P	66	0	66	0.00001
SRR5925331_1_kneaddata_paired	Firmicutes_C	17613	P	62	0	62	0.00001
SRR5925331_1_kneaddata_paired	Thermotogota	33086	P	30	0	30	0.00000
SRR5925331_1_kneaddata_paired	Elusimicrobiota	11888	P	6	0	6	0.00000
SRR5925332_1_kneaddata_paired	Bacteroidota	4587	P	3577625	14504	3592129	0.45866
SRR5925332_1_kneaddata_paired	Firmicutes_A	14608	P	3458992	21611	3480603	0.44442
SRR5925332_1_kneaddata_paired	Campylobacterota	8700	P	411509	88	411597	0.05255
SRR5925332_1_kneaddata_paired	Deferribacterota	10822	P	122743	328	123071	0.01571
SRR5925332_1_kneaddata_paired	Verrucomicrobiota	33333	P	88996	3742	92738	0.01184
SRR5925332_1_kneaddata_paired	Desulfobacterota_A	11509	P	87581	461	88042	0.01124
SRR5925332_1_kneaddata_paired	Firmicutes	12188	P	17535	308	17843	0.00228
SRR5925332_1_kneaddata_paired	Proteobacteria	22518	P	12973	41	13014	0.00166
SRR5925332_1_kneaddata_paired	Cyanobacteria	9876	P	6614	102	6716	0.00086
SRR5925332_1_kneaddata_paired	Actinobacteriota	615	P	5461	12	5473	0.00070
SRR5925332_1_kneaddata_paired	Spirochaetota	32587	P	255	0	255	0.00003
SRR5925332_1_kneaddata_paired	Firmicutes_B	17289	P	175	4	179	0.00002
SRR5925332_1_kneaddata_paired	Firmicutes_C	17613	P	64	0	64	0.00001
SRR5925332_1_kneaddata_paired	Firmicutes_I	18140	P	62	0	62	0.00001
SRR5925332_1_kneaddata_paired	Thermotogota	33086	P	29	0	29	0.00000
SRR5925332_1_kneaddata_paired	Elusimicrobiota	11888	P	10	0	10	0.00000
SRR5925333_1_kneaddata_paired	Firmicutes_A	14608	P	4734910	28739	4763649	0.47556
SRR5925333_1_kneaddata_paired	Bacteroidota	4587	P	4532107	21447	4553554	0.45459
SRR5925333_1_kneaddata_paired	Campylobacterota	8700	P	371431	59	371490	0.03709
SRR5925333_1_kneaddata_paired	Desulfobacterota_A	11509	P	120363	599	120962	0.01208
SRR5925333_1_kneaddata_paired	Deferribacterota	10822	P	99778	249	100027	0.00999
SRR5925333_1_kneaddata_paired	Verrucomicrobiota	33333	P	52008	2051	54059	0.00540
SRR5925333_1_kneaddata_paired	Firmicutes	12188	P	20439	429	20868	0.00208
SRR5925333_1_kneaddata_paired	Proteobacteria	22518	P	14725	42	14767	0.00147
SRR5925333_1_kneaddata_paired	Actinobacteriota	615	P	8823	18	8841	0.00088
SRR5925333_1_kneaddata_paired	Cyanobacteria	9876	P	7714	214	7928	0.00079
SRR5925333_1_kneaddata_paired	Firmicutes_B	17289	P	322	8	330	0.00003
SRR5925333_1_kneaddata_paired	Spirochaetota	32587	P	209	0	209	0.00002
SRR5925333_1_kneaddata_paired	Firmicutes_C	17613	P	83	0	83	0.00001
SRR5925333_1_kneaddata_paired	Firmicutes_I	18140	P	83	0	83	0.00001
SRR5925333_1_kneaddata_paired	Thermotogota	33086	P	29	0	29	0.00000
SRR5925333_1_kneaddata_paired	Elusimicrobiota	11888	P	21	0	21	0.00000
SRR5925334_1_kneaddata_paired	Bacteroidota	4587	P	6240333	47783	6288116	0.57949
SRR5925334_1_kneaddata_paired	Firmicutes_A	14608	P	4085784	27995	4113779	0.37911
SRR5925334_1_kneaddata_paired	Campylobacterota	8700	P	131872	49	131921	0.01216
SRR5925334_1_kneaddata_paired	Desulfobacterota_A	11509	P	126539	1196	127735	0.01177
SRR5925334_1_kneaddata_paired	Firmicutes	12188	P	82330	920	83250	0.00767
SRR5925334_1_kneaddata_paired	Actinobacteriota	615	P	39707	105	39812	0.00367
SRR5925334_1_kneaddata_paired	Deferribacterota	10822	P	35572	141	35713	0.00329
SRR5925334_1_kneaddata_paired	Proteobacteria	22518	P	24116	59	24175	0.00223
SRR5925334_1_kneaddata_paired	Cyanobacteria	9876	P	4216	204	4420	0.00041
SRR5925334_1_kneaddata_paired	Verrucomicrobiota	33333	P	1107	66	1173	0.00011
SRR5925334_1_kneaddata_paired	Firmicutes_B	17289	P	399	15	414	0.00004
SRR5925334_1_kneaddata_paired	Spirochaetota	32587	P	218	0	218	0.00002
SRR5925334_1_kneaddata_paired	Firmicutes_I	18140	P	176	0	176	0.00002
SRR5925334_1_kneaddata_paired	Firmicutes_C	17613	P	86	0	86	0.00001
SRR5925334_1_kneaddata_paired	Thermotogota	33086	P	32	0	32	0.00000
SRR5925334_1_kneaddata_paired	Elusimicrobiota	11888	P	10	0	10	0.00000
SRR5925335_1_kneaddata_paired	Bacteroidota	4587	P	8257691	61577	8319268	0.78222
SRR5925335_1_kneaddata_paired	Firmicutes_A	14608	P	1748580	14384	1762964	0.16576
SRR5925335_1_kneaddata_paired	Firmicutes	12188	P	177903	939	178842	0.01682
SRR5925335_1_kneaddata_paired	Campylobacterota	8700	P	172918	75	172993	0.01627
SRR5925335_1_kneaddata_paired	Proteobacteria	22518	P	78449	109	78558	0.00739
SRR5925335_1_kneaddata_paired	Deferribacterota	10822	P	53413	197	53610	0.00504
SRR5925335_1_kneaddata_paired	Desulfobacterota_A	11509	P	47106	462	47568	0.00447
SRR5925335_1_kneaddata_paired	Actinobacteriota	615	P	14794	50	14844	0.00140
SRR5925335_1_kneaddata_paired	Cyanobacteria	9876	P	5478	275	5753	0.00054
SRR5925335_1_kneaddata_paired	Verrucomicrobiota	33333	P	659	34	693	0.00007
SRR5925335_1_kneaddata_paired	Spirochaetota	32587	P	187	0	187	0.00002
SRR5925335_1_kneaddata_paired	Firmicutes_B	17289	P	103	3	106	0.00001
SRR5925335_1_kneaddata_paired	Firmicutes_I	18140	P	79	0	79	0.00001
SRR5925335_1_kneaddata_paired	Firmicutes_C	17613	P	26	0	26	0.00000
SRR5925335_1_kneaddata_paired	Thermotogota	33086	P	11	0	11	0.00000
SRR5925335_1_kneaddata_paired	Elusimicrobiota	11888	P	3	0	3	0.00000
SRR5925348_1_kneaddata_paired	Bacteroidota	4587	P	7547160	57685	7604845	0.59173
SRR5925348_1_kneaddata_paired	Firmicutes_A	14608	P	4708750	26336	4735086	0.36844
SRR5925348_1_kneaddata_paired	Campylobacterota	8700	P	153732	2	153734	0.01196
SRR5925348_1_kneaddata_paired	Firmicutes	12188	P	120172	1326	121498	0.00945
SRR5925348_1_kneaddata_paired	Desulfobacterota_A	11509	P	83796	596	84392	0.00657
SRR5925348_1_kneaddata_paired	Deferribacterota	10822	P	67472	6	67478	0.00525
SRR5925348_1_kneaddata_paired	Cyanobacteria	9876	P	39400	340	39740	0.00309
SRR5925348_1_kneaddata_paired	Proteobacteria	22518	P	21719	41	21760	0.00169
SRR5925348_1_kneaddata_paired	Actinobacteriota	615	P	21637	44	21681	0.00169
SRR5925348_1_kneaddata_paired	Firmicutes_B	17289	P	579	18	597	0.00005
SRR5925348_1_kneaddata_paired	Verrucomicrobiota	33333	P	530	23	553	0.00004
SRR5925348_1_kneaddata_paired	Spirochaetota	32587	P	256	0	256	0.00002
SRR5925348_1_kneaddata_paired	Firmicutes_I	18140	P	89	0	89	0.00001
SRR5925348_1_kneaddata_paired	Firmicutes_C	17613	P	65	0	65	0.00001
SRR5925348_1_kneaddata_paired	Thermotogota	33086	P	41	0	41	0.00000
SRR5925348_1_kneaddata_paired	Elusimicrobiota	11888	P	26	0	26	0.00000
SRR5925350_1_kneaddata_paired	Bacteroidota	4587	P	7172882	48558	7221440	0.73581
SRR5925350_1_kneaddata_paired	Firmicutes_A	14608	P	2128595	13551	2142146	0.21827
SRR5925350_1_kneaddata_paired	Firmicutes	12188	P	119203	818	120021	0.01223
SRR5925350_1_kneaddata_paired	Deferribacterota	10822	P	111263	8	111271	0.01134
SRR5925350_1_kneaddata_paired	Actinobacteriota	615	P	83025	110	83135	0.00847
SRR5925350_1_kneaddata_paired	Proteobacteria	22518	P	65483	107	65590	0.00668
SRR5925350_1_kneaddata_paired	Desulfobacterota_A	11509	P	38089	219	38308	0.00390
SRR5925350_1_kneaddata_paired	Campylobacterota	8700	P	23800	0	23800	0.00243
SRR5925350_1_kneaddata_paired	Cyanobacteria	9876	P	7264	279	7543	0.00077
SRR5925350_1_kneaddata_paired	Verrucomicrobiota	33333	P	419	17	436	0.00004
SRR5925350_1_kneaddata_paired	Firmicutes_B	17289	P	248	7	255	0.00003
SRR5925350_1_kneaddata_paired	Spirochaetota	32587	P	185	0	185	0.00002
SRR5925350_1_kneaddata_paired	Firmicutes_I	18140	P	56	0	56	0.00001
SRR5925350_1_kneaddata_paired	Firmicutes_C	17613	P	42	0	42	0.00000
SRR5925350_1_kneaddata_paired	Elusimicrobiota	11888	P	21	0	21	0.00000
SRR5925350_1_kneaddata_paired	Thermotogota	33086	P	15	0	15	0.00000
SRR5925351_1_kneaddata_paired	Firmicutes_A	14608	P	4195578	22292	4217870	0.66687
SRR5925351_1_kneaddata_paired	Bacteroidota	4587	P	1228458	8834	1237292	0.19562
SRR5925351_1_kneaddata_paired	Campylobacterota	8700	P	515580	9	515589	0.08152
SRR5925351_1_kneaddata_paired	Deferribacterota	10822	P	160218	14	160232	0.02533
SRR5925351_1_kneaddata_paired	Firmicutes	12188	P	113069	845	113914	0.01801
SRR5925351_1_kneaddata_paired	Desulfobacterota_A	11509	P	48342	293	48635	0.00769
SRR5925351_1_kneaddata_paired	Actinobacteriota	615	P	14106	27	14133	0.00223
SRR5925351_1_kneaddata_paired	Proteobacteria	22518	P	11479	28	11507	0.00182
SRR5925351_1_kneaddata_paired	Cyanobacteria	9876	P	4246	118	4364	0.00069
SRR5925351_1_kneaddata_paired	Spirochaetota	32587	P	395	0	395	0.00006
SRR5925351_1_kneaddata_paired	Verrucomicrobiota	33333	P	353	16	369	0.00006
SRR5925351_1_kneaddata_paired	Firmicutes_B	17289	P	329	10	339	0.00005
SRR5925351_1_kneaddata_paired	Firmicutes_I	18140	P	77	0	77	0.00001
SRR5925351_1_kneaddata_paired	Thermotogota	33086	P	68	0	68	0.00001
SRR5925351_1_kneaddata_paired	Firmicutes_C	17613	P	52	0	52	0.00001
SRR5925351_1_kneaddata_paired	Elusimicrobiota	11888	P	22	0	22	0.00000
SRR5925356_1_kneaddata_paired	Bacteroidota	4587	P	5490834	40160	5530994	0.52995
SRR5925356_1_kneaddata_paired	Firmicutes_A	14608	P	4430599	31807	4462406	0.42757
SRR5925356_1_kneaddata_paired	Campylobacterota	8700	P	184633	26	184659	0.01769
SRR5925356_1_kneaddata_paired	Desulfobacterota_A	11509	P	94727	854	95581	0.00916
SRR5925356_1_kneaddata_paired	Firmicutes	12188	P	75022	782	75804	0.00726
SRR5925356_1_kneaddata_paired	Proteobacteria	22518	P	41115	81	41196	0.00395
SRR5925356_1_kneaddata_paired	Actinobacteriota	615	P	21865	85	21950	0.00210
SRR5925356_1_kneaddata_paired	Deferribacterota	10822	P	18195	65	18260	0.00175
SRR5925356_1_kneaddata_paired	Cyanobacteria	9876	P	4422	192	4614	0.00044
SRR5925356_1_kneaddata_paired	Verrucomicrobiota	33333	P	528	11	539	0.00005
SRR5925356_1_kneaddata_paired	Firmicutes_B	17289	P	285	10	295	0.00003
SRR5925356_1_kneaddata_paired	Spirochaetota	32587	P	232	0	232	0.00002
SRR5925356_1_kneaddata_paired	Firmicutes_I	18140	P	146	0	146	0.00001
SRR5925356_1_kneaddata_paired	Firmicutes_C	17613	P	65	0	65	0.00001
SRR5925356_1_kneaddata_paired	Elusimicrobiota	11888	P	20	0	20	0.00000
SRR5925356_1_kneaddata_paired	Thermotogota	33086	P	13	0	13	0.00000
SRR5925357_1_kneaddata_paired	Firmicutes_A	14608	P	2901118	16953	2918071	0.72777
SRR5925357_1_kneaddata_paired	Bacteroidota	4587	P	646245	4963	651208	0.16241
SRR5925357_1_kneaddata_paired	Campylobacterota	8700	P	148645	52	148697	0.03709
SRR5925357_1_kneaddata_paired	Firmicutes	12188	P	117311	880	118191	0.02948
SRR5925357_1_kneaddata_paired	Deferribacterota	10822	P	110896	474	111370	0.02778
SRR5925357_1_kneaddata_paired	Desulfobacterota_A	11509	P	44605	487	45092	0.01125
SRR5925357_1_kneaddata_paired	Proteobacteria	22518	P	8033	17	8050	0.00201
SRR5925357_1_kneaddata_paired	Actinobacteriota	615	P	5449	30	5479	0.00137
SRR5925357_1_kneaddata_paired	Cyanobacteria	9876	P	2282	33	2315	0.00058
SRR5925357_1_kneaddata_paired	Spirochaetota	32587	P	391	1	392	0.00010
SRR5925357_1_kneaddata_paired	Verrucomicrobiota	33333	P	284	16	300	0.00007
SRR5925357_1_kneaddata_paired	Firmicutes_B	17289	P	249	10	259	0.00006
SRR5925357_1_kneaddata_paired	Firmicutes_I	18140	P	74	0	74	0.00002
SRR5925357_1_kneaddata_paired	Firmicutes_C	17613	P	44	0	44	0.00001
SRR5925357_1_kneaddata_paired	Elusimicrobiota	11888	P	19	0	19	0.00000
SRR5925357_1_kneaddata_paired	Thermotogota	33086	P	19	0	19	0.00000
SRR5925358_1_kneaddata_paired	Firmicutes_A	14608	P	5862119	32684	5894803	0.68666
SRR5925358_1_kneaddata_paired	Bacteroidota	4587	P	2312431	13167	2325598	0.27090
SRR5925358_1_kneaddata_paired	Campylobacterota	8700	P	116136	9	116145	0.01353
SRR5925358_1_kneaddata_paired	Desulfobacterota_A	11509	P	110483	684	111167	0.01295
SRR5925358_1_kneaddata_paired	Deferribacterota	10822	P	56148	155	56303	0.00656
SRR5925358_1_kneaddata_paired	Firmicutes	12188	P	49615	549	50164	0.00584
SRR5925358_1_kneaddata_paired	Proteobacteria	22518	P	18409	27	18436	0.00215
SRR5925358_1_kneaddata_paired	Actinobacteriota	615	P	7522	17	7539	0.00088
SRR5925358_1_kneaddata_paired	Cyanobacteria	9876	P	2279	84	2363	0.00028
SRR5925358_1_kneaddata_paired	Firmicutes_B	17289	P	904	25	929	0.00011
SRR5925358_1_kneaddata_paired	Verrucomicrobiota	33333	P	837	34	871	0.00010
SRR5925358_1_kneaddata_paired	Spirochaetota	32587	P	235	0	235	0.00003
SRR5925358_1_kneaddata_paired	Firmicutes_I	18140	P	78	0	78	0.00001
SRR5925358_1_kneaddata_paired	Firmicutes_C	17613	P	74	0	74	0.00001
SRR5925358_1_kneaddata_paired	Elusimicrobiota	11888	P	30	0	30	0.00000
SRR5925358_1_kneaddata_paired	Thermotogota	33086	P	17	0	17	0.00000
SRR5925359_1_kneaddata_paired	Bacteroidota	4587	P	8272332	66334	8338666	0.78810
SRR5925359_1_kneaddata_paired	Firmicutes_A	14608	P	1807727	22698	1830425	0.17300
SRR5925359_1_kneaddata_paired	Campylobacterota	8700	P	177165	75	177240	0.01675
SRR5925359_1_kneaddata_paired	Proteobacteria	22518	P	79834	186	80020	0.00756
SRR5925359_1_kneaddata_paired	Firmicutes	12188	P	66918	1005	67923	0.00642
SRR5925359_1_kneaddata_paired	Desulfobacterota_A	11509	P	31695	383	32078	0.00303
SRR5925359_1_kneaddata_paired	Actinobacteriota	615	P	25337	85	25422	0.00240
SRR5925359_1_kneaddata_paired	Deferribacterota	10822	P	21585	106	21691	0.00205
SRR5925359_1_kneaddata_paired	Cyanobacteria	9876	P	3546	247	3793	0.00036
SRR5925359_1_kneaddata_paired	Verrucomicrobiota	33333	P	2833	218	3051	0.00029
SRR5925359_1_kneaddata_paired	Firmicutes_B	17289	P	188	9	197	0.00002
SRR5925359_1_kneaddata_paired	Spirochaetota	32587	P	121	0	121	0.00001
SRR5925359_1_kneaddata_paired	Firmicutes_I	18140	P	71	0	71	0.00001
SRR5925359_1_kneaddata_paired	Firmicutes_C	17613	P	33	0	33	0.00000
SRR5925359_1_kneaddata_paired	Thermotogota	33086	P	10	0	10	0.00000
SRR5925359_1_kneaddata_paired	Elusimicrobiota	11888	P	7	0	7	0.00000
SRR5925360_1_kneaddata_paired	Firmicutes_A	14608	P	4508415	34556	4542971	0.50801
SRR5925360_1_kneaddata_paired	Bacteroidota	4587	P	3718775	23212	3741987	0.41844
SRR5925360_1_kneaddata_paired	Campylobacterota	8700	P	316346	45	316391	0.03538
SRR5925360_1_kneaddata_paired	Deferribacterota	10822	P	147548	562	148110	0.01656
SRR5925360_1_kneaddata_paired	Firmicutes	12188	P	86365	1092	87457	0.00978
SRR5925360_1_kneaddata_paired	Desulfobacterota_A	11509	P	62785	598	63383	0.00709
SRR5925360_1_kneaddata_paired	Proteobacteria	22518	P	28525	73	28598	0.00320
SRR5925360_1_kneaddata_paired	Actinobacteriota	615	P	8670	27	8697	0.00097
SRR5925360_1_kneaddata_paired	Cyanobacteria	9876	P	2999	135	3134	0.00035
SRR5925360_1_kneaddata_paired	Verrucomicrobiota	33333	P	1065	61	1126	0.00013
SRR5925360_1_kneaddata_paired	Firmicutes_B	17289	P	415	15	430	0.00005
SRR5925360_1_kneaddata_paired	Spirochaetota	32587	P	243	0	243	0.00003
SRR5925360_1_kneaddata_paired	Firmicutes_I	18140	P	68	0	68	0.00001
SRR5925360_1_kneaddata_paired	Firmicutes_C	17613	P	60	0	60	0.00001
SRR5925360_1_kneaddata_paired	Elusimicrobiota	11888	P	12	0	12	0.00000
SRR5925360_1_kneaddata_paired	Thermotogota	33086	P	8	0	8	0.00000
SRR5925361_1_kneaddata_paired	Bacteroidota	4587	P	10237080	68333	10305413	0.73283
SRR5925361_1_kneaddata_paired	Firmicutes_A	14608	P	3166484	35316	3201800	0.22768
SRR5925361_1_kneaddata_paired	Firmicutes	12188	P	255057	1862	256919	0.01827
SRR5925361_1_kneaddata_paired	Proteobacteria	22518	P	101504	246	101750	0.00724
SRR5925361_1_kneaddata_paired	Campylobacterota	8700	P	77793	15	77808	0.00553
SRR5925361_1_kneaddata_paired	Desulfobacterota_A	11509	P	65932	722	66654	0.00474
SRR5925361_1_kneaddata_paired	Actinobacteriota	615	P	33230	112	33342	0.00237
SRR5925361_1_kneaddata_paired	Deferribacterota	10822	P	11079	49	11128	0.00079
SRR5925361_1_kneaddata_paired	Cyanobacteria	9876	P	4396	259	4655	0.00033
SRR5925361_1_kneaddata_paired	Verrucomicrobiota	33333	P	2274	156	2430	0.00017
SRR5925361_1_kneaddata_paired	Firmicutes_B	17289	P	316	14	330	0.00002
SRR5925361_1_kneaddata_paired	Spirochaetota	32587	P	148	0	148	0.00001
SRR5925361_1_kneaddata_paired	Firmicutes_I	18140	P	113	0	113	0.00001
SRR5925361_1_kneaddata_paired	Firmicutes_C	17613	P	47	0	47	0.00000
SRR5925361_1_kneaddata_paired	Elusimicrobiota	11888	P	11	0	11	0.00000
SRR5925361_1_kneaddata_paired	Thermotogota	33086	P	1	0	1	0.00000
SRR5925362_1_kneaddata_paired	Bacteroidota	4587	P	4610265	28988	4639253	0.54545
SRR5925362_1_kneaddata_paired	Firmicutes_A	14608	P	3279390	23293	3302683	0.38830
SRR5925362_1_kneaddata_paired	Campylobacterota	8700	P	227591	65	227656	0.02677
SRR5925362_1_kneaddata_paired	Firmicutes	12188	P	88083	895	88978	0.01046
SRR5925362_1_kneaddata_paired	Deferribacterota	10822	P	78788	261	79049	0.00929
SRR5925362_1_kneaddata_paired	Desulfobacterota_A	11509	P	73868	587	74455	0.00875
SRR5925362_1_kneaddata_paired	Proteobacteria	22518	P	65769	103	65872	0.00774
SRR5925362_1_kneaddata_paired	Actinobacteriota	615	P	15980	33	16013	0.00188
SRR5925362_1_kneaddata_paired	Cyanobacteria	9876	P	6971	258	7229	0.00085
SRR5925362_1_kneaddata_paired	Verrucomicrobiota	33333	P	3197	164	3361	0.00040
SRR5925362_1_kneaddata_paired	Firmicutes_B	17289	P	420	13	433	0.00005
SRR5925362_1_kneaddata_paired	Spirochaetota	32587	P	260	0	260	0.00003
SRR5925362_1_kneaddata_paired	Firmicutes_I	18140	P	89	0	89	0.00001
SRR5925362_1_kneaddata_paired	Firmicutes_C	17613	P	53	0	53	0.00001
SRR5925362_1_kneaddata_paired	Elusimicrobiota	11888	P	33	0	33	0.00000
SRR5925362_1_kneaddata_paired	Thermotogota	33086	P	15	0	15	0.00000
SRR5925363_1_kneaddata_paired	Bacteroidota	4587	P	7775406	55377	7830783	0.68518
SRR5925363_1_kneaddata_paired	Firmicutes_A	14608	P	2890367	23105	2913472	0.25492
SRR5925363_1_kneaddata_paired	Campylobacterota	8700	P	184458	63	184521	0.01615
SRR5925363_1_kneaddata_paired	Proteobacteria	22518	P	143926	151	144077	0.01261
SRR5925363_1_kneaddata_paired	Firmicutes	12188	P	135762	959	136721	0.01196
SRR5925363_1_kneaddata_paired	Desulfobacterota_A	11509	P	100592	840	101432	0.00888
SRR5925363_1_kneaddata_paired	Deferribacterota	10822	P	57021	189	57210	0.00501
SRR5925363_1_kneaddata_paired	Actinobacteriota	615	P	51517	87	51604	0.00452
SRR5925363_1_kneaddata_paired	Cyanobacteria	9876	P	6543	276	6819	0.00060
SRR5925363_1_kneaddata_paired	Verrucomicrobiota	33333	P	1508	75	1583	0.00014
SRR5925363_1_kneaddata_paired	Firmicutes_B	17289	P	249	8	257	0.00002
SRR5925363_1_kneaddata_paired	Spirochaetota	32587	P	219	0	219	0.00002
SRR5925363_1_kneaddata_paired	Firmicutes_I	18140	P	98	0	98	0.00001
SRR5925363_1_kneaddata_paired	Firmicutes_C	17613	P	50	0	50	0.00000
SRR5925363_1_kneaddata_paired	Elusimicrobiota	11888	P	13	0	13	0.00000
SRR5925363_1_kneaddata_paired	Thermotogota	33086	P	6	0	6	0.00000
SRR5925364_1_kneaddata_paired	Bacteroidota	4587	P	6333929	44109	6378038	0.74623
SRR5925364_1_kneaddata_paired	Firmicutes_A	14608	P	1774583	12959	1787542	0.20914
SRR5925364_1_kneaddata_paired	Proteobacteria	22518	P	103337	118	103455	0.01210
SRR5925364_1_kneaddata_paired	Campylobacterota	8700	P	100077	27	100104	0.01171
SRR5925364_1_kneaddata_paired	Firmicutes	12188	P	69565	651	70216	0.00822
SRR5925364_1_kneaddata_paired	Desulfobacterota_A	11509	P	51596	399	51995	0.00608
SRR5925364_1_kneaddata_paired	Deferribacterota	10822	P	31930	98	32028	0.00375
SRR5925364_1_kneaddata_paired	Actinobacteriota	615	P	16093	29	16122	0.00189
SRR5925364_1_kneaddata_paired	Cyanobacteria	9876	P	5681	221	5902	0.00069
SRR5925364_1_kneaddata_paired	Verrucomicrobiota	33333	P	1098	51	1149	0.00013
SRR5925364_1_kneaddata_paired	Firmicutes_B	17289	P	201	6	207	0.00002
SRR5925364_1_kneaddata_paired	Spirochaetota	32587	P	163	0	163	0.00002
SRR5925364_1_kneaddata_paired	Firmicutes_I	18140	P	51	0	51	0.00001
SRR5925364_1_kneaddata_paired	Firmicutes_C	17613	P	29	0	29	0.00000
SRR5925364_1_kneaddata_paired	Thermotogota	33086	P	10	0	10	0.00000
SRR5925364_1_kneaddata_paired	Elusimicrobiota	11888	P	9	0	9	0.00000
SRR5925365_1_kneaddata_paired	Bacteroidota	4587	P	5600719	41783	5642502	0.70776
SRR5925365_1_kneaddata_paired	Firmicutes_A	14608	P	1814979	18469	1833448	0.22998
SRR5925365_1_kneaddata_paired	Campylobacterota	8700	P	225848	31	225879	0.02833
SRR5925365_1_kneaddata_paired	Firmicutes	12188	P	82094	1028	83122	0.01043
SRR5925365_1_kneaddata_paired	Deferribacterota	10822	P	67978	325	68303	0.00857
SRR5925365_1_kneaddata_paired	Proteobacteria	22518	P	56864	93	56957	0.00714
SRR5925365_1_kneaddata_paired	Desulfobacterota_A	11509	P	46504	569	47073	0.00590
SRR5925365_1_kneaddata_paired	Actinobacteriota	615	P	8677	34	8711	0.00109
SRR5925365_1_kneaddata_paired	Cyanobacteria	9876	P	4431	249	4680	0.00059
SRR5925365_1_kneaddata_paired	Verrucomicrobiota	33333	P	1019	74	1093	0.00014
SRR5925365_1_kneaddata_paired	Spirochaetota	32587	P	315	1	316	0.00004
SRR5925365_1_kneaddata_paired	Firmicutes_B	17289	P	107	5	112	0.00001
SRR5925365_1_kneaddata_paired	Firmicutes_I	18140	P	65	0	65	0.00001
SRR5925365_1_kneaddata_paired	Firmicutes_C	17613	P	25	0	25	0.00000
SRR5925365_1_kneaddata_paired	Elusimicrobiota	11888	P	13	0	13	0.00000
SRR5925365_1_kneaddata_paired	Thermotogota	33086	P	8	0	8	0.00000
SRR5927678_1_kneaddata_paired	Bacteroidota	4587	P	57643725	672804	58316529	0.79421
SRR5927678_1_kneaddata_paired	Firmicutes_A	14608	P	12291565	52040	12343605	0.16811
SRR5927678_1_kneaddata_paired	Proteobacteria	22518	P	848238	1018	849256	0.01157
SRR5927678_1_kneaddata_paired	Desulfobacterota_A	11509	P	774105	5735	779840	0.01062
SRR5927678_1_kneaddata_paired	Firmicutes	12188	P	565924	5145	571069	0.00778
SRR5927678_1_kneaddata_paired	Campylobacterota	8700	P	295207	97	295304	0.00402
SRR5927678_1_kneaddata_paired	Actinobacteriota	615	P	179163	161	179324	0.00244
SRR5927678_1_kneaddata_paired	Cyanobacteria	9876	P	43698	200	43898	0.00060
SRR5927678_1_kneaddata_paired	Deferribacterota	10822	P	22539	62	22601	0.00031
SRR5927678_1_kneaddata_paired	Spirochaetota	32587	P	19856	13	19869	0.00027
SRR5927678_1_kneaddata_paired	Firmicutes_B	17289	P	3706	108	3814	0.00005
SRR5927678_1_kneaddata_paired	Verrucomicrobiota	33333	P	995	33	1028	0.00001
SRR5927678_1_kneaddata_paired	Firmicutes_I	18140	P	367	0	367	0.00000
SRR5927678_1_kneaddata_paired	Firmicutes_C	17613	P	205	0	205	0.00000
SRR5927678_1_kneaddata_paired	Thermotogota	33086	P	26	0	26	0.00000
SRR5927678_1_kneaddata_paired	Elusimicrobiota	11888	P	23	0	23	0.00000
SRR5927679_1_kneaddata_paired	Firmicutes_A	14608	P	7402295	294440	7696735	0.51102
SRR5927679_1_kneaddata_paired	Bacteroidota	4587	P	4088260	242614	4330874	0.28755
SRR5927679_1_kneaddata_paired	Firmicutes	12188	P	1242426	77189	1319615	0.08762
SRR5927679_1_kneaddata_paired	Campylobacterota	8700	P	667790	5519	673309	0.04470
SRR5927679_1_kneaddata_paired	Cyanobacteria	9876	P	346401	6245	352646	0.02341
SRR5927679_1_kneaddata_paired	Proteobacteria	22518	P	180636	1528	182164	0.01209
SRR5927679_1_kneaddata_paired	Spirochaetota	32587	P	175983	924	176907	0.01175
SRR5927679_1_kneaddata_paired	Deferribacterota	10822	P	161959	3790	165749	0.01100
SRR5927679_1_kneaddata_paired	Actinobacteriota	615	P	99418	759	100177	0.00665
SRR5927679_1_kneaddata_paired	Desulfobacterota_A	11509	P	48886	2463	51349	0.00341
SRR5927679_1_kneaddata_paired	Verrucomicrobiota	33333	P	8255	255	8510	0.00057
SRR5927679_1_kneaddata_paired	Firmicutes_B	17289	P	2345	549	2894	0.00019
SRR5927679_1_kneaddata_paired	Firmicutes_I	18140	P	417	1	418	0.00003
SRR5927679_1_kneaddata_paired	Firmicutes_C	17613	P	60	0	60	0.00000
SRR5927679_1_kneaddata_paired	Elusimicrobiota	11888	P	30	0	30	0.00000
SRR5927679_1_kneaddata_paired	Thermotogota	33086	P	26	0	26	0.00000
SRR5927680_1_kneaddata_paired	Bacteroidota	4587	P	15597707	287667	15885374	0.66561
SRR5927680_1_kneaddata_paired	Firmicutes_A	14608	P	6156416	43286	6199702	0.25977
SRR5927680_1_kneaddata_paired	Firmicutes	12188	P	776773	12129	788902	0.03306
SRR5927680_1_kneaddata_paired	Campylobacterota	8700	P	424337	478	424815	0.01780
SRR5927680_1_kneaddata_paired	Proteobacteria	22518	P	171979	347	172326	0.00722
SRR5927680_1_kneaddata_paired	Actinobacteriota	615	P	127944	264	128208	0.00537
SRR5927680_1_kneaddata_paired	Cyanobacteria	9876	P	108323	526	108849	0.00456
SRR5927680_1_kneaddata_paired	Desulfobacterota_A	11509	P	101017	1376	102393	0.00429
SRR5927680_1_kneaddata_paired	Spirochaetota	32587	P	40284	44	40328	0.00169
SRR5927680_1_kneaddata_paired	Deferribacterota	10822	P	13133	63	13196	0.00055
SRR5927680_1_kneaddata_paired	Firmicutes_B	17289	P	1040	51	1091	0.00005
SRR5927680_1_kneaddata_paired	Verrucomicrobiota	33333	P	312	20	332	0.00001
SRR5927680_1_kneaddata_paired	Firmicutes_I	18140	P	164	0	164	0.00001
SRR5927680_1_kneaddata_paired	Firmicutes_C	17613	P	63	0	63	0.00000
SRR5927680_1_kneaddata_paired	Elusimicrobiota	11888	P	8	0	8	0.00000
SRR5927680_1_kneaddata_paired	Thermotogota	33086	P	5	0	5	0.00000
SRR5927681_1_kneaddata_paired	Bacteroidota	4587	P	47664791	729662	48394453	0.78351
SRR5927681_1_kneaddata_paired	Firmicutes_A	14608	P	11298539	75758	11374297	0.18415
SRR5927681_1_kneaddata_paired	Campylobacterota	8700	P	700163	278	700441	0.01134
SRR5927681_1_kneaddata_paired	Proteobacteria	22518	P	503089	1029	504118	0.00816
SRR5927681_1_kneaddata_paired	Firmicutes	12188	P	402915	8399	411314	0.00666
SRR5927681_1_kneaddata_paired	Desulfobacterota_A	11509	P	175201	1975	177176	0.00287
SRR5927681_1_kneaddata_paired	Cyanobacteria	9876	P	71772	499	72271	0.00117
SRR5927681_1_kneaddata_paired	Actinobacteriota	615	P	63539	72	63611	0.00103
SRR5927681_1_kneaddata_paired	Spirochaetota	32587	P	47667	46	47713	0.00077
SRR5927681_1_kneaddata_paired	Deferribacterota	10822	P	12297	53	12350	0.00020
SRR5927681_1_kneaddata_paired	Verrucomicrobiota	33333	P	4551	49	4600	0.00007
SRR5927681_1_kneaddata_paired	Firmicutes_B	17289	P	3306	144	3450	0.00006
SRR5927681_1_kneaddata_paired	Firmicutes_I	18140	P	281	0	281	0.00000
SRR5927681_1_kneaddata_paired	Firmicutes_C	17613	P	148	0	148	0.00000
SRR5927681_1_kneaddata_paired	Thermotogota	33086	P	22	0	22	0.00000
SRR5927681_1_kneaddata_paired	Elusimicrobiota	11888	P	15	0	15	0.00000
SRR5927682_1_kneaddata_paired	Bacteroidota	4587	P	42329769	609345	42939114	0.70359
SRR5927682_1_kneaddata_paired	Firmicutes_A	14608	P	16057313	89060	16146373	0.26457
SRR5927682_1_kneaddata_paired	Campylobacterota	8700	P	542489	127	542616	0.00889
SRR5927682_1_kneaddata_paired	Proteobacteria	22518	P	528384	702	529086	0.00867
SRR5927682_1_kneaddata_paired	Firmicutes	12188	P	408396	6043	414439	0.00679
SRR5927682_1_kneaddata_paired	Desulfobacterota_A	11509	P	253831	2287	256118	0.00420
SRR5927682_1_kneaddata_paired	Actinobacteriota	615	P	111912	116	112028	0.00184
SRR5927682_1_kneaddata_paired	Cyanobacteria	9876	P	43713	215	43928	0.00072
SRR5927682_1_kneaddata_paired	Deferribacterota	10822	P	24361	83	24444	0.00040
SRR5927682_1_kneaddata_paired	Spirochaetota	32587	P	14527	12	14539	0.00024
SRR5927682_1_kneaddata_paired	Firmicutes_B	17289	P	3790	133	3923	0.00006
SRR5927682_1_kneaddata_paired	Verrucomicrobiota	33333	P	1016	24	1040	0.00002
SRR5927682_1_kneaddata_paired	Firmicutes_I	18140	P	318	0	318	0.00001
SRR5927682_1_kneaddata_paired	Thermotogota	33086	P	197	0	197	0.00000
SRR5927682_1_kneaddata_paired	Firmicutes_C	17613	P	168	0	168	0.00000
SRR5927682_1_kneaddata_paired	Elusimicrobiota	11888	P	21	0	21	0.00000
SRR5927683_1_kneaddata_paired	Firmicutes_A	14608	P	4417116	164543	4581659	0.47206
SRR5927683_1_kneaddata_paired	Bacteroidota	4587	P	2847983	172705	3020688	0.31123
SRR5927683_1_kneaddata_paired	Firmicutes	12188	P	1323386	82858	1406244	0.14489
SRR5927683_1_kneaddata_paired	Cyanobacteria	9876	P	210663	3807	214470	0.02210
SRR5927683_1_kneaddata_paired	Desulfobacterota_A	11509	P	97977	4469	102446	0.01056
SRR5927683_1_kneaddata_paired	Campylobacterota	8700	P	89925	551	90476	0.00932
SRR5927683_1_kneaddata_paired	Deferribacterota	10822	P	86087	1957	88044	0.00907
SRR5927683_1_kneaddata_paired	Spirochaetota	32587	P	67257	347	67604	0.00697
SRR5927683_1_kneaddata_paired	Proteobacteria	22518	P	65564	730	66294	0.00683
SRR5927683_1_kneaddata_paired	Actinobacteriota	615	P	63250	597	63847	0.00658
SRR5927683_1_kneaddata_paired	Firmicutes_B	17289	P	2156	492	2648	0.00027
SRR5927683_1_kneaddata_paired	Firmicutes_I	18140	P	652	1	653	0.00007
SRR5927683_1_kneaddata_paired	Verrucomicrobiota	33333	P	283	67	350	0.00004
SRR5927683_1_kneaddata_paired	Firmicutes_C	17613	P	96	1	97	0.00001
SRR5927683_1_kneaddata_paired	Thermotogota	33086	P	79	0	79	0.00001
SRR5927683_1_kneaddata_paired	Elusimicrobiota	11888	P	44	0	44	0.00000
SRR5927684_1_kneaddata_paired	Bacteroidota	4587	P	74634723	849776	75484499	0.86643
SRR5927684_1_kneaddata_paired	Firmicutes_A	14608	P	8107099	37060	8144159	0.09348
SRR5927684_1_kneaddata_paired	Firmicutes	12188	P	1832832	10973	1843805	0.02116
SRR5927684_1_kneaddata_paired	Campylobacterota	8700	P	563196	353	563549	0.00647
SRR5927684_1_kneaddata_paired	Actinobacteriota	615	P	447746	61	447807	0.00514
SRR5927684_1_kneaddata_paired	Proteobacteria	22518	P	340837	667	341504	0.00392
SRR5927684_1_kneaddata_paired	Desulfobacterota_A	11509	P	195812	1395	197207	0.00226
SRR5927684_1_kneaddata_paired	Cyanobacteria	9876	P	48111	275	48386	0.00056
SRR5927684_1_kneaddata_paired	Spirochaetota	32587	P	29682	19	29701	0.00034
SRR5927684_1_kneaddata_paired	Deferribacterota	10822	P	17568	48	17616	0.00020
SRR5927684_1_kneaddata_paired	Firmicutes_B	17289	P	2210	61	2271	0.00003
SRR5927684_1_kneaddata_paired	Verrucomicrobiota	33333	P	589	12	601	0.00001
SRR5927684_1_kneaddata_paired	Firmicutes_I	18140	P	256	0	256	0.00000
SRR5927684_1_kneaddata_paired	Firmicutes_C	17613	P	85	0	85	0.00000
SRR5927684_1_kneaddata_paired	Thermotogota	33086	P	42	0	42	0.00000
SRR5927684_1_kneaddata_paired	Elusimicrobiota	11888	P	5	0	5	0.00000
SRR5927685_1_kneaddata_paired	Firmicutes_A	14608	P	44406480	384772	44791252	0.54901
SRR5927685_1_kneaddata_paired	Bacteroidota	4587	P	33197928	941936	34139864	0.41846
SRR5927685_1_kneaddata_paired	Firmicutes	12188	P	960343	24797	985140	0.01207
SRR5927685_1_kneaddata_paired	Desulfobacterota_A	11509	P	768102	8969	777071	0.00952
SRR5927685_1_kneaddata_paired	Proteobacteria	22518	P	288976	1294	290270	0.00356
SRR5927685_1_kneaddata_paired	Campylobacterota	8700	P	261015	267	261282	0.00320
SRR5927685_1_kneaddata_paired	Actinobacteriota	615	P	123719	279	123998	0.00152
SRR5927685_1_kneaddata_paired	Deferribacterota	10822	P	88886	648	89534	0.00110
SRR5927685_1_kneaddata_paired	Cyanobacteria	9876	P	72450	940	73390	0.00090
SRR5927685_1_kneaddata_paired	Spirochaetota	32587	P	38728	66	38794	0.00048
SRR5927685_1_kneaddata_paired	Firmicutes_B	17289	P	9783	720	10503	0.00013
SRR5927685_1_kneaddata_paired	Verrucomicrobiota	33333	P	2242	213	2455	0.00003
SRR5927685_1_kneaddata_paired	Firmicutes_I	18140	P	757	0	757	0.00001
SRR5927685_1_kneaddata_paired	Firmicutes_C	17613	P	723	3	726	0.00001
SRR5927685_1_kneaddata_paired	Thermotogota	33086	P	92	0	92	0.00000
SRR5927685_1_kneaddata_paired	Elusimicrobiota	11888	P	36	0	36	0.00000
SRR5927686_1_kneaddata_paired	Bacteroidota	4587	P	28479612	605096	29084708	0.61125
SRR5927686_1_kneaddata_paired	Firmicutes_A	14608	P	13653960	78506	13732466	0.28861
SRR5927686_1_kneaddata_paired	Firmicutes	12188	P	2228182	45165	2273347	0.04778
SRR5927686_1_kneaddata_paired	Campylobacterota	8700	P	1277030	542	1277572	0.02685
SRR5927686_1_kneaddata_paired	Proteobacteria	22518	P	325025	666	325691	0.00684
SRR5927686_1_kneaddata_paired	Deferribacterota	10822	P	310334	1386	311720	0.00655
SRR5927686_1_kneaddata_paired	Desulfobacterota_A	11509	P	298950	2817	301767	0.00634
SRR5927686_1_kneaddata_paired	Spirochaetota	32587	P	141031	147	141178	0.00297
SRR5927686_1_kneaddata_paired	Cyanobacteria	9876	P	65968	354	66322	0.00139
SRR5927686_1_kneaddata_paired	Actinobacteriota	615	P	60118	65	60183	0.00126
SRR5927686_1_kneaddata_paired	Firmicutes_B	17289	P	4768	213	4981	0.00010
SRR5927686_1_kneaddata_paired	Verrucomicrobiota	33333	P	990	50	1040	0.00002
SRR5927686_1_kneaddata_paired	Firmicutes_I	18140	P	815	0	815	0.00002
SRR5927686_1_kneaddata_paired	Firmicutes_C	17613	P	264	0	264	0.00001
SRR5927686_1_kneaddata_paired	Thermotogota	33086	P	80	0	80	0.00000
SRR5927686_1_kneaddata_paired	Elusimicrobiota	11888	P	53	0	53	0.00000
SRR5927687_1_kneaddata_paired	Firmicutes_A	14608	P	8066177	103703	8169880	0.54754
SRR5927687_1_kneaddata_paired	Bacteroidota	4587	P	4892816	142592	5035408	0.33747
SRR5927687_1_kneaddata_paired	Firmicutes	12188	P	705578	19448	725026	0.04859
SRR5927687_1_kneaddata_paired	Campylobacterota	8700	P	331990	692	332682	0.02230
SRR5927687_1_kneaddata_paired	Desulfobacterota_A	11509	P	197641	3921	201562	0.01351
SRR5927687_1_kneaddata_paired	Deferribacterota	10822	P	137743	1119	138862	0.00931
SRR5927687_1_kneaddata_paired	Cyanobacteria	9876	P	106102	742	106844	0.00716
SRR5927687_1_kneaddata_paired	Spirochaetota	32587	P	90826	164	90990	0.00610
SRR5927687_1_kneaddata_paired	Actinobacteriota	615	P	70762	183	70945	0.00475
SRR5927687_1_kneaddata_paired	Proteobacteria	22518	P	35335	207	35542	0.00238
SRR5927687_1_kneaddata_paired	Verrucomicrobiota	33333	P	10375	118	10493	0.00070
SRR5927687_1_kneaddata_paired	Firmicutes_B	17289	P	1962	158	2120	0.00014
SRR5927687_1_kneaddata_paired	Firmicutes_I	18140	P	374	0	374	0.00003
SRR5927687_1_kneaddata_paired	Firmicutes_C	17613	P	145	0	145	0.00001
SRR5927687_1_kneaddata_paired	Thermotogota	33086	P	90	0	90	0.00001
SRR5927687_1_kneaddata_paired	Elusimicrobiota	11888	P	20	0	20	0.00000
SRR5927688_1_kneaddata_paired	Bacteroidota	4587	P	14321124	162466	14483590	0.77401
SRR5927688_1_kneaddata_paired	Firmicutes_A	14608	P	3066105	14592	3080697	0.16463
SRR5927688_1_kneaddata_paired	Firmicutes	12188	P	595275	5552	600827	0.03211
SRR5927688_1_kneaddata_paired	Campylobacterota	8700	P	265856	174	266030	0.01422
SRR5927688_1_kneaddata_paired	Proteobacteria	22518	P	95555	112	95667	0.00511
SRR5927688_1_kneaddata_paired	Actinobacteriota	615	P	49496	57	49553	0.00265
SRR5927688_1_kneaddata_paired	Desulfobacterota_A	11509	P	47636	288	47924	0.00256
SRR5927688_1_kneaddata_paired	Cyanobacteria	9876	P	40585	118	40703	0.00218
SRR5927688_1_kneaddata_paired	Spirochaetota	32587	P	23951	15	23966	0.00128
SRR5927688_1_kneaddata_paired	Deferribacterota	10822	P	22404	59	22463	0.00120
SRR5927688_1_kneaddata_paired	Firmicutes_B	17289	P	654	17	671	0.00004
SRR5927688_1_kneaddata_paired	Verrucomicrobiota	33333	P	175	5	180	0.00001
SRR5927688_1_kneaddata_paired	Firmicutes_I	18140	P	103	0	103	0.00001
SRR5927688_1_kneaddata_paired	Firmicutes_C	17613	P	51	0	51	0.00000
SRR5927688_1_kneaddata_paired	Thermotogota	33086	P	13	0	13	0.00000
SRR5927688_1_kneaddata_paired	Elusimicrobiota	11888	P	11	0	11	0.00000
SRR5927689_1_kneaddata_paired	Bacteroidota	4587	P	50572988	784870	51357858	0.84212
SRR5927689_1_kneaddata_paired	Firmicutes_A	14608	P	5777967	32882	5810849	0.09528
SRR5927689_1_kneaddata_paired	Proteobacteria	22518	P	1279478	1473	1280951	0.02100
SRR5927689_1_kneaddata_paired	Campylobacterota	8700	P	884668	97	884765	0.01451
SRR5927689_1_kneaddata_paired	Firmicutes	12188	P	725342	9227	734569	0.01204
SRR5927689_1_kneaddata_paired	Actinobacteriota	615	P	687862	83	687945	0.01128
SRR5927689_1_kneaddata_paired	Desulfobacterota_A	11509	P	122866	984	123850	0.00203
SRR5927689_1_kneaddata_paired	Cyanobacteria	9876	P	76741	241	76982	0.00126
SRR5927689_1_kneaddata_paired	Spirochaetota	32587	P	24017	18	24035	0.00039
SRR5927689_1_kneaddata_paired	Firmicutes_B	17289	P	2142	73	2215	0.00004
SRR5927689_1_kneaddata_paired	Deferribacterota	10822	P	1519	4	1523	0.00002
SRR5927689_1_kneaddata_paired	Verrucomicrobiota	33333	P	279	8	287	0.00000
SRR5927689_1_kneaddata_paired	Firmicutes_I	18140	P	158	0	158	0.00000
SRR5927689_1_kneaddata_paired	Firmicutes_C	17613	P	80	0	80	0.00000
SRR5927689_1_kneaddata_paired	Elusimicrobiota	11888	P	11	0	11	0.00000
SRR5927689_1_kneaddata_paired	Thermotogota	33086	P	6	0	6	0.00000
SRR5927690_1_kneaddata_paired	Firmicutes_A	14608	P	31913532	438024	32351556	0.55793
SRR5927690_1_kneaddata_paired	Bacteroidota	4587	P	19152113	929684	20081797	0.34633
SRR5927690_1_kneaddata_paired	Campylobacterota	8700	P	3176961	645	3177606	0.05480
SRR5927690_1_kneaddata_paired	Firmicutes	12188	P	945379	33964	979343	0.01689
SRR5927690_1_kneaddata_paired	Desulfobacterota_A	11509	P	435696	11891	447587	0.00772
SRR5927690_1_kneaddata_paired	Deferribacterota	10822	P	333035	3282	336317	0.00580
SRR5927690_1_kneaddata_paired	Spirochaetota	32587	P	219445	535	219980	0.00379
SRR5927690_1_kneaddata_paired	Proteobacteria	22518	P	163850	1452	165302	0.00285
SRR5927690_1_kneaddata_paired	Cyanobacteria	9876	P	108580	1572	110152	0.00190
SRR5927690_1_kneaddata_paired	Actinobacteriota	615	P	98596	176	98772	0.00170
SRR5927690_1_kneaddata_paired	Firmicutes_B	17289	P	11761	1285	13046	0.00023
SRR5927690_1_kneaddata_paired	Verrucomicrobiota	33333	P	1923	291	2214	0.00004
SRR5927690_1_kneaddata_paired	Firmicutes_I	18140	P	568	0	568	0.00001
SRR5927690_1_kneaddata_paired	Firmicutes_C	17613	P	401	2	403	0.00001
SRR5927690_1_kneaddata_paired	Elusimicrobiota	11888	P	39	0	39	0.00000
SRR5927690_1_kneaddata_paired	Thermotogota	33086	P	32	0	32	0.00000
SRR5927691_1_kneaddata_paired	Bacteroidota	4587	P	51505808	1076785	52582593	0.77136
SRR5927691_1_kneaddata_paired	Firmicutes_A	14608	P	11333585	129098	11462683	0.16815
SRR5927691_1_kneaddata_paired	Proteobacteria	22518	P	1658913	3455	1662368	0.02439
SRR5927691_1_kneaddata_paired	Desulfobacterota_A	11509	P	1102405	18929	1121334	0.01645
SRR5927691_1_kneaddata_paired	Firmicutes	12188	P	668789	12122	680911	0.00999
SRR5927691_1_kneaddata_paired	Campylobacterota	8700	P	377950	63	378013	0.00555
SRR5927691_1_kneaddata_paired	Actinobacteriota	615	P	111572	280	111852	0.00164
SRR5927691_1_kneaddata_paired	Cyanobacteria	9876	P	92552	1077	93629	0.00137
SRR5927691_1_kneaddata_paired	Deferribacterota	10822	P	38498	249	38747	0.00057
SRR5927691_1_kneaddata_paired	Spirochaetota	32587	P	27526	42	27568	0.00040
SRR5927691_1_kneaddata_paired	Firmicutes_B	17289	P	5766	381	6147	0.00009
SRR5927691_1_kneaddata_paired	Verrucomicrobiota	33333	P	2399	138	2537	0.00004
SRR5927691_1_kneaddata_paired	Firmicutes_I	18140	P	388	0	388	0.00001
SRR5927691_1_kneaddata_paired	Firmicutes_C	17613	P	220	0	220	0.00000
SRR5927691_1_kneaddata_paired	Thermotogota	33086	P	34	0	34	0.00000
SRR5927691_1_kneaddata_paired	Elusimicrobiota	11888	P	26	0	26	0.00000
SRR5927692_1_kneaddata_paired	Bacteroidota	4587	P	42187086	627246	42814332	0.73451
SRR5927692_1_kneaddata_paired	Firmicutes_A	14608	P	13228732	77035	13305767	0.22827
SRR5927692_1_kneaddata_paired	Firmicutes	12188	P	670682	10485	681167	0.01169
SRR5927692_1_kneaddata_paired	Proteobacteria	22518	P	499661	1007	500668	0.00859
SRR5927692_1_kneaddata_paired	Desulfobacterota_A	11509	P	449103	4638	453741	0.00778
SRR5927692_1_kneaddata_paired	Campylobacterota	8700	P	395050	266	395316	0.00678
SRR5927692_1_kneaddata_paired	Actinobacteriota	615	P	57696	88	57784	0.00099
SRR5927692_1_kneaddata_paired	Cyanobacteria	9876	P	40397	342	40739	0.00070
SRR5927692_1_kneaddata_paired	Spirochaetota	32587	P	22903	22	22925	0.00039
SRR5927692_1_kneaddata_paired	Deferribacterota	10822	P	12671	53	12724	0.00022
SRR5927692_1_kneaddata_paired	Firmicutes_B	17289	P	3049	129	3178	0.00005
SRR5927692_1_kneaddata_paired	Verrucomicrobiota	33333	P	748	35	783	0.00001
SRR5927692_1_kneaddata_paired	Firmicutes_I	18140	P	267	0	267	0.00000
SRR5927692_1_kneaddata_paired	Firmicutes_C	17613	P	199	0	199	0.00000
SRR5927692_1_kneaddata_paired	Elusimicrobiota	11888	P	18	0	18	0.00000
SRR5927692_1_kneaddata_paired	Thermotogota	33086	P	16	0	16	0.00000
SRR5927693_1_kneaddata_paired	Bacteroidota	4587	P	40186934	749276	40936210	0.71405
SRR5927693_1_kneaddata_paired	Firmicutes_A	14608	P	14825435	110432	14935867	0.26053
SRR5927693_1_kneaddata_paired	Desulfobacterota_A	11509	P	331231	3957	335188	0.00585
SRR5927693_1_kneaddata_paired	Proteobacteria	22518	P	329909	1147	331056	0.00577
SRR5927693_1_kneaddata_paired	Firmicutes	12188	P	297396	7495	304891	0.00532
SRR5927693_1_kneaddata_paired	Campylobacterota	8700	P	196083	181	196264	0.00342
SRR5927693_1_kneaddata_paired	Actinobacteriota	615	P	142485	217	142702	0.00249
SRR5927693_1_kneaddata_paired	Cyanobacteria	9876	P	75031	510	75541	0.00132
SRR5927693_1_kneaddata_paired	Spirochaetota	32587	P	57804	62	57866	0.00101
SRR5927693_1_kneaddata_paired	Deferribacterota	10822	P	7943	36	7979	0.00014
SRR5927693_1_kneaddata_paired	Firmicutes_B	17289	P	4087	195	4282	0.00007
SRR5927693_1_kneaddata_paired	Verrucomicrobiota	33333	P	813	42	855	0.00001
SRR5927693_1_kneaddata_paired	Firmicutes_I	18140	P	318	0	318	0.00001
SRR5927693_1_kneaddata_paired	Firmicutes_C	17613	P	207	0	207	0.00000
SRR5927693_1_kneaddata_paired	Thermotogota	33086	P	25	0	25	0.00000
SRR5927693_1_kneaddata_paired	Elusimicrobiota	11888	P	17	0	17	0.00000
SRR5927694_1_kneaddata_paired	Bacteroidota	4587	P	38876662	535778	39412440	0.82767
SRR5927694_1_kneaddata_paired	Firmicutes_A	14608	P	5947892	30732	5978624	0.12555
SRR5927694_1_kneaddata_paired	Proteobacteria	22518	P	1402304	1339	1403643	0.02948
SRR5927694_1_kneaddata_paired	Firmicutes	12188	P	329948	3149	333097	0.00700
SRR5927694_1_kneaddata_paired	Campylobacterota	8700	P	224568	85	224653	0.00472
SRR5927694_1_kneaddata_paired	Desulfobacterota_A	11509	P	146746	1076	147822	0.00310
SRR5927694_1_kneaddata_paired	Actinobacteriota	615	P	60324	63	60387	0.00127
SRR5927694_1_kneaddata_paired	Cyanobacteria	9876	P	36440	159	36599	0.00077
SRR5927694_1_kneaddata_paired	Spirochaetota	32587	P	10663	7	10670	0.00022
SRR5927694_1_kneaddata_paired	Deferribacterota	10822	P	7397	22	7419	0.00016
SRR5927694_1_kneaddata_paired	Firmicutes_B	17289	P	2349	73	2422	0.00005
SRR5927694_1_kneaddata_paired	Verrucomicrobiota	33333	P	376	13	389	0.00001
SRR5927694_1_kneaddata_paired	Firmicutes_I	18140	P	144	0	144	0.00000
SRR5927694_1_kneaddata_paired	Firmicutes_C	17613	P	68	0	68	0.00000
SRR5927694_1_kneaddata_paired	Thermotogota	33086	P	15	0	15	0.00000
SRR5927694_1_kneaddata_paired	Elusimicrobiota	11888	P	11	0	11	0.00000
SRR5927695_1_kneaddata_paired	Firmicutes_A	14608	P	33936612	360940	34297552	0.56413
SRR5927695_1_kneaddata_paired	Bacteroidota	4587	P	20889636	683822	21573458	0.35485
SRR5927695_1_kneaddata_paired	Campylobacterota	8700	P	2190853	917	2191770	0.03605
SRR5927695_1_kneaddata_paired	Firmicutes	12188	P	1067365	30825	1098190	0.01806
SRR5927695_1_kneaddata_paired	Desulfobacterota_A	11509	P	785598	15140	800738	0.01317
SRR5927695_1_kneaddata_paired	Proteobacteria	22518	P	256820	1129	257949	0.00424
SRR5927695_1_kneaddata_paired	Spirochaetota	32587	P	216137	382	216519	0.00356
SRR5927695_1_kneaddata_paired	Deferribacterota	10822	P	151788	1177	152965	0.00252
SRR5927695_1_kneaddata_paired	Actinobacteriota	615	P	100554	203	100757	0.00166
SRR5927695_1_kneaddata_paired	Cyanobacteria	9876	P	89038	1094	90132	0.00148
SRR5927695_1_kneaddata_paired	Firmicutes_B	17289	P	11645	908	12553	0.00021
SRR5927695_1_kneaddata_paired	Verrucomicrobiota	33333	P	2448	251	2699	0.00004
SRR5927695_1_kneaddata_paired	Firmicutes_I	18140	P	878	0	878	0.00001
SRR5927695_1_kneaddata_paired	Firmicutes_C	17613	P	512	2	514	0.00001
SRR5927695_1_kneaddata_paired	Thermotogota	33086	P	63	0	63	0.00000
SRR5927695_1_kneaddata_paired	Elusimicrobiota	11888	P	57	0	57	0.00000
SRR5927696_1_kneaddata_paired	Bacteroidota	4587	P	35220648	671480	35892128	0.72366
SRR5927696_1_kneaddata_paired	Firmicutes_A	14608	P	10760618	80013	10840631	0.21857
SRR5927696_1_kneaddata_paired	Firmicutes	12188	P	923959	17069	941028	0.01897
SRR5927696_1_kneaddata_paired	Campylobacterota	8700	P	674303	198	674501	0.01360
SRR5927696_1_kneaddata_paired	Spirochaetota	32587	P	592292	687	592979	0.01196
SRR5927696_1_kneaddata_paired	Proteobacteria	22518	P	334776	719	335495	0.00676
SRR5927696_1_kneaddata_paired	Desulfobacterota_A	11509	P	127972	1463	129435	0.00261
SRR5927696_1_kneaddata_paired	Cyanobacteria	9876	P	85959	489	86448	0.00174
SRR5927696_1_kneaddata_paired	Actinobacteriota	615	P	60076	103	60179	0.00121
SRR5927696_1_kneaddata_paired	Deferribacterota	10822	P	40938	94	41032	0.00083
SRR5927696_1_kneaddata_paired	Firmicutes_B	17289	P	2942	153	3095	0.00006
SRR5927696_1_kneaddata_paired	Verrucomicrobiota	33333	P	458	22	480	0.00001
SRR5927696_1_kneaddata_paired	Firmicutes_I	18140	P	230	0	230	0.00000
SRR5927696_1_kneaddata_paired	Firmicutes_C	17613	P	169	0	169	0.00000
SRR5927696_1_kneaddata_paired	Elusimicrobiota	11888	P	26	0	26	0.00000
SRR5927696_1_kneaddata_paired	Thermotogota	33086	P	7	0	7	0.00000
SRR5927697_1_kneaddata_paired	Bacteroidota	4587	P	11842384	276760	12119144	0.56889
SRR5927697_1_kneaddata_paired	Firmicutes_A	14608	P	7131224	58565	7189789	0.33750
SRR5927697_1_kneaddata_paired	Campylobacterota	8700	P	664455	919	665374	0.03123
SRR5927697_1_kneaddata_paired	Firmicutes	12188	P	629786	10416	640202	0.03005
SRR5927697_1_kneaddata_paired	Desulfobacterota_A	11509	P	204427	3328	207755	0.00975
SRR5927697_1_kneaddata_paired	Actinobacteriota	615	P	150956	358	151314	0.00710
SRR5927697_1_kneaddata_paired	Cyanobacteria	9876	P	122586	666	123252	0.00579
SRR5927697_1_kneaddata_paired	Proteobacteria	22518	P	117169	370	117539	0.00552
SRR5927697_1_kneaddata_paired	Deferribacterota	10822	P	51746	316	52062	0.00244
SRR5927697_1_kneaddata_paired	Spirochaetota	32587	P	34350	46	34396	0.00161
SRR5927697_1_kneaddata_paired	Firmicutes_B	17289	P	1541	93	1634	0.00008
SRR5927697_1_kneaddata_paired	Verrucomicrobiota	33333	P	453	35	488	0.00002
SRR5927697_1_kneaddata_paired	Firmicutes_I	18140	P	144	0	144	0.00001
SRR5927697_1_kneaddata_paired	Firmicutes_C	17613	P	78	0	78	0.00000
SRR5927697_1_kneaddata_paired	Thermotogota	33086	P	34	0	34	0.00000
SRR5927697_1_kneaddata_paired	Elusimicrobiota	11888	P	5	0	5	0.00000
SRR5927698_1_kneaddata_paired	Firmicutes_A	14608	P	25308274	111436	25419710	0.51025
SRR5927698_1_kneaddata_paired	Bacteroidota	4587	P	19647625	261488	19909113	0.39963
SRR5927698_1_kneaddata_paired	Desulfobacterota_A	11509	P	1351584	12905	1364489	0.02739
SRR5927698_1_kneaddata_paired	Firmicutes	12188	P	1157843	14578	1172421	0.02353
SRR5927698_1_kneaddata_paired	Campylobacterota	8700	P	1054944	336	1055280	0.02118
SRR5927698_1_kneaddata_paired	Deferribacterota	10822	P	440494	64	440558	0.00884
SRR5927698_1_kneaddata_paired	Spirochaetota	32587	P	199535	164	199699	0.00401
SRR5927698_1_kneaddata_paired	Proteobacteria	22518	P	186334	365	186699	0.00375
SRR5927698_1_kneaddata_paired	Cyanobacteria	9876	P	34364	406	34770	0.00070
SRR5927698_1_kneaddata_paired	Actinobacteriota	615	P	28939	53	28992	0.00058
SRR5927698_1_kneaddata_paired	Firmicutes_B	17289	P	3535	129	3664	0.00007
SRR5927698_1_kneaddata_paired	Verrucomicrobiota	33333	P	1391	64	1455	0.00003
SRR5927698_1_kneaddata_paired	Firmicutes_I	18140	P	921	0	921	0.00002
SRR5927698_1_kneaddata_paired	Firmicutes_C	17613	P	424	0	424	0.00001
SRR5927698_1_kneaddata_paired	Elusimicrobiota	11888	P	48	0	48	0.00000
SRR5927698_1_kneaddata_paired	Thermotogota	33086	P	41	0	41	0.00000
SRR5927699_1_kneaddata_paired	Bacteroidota	4587	P	27773594	541173	28314767	0.66153
SRR5927699_1_kneaddata_paired	Firmicutes_A	14608	P	11195092	102110	11297202	0.26394
SRR5927699_1_kneaddata_paired	Firmicutes	12188	P	1572079	31660	1603739	0.03747
SRR5927699_1_kneaddata_paired	Proteobacteria	22518	P	1013249	2156	1015405	0.02372
SRR5927699_1_kneaddata_paired	Desulfobacterota_A	11509	P	304628	4644	309272	0.00723
SRR5927699_1_kneaddata_paired	Actinobacteriota	615	P	114935	303	115238	0.00269
SRR5927699_1_kneaddata_paired	Campylobacterota	8700	P	66614	96	66710	0.00156
SRR5927699_1_kneaddata_paired	Cyanobacteria	9876	P	45519	577	46096	0.00108
SRR5927699_1_kneaddata_paired	Spirochaetota	32587	P	16638	32	16670	0.00039
SRR5927699_1_kneaddata_paired	Deferribacterota	10822	P	11049	10	11059	0.00026
SRR5927699_1_kneaddata_paired	Firmicutes_B	17289	P	3210	215	3425	0.00008
SRR5927699_1_kneaddata_paired	Firmicutes_I	18140	P	854	0	854	0.00002
SRR5927699_1_kneaddata_paired	Verrucomicrobiota	33333	P	846	63	909	0.00002
SRR5927699_1_kneaddata_paired	Firmicutes_C	17613	P	265	1	266	0.00001
SRR5927699_1_kneaddata_paired	Thermotogota	33086	P	57	0	57	0.00000
SRR5927699_1_kneaddata_paired	Elusimicrobiota	11888	P	50	0	50	0.00000
SRR5927700_1_kneaddata_paired	Bacteroidota	4587	P	41644020	786323	42430343	0.77723
SRR5927700_1_kneaddata_paired	Firmicutes_A	14608	P	9117199	64612	9181811	0.16819
SRR5927700_1_kneaddata_paired	Campylobacterota	8700	P	936737	101	936838	0.01716
SRR5927700_1_kneaddata_paired	Proteobacteria	22518	P	750276	1318	751594	0.01377
SRR5927700_1_kneaddata_paired	Firmicutes	12188	P	579812	12083	591895	0.01084
SRR5927700_1_kneaddata_paired	Desulfobacterota_A	11509	P	472568	5787	478355	0.00876
SRR5927700_1_kneaddata_paired	Actinobacteriota	615	P	83195	122	83317	0.00153
SRR5927700_1_kneaddata_paired	Cyanobacteria	9876	P	60482	329	60811	0.00111
SRR5927700_1_kneaddata_paired	Deferribacterota	10822	P	51126	227	51353	0.00094
SRR5927700_1_kneaddata_paired	Spirochaetota	32587	P	20719	21	20740	0.00038
SRR5927700_1_kneaddata_paired	Firmicutes_B	17289	P	3411	155	3566	0.00007
SRR5927700_1_kneaddata_paired	Verrucomicrobiota	33333	P	645	30	675	0.00001
SRR5927700_1_kneaddata_paired	Firmicutes_I	18140	P	313	0	313	0.00001
SRR5927700_1_kneaddata_paired	Firmicutes_C	17613	P	152	0	152	0.00000
SRR5927700_1_kneaddata_paired	Thermotogota	33086	P	61	0	61	0.00000
SRR5927700_1_kneaddata_paired	Elusimicrobiota	11888	P	14	0	14	0.00000
SRR5927701_1_kneaddata_paired	Bacteroidota	4587	P	38748996	833419	39582415	0.60669
SRR5927701_1_kneaddata_paired	Firmicutes_A	14608	P	21853898	176151	22030049	0.33766
SRR5927701_1_kneaddata_paired	Firmicutes	12188	P	1005951	14718	1020669	0.01564
SRR5927701_1_kneaddata_paired	Campylobacterota	8700	P	739038	26	739064	0.01133
SRR5927701_1_kneaddata_paired	Proteobacteria	22518	P	590945	1116	592061	0.00907
SRR5927701_1_kneaddata_paired	Actinobacteriota	615	P	587156	165	587321	0.00900
SRR5927701_1_kneaddata_paired	Desulfobacterota_A	11509	P	441986	5817	447803	0.00686
SRR5927701_1_kneaddata_paired	Deferribacterota	10822	P	135597	659	136256	0.00209
SRR5927701_1_kneaddata_paired	Cyanobacteria	9876	P	69706	468	70174	0.00108
SRR5927701_1_kneaddata_paired	Spirochaetota	32587	P	31624	36	31660	0.00049
SRR5927701_1_kneaddata_paired	Firmicutes_B	17289	P	3714	180	3894	0.00006
SRR5927701_1_kneaddata_paired	Verrucomicrobiota	33333	P	702	42	744	0.00001
SRR5927701_1_kneaddata_paired	Firmicutes_I	18140	P	415	0	415	0.00001
SRR5927701_1_kneaddata_paired	Firmicutes_C	17613	P	198	0	198	0.00000
SRR5927701_1_kneaddata_paired	Elusimicrobiota	11888	P	41	0	41	0.00000
SRR5927701_1_kneaddata_paired	Thermotogota	33086	P	37	0	37	0.00000
SRR5927702_1_kneaddata_paired	Bacteroidota	4587	P	57129050	647529	57776579	0.80387
SRR5927702_1_kneaddata_paired	Firmicutes_A	14608	P	11183621	47346	11230967	0.15626
SRR5927702_1_kneaddata_paired	Campylobacterota	8700	P	1029763	323	1030086	0.01433
SRR5927702_1_kneaddata_paired	Desulfobacterota_A	11509	P	721607	5785	727392	0.01012
SRR5927702_1_kneaddata_paired	Proteobacteria	22518	P	482457	769	483226	0.00672
SRR5927702_1_kneaddata_paired	Firmicutes	12188	P	406844	4817	411661	0.00573
SRR5927702_1_kneaddata_paired	Actinobacteriota	615	P	69087	83	69170	0.00096
SRR5927702_1_kneaddata_paired	Cyanobacteria	9876	P	56920	332	57252	0.00080
SRR5927702_1_kneaddata_paired	Deferribacterota	10822	P	46224	127	46351	0.00064
SRR5927702_1_kneaddata_paired	Spirochaetota	32587	P	36470	24	36494	0.00051
SRR5927702_1_kneaddata_paired	Firmicutes_B	17289	P	2794	83	2877	0.00004
SRR5927702_1_kneaddata_paired	Verrucomicrobiota	33333	P	687	21	708	0.00001
SRR5927702_1_kneaddata_paired	Firmicutes_I	18140	P	305	0	305	0.00000
SRR5927702_1_kneaddata_paired	Firmicutes_C	17613	P	172	0	172	0.00000
SRR5927702_1_kneaddata_paired	Thermotogota	33086	P	26	0	26	0.00000
SRR5927702_1_kneaddata_paired	Elusimicrobiota	11888	P	17	0	17	0.00000
SRR5927703_1_kneaddata_paired	Firmicutes_A	14608	P	33931444	165470	34096914	0.76827
SRR5927703_1_kneaddata_paired	Bacteroidota	4587	P	7716843	136555	7853398	0.17695
SRR5927703_1_kneaddata_paired	Firmicutes	12188	P	1071978	32441	1104419	0.02488
SRR5927703_1_kneaddata_paired	Proteobacteria	22518	P	657732	937	658669	0.01484
SRR5927703_1_kneaddata_paired	Campylobacterota	8700	P	369636	33	369669	0.00833
SRR5927703_1_kneaddata_paired	Desulfobacterota_A	11509	P	181595	1832	183427	0.00413
SRR5927703_1_kneaddata_paired	Spirochaetota	32587	P	49694	45	49739	0.00112
SRR5927703_1_kneaddata_paired	Cyanobacteria	9876	P	19983	226	20209	0.00046
SRR5927703_1_kneaddata_paired	Actinobacteriota	615	P	19839	41	19880	0.00045
SRR5927703_1_kneaddata_paired	Deferribacterota	10822	P	15225	38	15263	0.00034
SRR5927703_1_kneaddata_paired	Firmicutes_B	17289	P	4761	190	4951	0.00011
SRR5927703_1_kneaddata_paired	Verrucomicrobiota	33333	P	3359	206	3565	0.00008
SRR5927703_1_kneaddata_paired	Firmicutes_I	18140	P	763	0	763	0.00002
SRR5927703_1_kneaddata_paired	Firmicutes_C	17613	P	349	0	349	0.00001
SRR5927703_1_kneaddata_paired	Thermotogota	33086	P	38	0	38	0.00000
SRR5927703_1_kneaddata_paired	Elusimicrobiota	11888	P	31	0	31	0.00000
SRR5927704_1_kneaddata_paired	Bacteroidota	4587	P	7578425	298054	7876479	0.63087
SRR5927704_1_kneaddata_paired	Firmicutes_A	14608	P	2699534	57793	2757327	0.22085
SRR5927704_1_kneaddata_paired	Firmicutes	12188	P	998525	31983	1030508	0.08254
SRR5927704_1_kneaddata_paired	Campylobacterota	8700	P	262893	1082	263975	0.02114
SRR5927704_1_kneaddata_paired	Cyanobacteria	9876	P	191108	1988	193096	0.01547
SRR5927704_1_kneaddata_paired	Proteobacteria	22518	P	116977	610	117587	0.00942
SRR5927704_1_kneaddata_paired	Spirochaetota	32587	P	77056	222	77278	0.00619
SRR5927704_1_kneaddata_paired	Actinobacteriota	615	P	67258	348	67606	0.00541
SRR5927704_1_kneaddata_paired	Deferribacterota	10822	P	60737	756	61493	0.00493
SRR5927704_1_kneaddata_paired	Desulfobacterota_A	11509	P	32314	938	33252	0.00266
SRR5927704_1_kneaddata_paired	Verrucomicrobiota	33333	P	4161	79	4240	0.00034
SRR5927704_1_kneaddata_paired	Firmicutes_B	17289	P	1693	215	1908	0.00015
SRR5927704_1_kneaddata_paired	Firmicutes_I	18140	P	345	0	345	0.00003
SRR5927704_1_kneaddata_paired	Firmicutes_C	17613	P	46	0	46	0.00000
SRR5927704_1_kneaddata_paired	Thermotogota	33086	P	25	0	25	0.00000
SRR5927704_1_kneaddata_paired	Elusimicrobiota	11888	P	14	0	14	0.00000
SRR5927705_1_kneaddata_paired	Bacteroidota	4587	P	22224635	402128	22626763	0.45145
SRR5927705_1_kneaddata_paired	Firmicutes_A	14608	P	18476567	93740	18570307	0.37052
SRR5927705_1_kneaddata_paired	Campylobacterota	8700	P	3887042	601	3887643	0.07757
SRR5927705_1_kneaddata_paired	Firmicutes	12188	P	2584321	40462	2624783	0.05237
SRR5927705_1_kneaddata_paired	Desulfobacterota_A	11509	P	875041	7010	882051	0.01760
SRR5927705_1_kneaddata_paired	Proteobacteria	22518	P	784854	1067	785921	0.01568
SRR5927705_1_kneaddata_paired	Deferribacterota	10822	P	401746	1510	403256	0.00805
SRR5927705_1_kneaddata_paired	Spirochaetota	32587	P	239914	204	240118	0.00479
SRR5927705_1_kneaddata_paired	Cyanobacteria	9876	P	52742	202	52944	0.00106
SRR5927705_1_kneaddata_paired	Actinobacteriota	615	P	41089	53	41142	0.00082
SRR5927705_1_kneaddata_paired	Firmicutes_B	17289	P	3122	117	3239	0.00006
SRR5927705_1_kneaddata_paired	Verrucomicrobiota	33333	P	855	37	892	0.00002
SRR5927705_1_kneaddata_paired	Firmicutes_I	18140	P	649	0	649	0.00001
SRR5927705_1_kneaddata_paired	Firmicutes_C	17613	P	324	0	324	0.00001
SRR5927705_1_kneaddata_paired	Thermotogota	33086	P	102	0	102	0.00000
SRR5927705_1_kneaddata_paired	Elusimicrobiota	11888	P	35	0	35	0.00000
SRR5927706_1_kneaddata_paired	Bacteroidota	4587	P	13170038	272688	13442726	0.58210
SRR5927706_1_kneaddata_paired	Firmicutes_A	14608	P	7446369	60700	7507069	0.32507
SRR5927706_1_kneaddata_paired	Firmicutes	12188	P	1272047	19666	1291713	0.05593
SRR5927706_1_kneaddata_paired	Campylobacterota	8700	P	265604	257	265861	0.01151
SRR5927706_1_kneaddata_paired	Actinobacteriota	615	P	210816	554	211370	0.00915
SRR5927706_1_kneaddata_paired	Cyanobacteria	9876	P	129850	569	130419	0.00565
SRR5927706_1_kneaddata_paired	Desulfobacterota_A	11509	P	87116	1222	88338	0.00383
SRR5927706_1_kneaddata_paired	Proteobacteria	22518	P	85199	264	85463	0.00370
SRR5927706_1_kneaddata_paired	Spirochaetota	32587	P	46977	57	47034	0.00204
SRR5927706_1_kneaddata_paired	Deferribacterota	10822	P	20684	112	20796	0.00090
SRR5927706_1_kneaddata_paired	Firmicutes_B	17289	P	1692	91	1783	0.00008
SRR5927706_1_kneaddata_paired	Verrucomicrobiota	33333	P	431	32	463	0.00002
SRR5927706_1_kneaddata_paired	Firmicutes_I	18140	P	205	0	205	0.00001
SRR5927706_1_kneaddata_paired	Firmicutes_C	17613	P	61	0	61	0.00000
SRR5927706_1_kneaddata_paired	Thermotogota	33086	P	57	0	57	0.00000
SRR5927706_1_kneaddata_paired	Elusimicrobiota	11888	P	6	0	6	0.00000
SRR5927707_1_kneaddata_paired	Bacteroidota	4587	P	35146418	1072205	36218623	0.75722
SRR5927707_1_kneaddata_paired	Firmicutes_A	14608	P	9119028	175701	9294729	0.19432
SRR5927707_1_kneaddata_paired	Campylobacterota	8700	P	1101763	64	1101827	0.02304
SRR5927707_1_kneaddata_paired	Firmicutes	12188	P	443633	6937	450570	0.00942
SRR5927707_1_kneaddata_paired	Desulfobacterota_A	11509	P	210347	4318	214665	0.00449
SRR5927707_1_kneaddata_paired	Proteobacteria	22518	P	208748	1155	209903	0.00439
SRR5927707_1_kneaddata_paired	Deferribacterota	10822	P	105525	855	106380	0.00222
SRR5927707_1_kneaddata_paired	Cyanobacteria	9876	P	97454	901	98355	0.00206
SRR5927707_1_kneaddata_paired	Actinobacteriota	615	P	93928	123	94051	0.00197
SRR5927707_1_kneaddata_paired	Spirochaetota	32587	P	34656	65	34721	0.00073
SRR5927707_1_kneaddata_paired	Firmicutes_B	17289	P	5299	429	5728	0.00012
SRR5927707_1_kneaddata_paired	Verrucomicrobiota	33333	P	953	86	1039	0.00002
SRR5927707_1_kneaddata_paired	Firmicutes_C	17613	P	194	0	194	0.00000
SRR5927707_1_kneaddata_paired	Firmicutes_I	18140	P	188	0	188	0.00000
SRR5927707_1_kneaddata_paired	Elusimicrobiota	11888	P	19	0	19	0.00000
SRR5927707_1_kneaddata_paired	Thermotogota	33086	P	14	0	14	0.00000
SRR5927708_1_kneaddata_paired	Firmicutes_A	14608	P	26004432	139474	26143906	0.48307
SRR5927708_1_kneaddata_paired	Bacteroidota	4587	P	24979927	476480	25456407	0.47037
SRR5927708_1_kneaddata_paired	Firmicutes	12188	P	1045353	22864	1068217	0.01974
SRR5927708_1_kneaddata_paired	Campylobacterota	8700	P	487469	134	487603	0.00901
SRR5927708_1_kneaddata_paired	Desulfobacterota_A	11509	P	387627	3842	391469	0.00723
SRR5927708_1_kneaddata_paired	Proteobacteria	22518	P	375827	553	376380	0.00695
SRR5927708_1_kneaddata_paired	Deferribacterota	10822	P	59806	14	59820	0.00111
SRR5927708_1_kneaddata_paired	Spirochaetota	32587	P	58581	57	58638	0.00108
SRR5927708_1_kneaddata_paired	Actinobacteriota	615	P	38237	47	38284	0.00071
SRR5927708_1_kneaddata_paired	Cyanobacteria	9876	P	33981	347	34328	0.00063
SRR5927708_1_kneaddata_paired	Firmicutes_B	17289	P	2839	119	2958	0.00005
SRR5927708_1_kneaddata_paired	Verrucomicrobiota	33333	P	1363	69	1432	0.00003
SRR5927708_1_kneaddata_paired	Firmicutes_I	18140	P	446	0	446	0.00001
SRR5927708_1_kneaddata_paired	Firmicutes_C	17613	P	358	0	358	0.00001
SRR5927708_1_kneaddata_paired	Thermotogota	33086	P	37	0	37	0.00000
SRR5927708_1_kneaddata_paired	Elusimicrobiota	11888	P	32	0	32	0.00000
SRR5927709_1_kneaddata_paired	Bacteroidota	4587	P	9287327	164904	9452231	0.50313
SRR5927709_1_kneaddata_paired	Firmicutes_A	14608	P	7188640	77989	7266629	0.38680
SRR5927709_1_kneaddata_paired	Campylobacterota	8700	P	747141	32	747173	0.03977
SRR5927709_1_kneaddata_paired	Proteobacteria	22518	P	385240	856	386096	0.02055
SRR5927709_1_kneaddata_paired	Firmicutes	12188	P	268439	2973	271412	0.01445
SRR5927709_1_kneaddata_paired	Deferribacterota	10822	P	188733	896	189629	0.01009
SRR5927709_1_kneaddata_paired	Cyanobacteria	9876	P	186162	770	186932	0.00995
SRR5927709_1_kneaddata_paired	Desulfobacterota_A	11509	P	152927	1848	154775	0.00824
SRR5927709_1_kneaddata_paired	Spirochaetota	32587	P	107188	114	107302	0.00571
SRR5927709_1_kneaddata_paired	Actinobacteriota	615	P	22220	39	22259	0.00118
SRR5927709_1_kneaddata_paired	Firmicutes_B	17289	P	1244	58	1302	0.00007
SRR5927709_1_kneaddata_paired	Verrucomicrobiota	33333	P	548	32	580	0.00003
SRR5927709_1_kneaddata_paired	Firmicutes_C	17613	P	191	0	191	0.00001
SRR5927709_1_kneaddata_paired	Firmicutes_I	18140	P	134	0	134	0.00001
SRR5927709_1_kneaddata_paired	Thermotogota	33086	P	14	0	14	0.00000
SRR5927709_1_kneaddata_paired	Elusimicrobiota	11888	P	13	0	13	0.00000
SRR5927710_1_kneaddata_paired	Bacteroidota	4587	P	36149514	653797	36803311	0.71752
SRR5927710_1_kneaddata_paired	Firmicutes_A	14608	P	13067772	79845	13147617	0.25633
SRR5927710_1_kneaddata_paired	Proteobacteria	22518	P	441827	1303	443130	0.00864
SRR5927710_1_kneaddata_paired	Firmicutes	12188	P	290158	3207	293365	0.00572
SRR5927710_1_kneaddata_paired	Campylobacterota	8700	P	266275	112	266387	0.00519
SRR5927710_1_kneaddata_paired	Spirochaetota	32587	P	116799	106	116905	0.00228
SRR5927710_1_kneaddata_paired	Desulfobacterota_A	11509	P	86512	1042	87554	0.00171
SRR5927710_1_kneaddata_paired	Deferribacterota	10822	P	72387	296	72683	0.00142
SRR5927710_1_kneaddata_paired	Cyanobacteria	9876	P	33803	173	33976	0.00066
SRR5927710_1_kneaddata_paired	Actinobacteriota	615	P	24458	26	24484	0.00048
SRR5927710_1_kneaddata_paired	Firmicutes_B	17289	P	1812	74	1886	0.00004
SRR5927710_1_kneaddata_paired	Verrucomicrobiota	33333	P	967	56	1023	0.00002
SRR5927710_1_kneaddata_paired	Firmicutes_I	18140	P	119	0	119	0.00000
SRR5927710_1_kneaddata_paired	Firmicutes_C	17613	P	89	0	89	0.00000
SRR5927710_1_kneaddata_paired	Thermotogota	33086	P	21	0	21	0.00000
SRR5927710_1_kneaddata_paired	Elusimicrobiota	11888	P	8	0	8	0.00000
SRR5927711_1_kneaddata_paired	Firmicutes_A	14608	P	8181543	211292	8392835	0.52347
SRR5927711_1_kneaddata_paired	Bacteroidota	4587	P	5061039	278682	5339721	0.33304
SRR5927711_1_kneaddata_paired	Firmicutes	12188	P	1229170	65221	1294391	0.08073
SRR5927711_1_kneaddata_paired	Cyanobacteria	9876	P	265102	3961	269063	0.01678
SRR5927711_1_kneaddata_paired	Desulfobacterota_A	11509	P	171690	6672	178362	0.01112
SRR5927711_1_kneaddata_paired	Campylobacterota	8700	P	170302	725	171027	0.01067
SRR5927711_1_kneaddata_paired	Proteobacteria	22518	P	110530	884	111414	0.00695
SRR5927711_1_kneaddata_paired	Deferribacterota	10822	P	92755	101	92856	0.00579
SRR5927711_1_kneaddata_paired	Spirochaetota	32587	P	89418	368	89786	0.00560
SRR5927711_1_kneaddata_paired	Actinobacteriota	615	P	88455	585	89040	0.00555
SRR5927711_1_kneaddata_paired	Firmicutes_B	17289	P	2560	472	3032	0.00019
SRR5927711_1_kneaddata_paired	Verrucomicrobiota	33333	P	618	146	764	0.00005
SRR5927711_1_kneaddata_paired	Firmicutes_I	18140	P	574	1	575	0.00004
SRR5927711_1_kneaddata_paired	Firmicutes_C	17613	P	175	1	176	0.00001
SRR5927711_1_kneaddata_paired	Elusimicrobiota	11888	P	41	0	41	0.00000
SRR5927711_1_kneaddata_paired	Thermotogota	33086	P	37	0	37	0.00000
SRR5927712_1_kneaddata_paired	Bacteroidota	4587	P	34498274	720342	35218616	0.61962
SRR5927712_1_kneaddata_paired	Firmicutes_A	14608	P	16795551	160008	16955559	0.29831
SRR5927712_1_kneaddata_paired	Firmicutes	12188	P	1926800	43325	1970125	0.03466
SRR5927712_1_kneaddata_paired	Proteobacteria	22518	P	678681	1779	680460	0.01197
SRR5927712_1_kneaddata_paired	Campylobacterota	8700	P	640310	738	641048	0.01128
SRR5927712_1_kneaddata_paired	Desulfobacterota_A	11509	P	630320	10319	640639	0.01127
SRR5927712_1_kneaddata_paired	Deferribacterota	10822	P	358793	2296	361089	0.00635
SRR5927712_1_kneaddata_paired	Spirochaetota	32587	P	139828	207	140035	0.00246
SRR5927712_1_kneaddata_paired	Actinobacteriota	615	P	111278	198	111476	0.00196
SRR5927712_1_kneaddata_paired	Cyanobacteria	9876	P	110480	944	111424	0.00196
SRR5927712_1_kneaddata_paired	Firmicutes_B	17289	P	5833	375	6208	0.00011
SRR5927712_1_kneaddata_paired	Verrucomicrobiota	33333	P	989	83	1072	0.00002
SRR5927712_1_kneaddata_paired	Firmicutes_I	18140	P	850	0	850	0.00001
SRR5927712_1_kneaddata_paired	Firmicutes_C	17613	P	234	0	234	0.00000
SRR5927712_1_kneaddata_paired	Elusimicrobiota	11888	P	60	0	60	0.00000
SRR5927712_1_kneaddata_paired	Thermotogota	33086	P	43	0	43	0.00000
SRR5927713_1_kneaddata_paired	Firmicutes_A	14608	P	12282618	198161	12480779	0.59145
SRR5927713_1_kneaddata_paired	Bacteroidota	4587	P	6951541	334719	7286260	0.34528
SRR5927713_1_kneaddata_paired	Firmicutes	12188	P	387665	13625	401290	0.01902
SRR5927713_1_kneaddata_paired	Deferribacterota	10822	P	255347	2956	258303	0.01224
SRR5927713_1_kneaddata_paired	Cyanobacteria	9876	P	196836	1798	198634	0.00941
SRR5927713_1_kneaddata_paired	Campylobacterota	8700	P	169837	180	170017	0.00806
SRR5927713_1_kneaddata_paired	Spirochaetota	32587	P	119943	304	120247	0.00570
SRR5927713_1_kneaddata_paired	Desulfobacterota_A	11509	P	107936	3486	111422	0.00528
SRR5927713_1_kneaddata_paired	Actinobacteriota	615	P	43133	101	43234	0.00205
SRR5927713_1_kneaddata_paired	Proteobacteria	22518	P	27668	406	28074	0.00133
SRR5927713_1_kneaddata_paired	Firmicutes_B	17289	P	2712	311	3023	0.00014
SRR5927713_1_kneaddata_paired	Verrucomicrobiota	33333	P	576	98	674	0.00003
SRR5927713_1_kneaddata_paired	Firmicutes_I	18140	P	102	0	102	0.00000
SRR5927713_1_kneaddata_paired	Firmicutes_C	17613	P	78	0	78	0.00000
SRR5927713_1_kneaddata_paired	Thermotogota	33086	P	12	0	12	0.00000
SRR5927713_1_kneaddata_paired	Elusimicrobiota	11888	P	8	0	8	0.00000
SRR5927714_1_kneaddata_paired	Bacteroidota	4587	P	6301103	182579	6483682	0.54913
SRR5927714_1_kneaddata_paired	Firmicutes_A	14608	P	3088498	35467	3123965	0.26458
SRR5927714_1_kneaddata_paired	Firmicutes	12188	P	1257531	27545	1285076	0.10884
SRR5927714_1_kneaddata_paired	Campylobacterota	8700	P	399245	266	399511	0.03384
SRR5927714_1_kneaddata_paired	Proteobacteria	22518	P	170231	419	170650	0.01445
SRR5927714_1_kneaddata_paired	Cyanobacteria	9876	P	104968	635	105603	0.00894
SRR5927714_1_kneaddata_paired	Spirochaetota	32587	P	97459	163	97622	0.00827
SRR5927714_1_kneaddata_paired	Actinobacteriota	615	P	59643	385	60028	0.00508
SRR5927714_1_kneaddata_paired	Desulfobacterota_A	11509	P	43382	891	44273	0.00375
SRR5927714_1_kneaddata_paired	Deferribacterota	10822	P	33230	252	33482	0.00284
SRR5927714_1_kneaddata_paired	Verrucomicrobiota	33333	P	2067	36	2103	0.00018
SRR5927714_1_kneaddata_paired	Firmicutes_B	17289	P	991	74	1065	0.00009
SRR5927714_1_kneaddata_paired	Firmicutes_I	18140	P	125	0	125	0.00001
SRR5927714_1_kneaddata_paired	Firmicutes_C	17613	P	44	0	44	0.00000
SRR5927714_1_kneaddata_paired	Thermotogota	33086	P	12	0	12	0.00000
SRR5927714_1_kneaddata_paired	Elusimicrobiota	11888	P	11	0	11	0.00000
SRR5927715_1_kneaddata_paired	Bacteroidota	4587	P	49304014	453165	49757179	0.84521
SRR5927715_1_kneaddata_paired	Firmicutes_A	14608	P	7429653	26061	7455714	0.12665
SRR5927715_1_kneaddata_paired	Campylobacterota	8700	P	560385	332	560717	0.00952
SRR5927715_1_kneaddata_paired	Proteobacteria	22518	P	518329	524	518853	0.00881
SRR5927715_1_kneaddata_paired	Firmicutes	12188	P	233383	2665	236048	0.00401
SRR5927715_1_kneaddata_paired	Desulfobacterota_A	11509	P	214052	1208	215260	0.00366
SRR5927715_1_kneaddata_paired	Actinobacteriota	615	P	44447	41	44488	0.00076
SRR5927715_1_kneaddata_paired	Spirochaetota	32587	P	30437	15	30452	0.00052
SRR5927715_1_kneaddata_paired	Deferribacterota	10822	P	25867	59	25926	0.00044
SRR5927715_1_kneaddata_paired	Cyanobacteria	9876	P	22858	192	23050	0.00039
SRR5927715_1_kneaddata_paired	Firmicutes_B	17289	P	1419	32	1451	0.00002
SRR5927715_1_kneaddata_paired	Verrucomicrobiota	33333	P	482	8	490	0.00001
SRR5927715_1_kneaddata_paired	Firmicutes_I	18140	P	134	0	134	0.00000
SRR5927715_1_kneaddata_paired	Firmicutes_C	17613	P	96	0	96	0.00000
SRR5927715_1_kneaddata_paired	Elusimicrobiota	11888	P	13	0	13	0.00000
SRR5927715_1_kneaddata_paired	Thermotogota	33086	P	9	0	9	0.00000
SRR5927716_1_kneaddata_paired	Bacteroidota	4587	P	39617735	610353	40228088	0.56314
SRR5927716_1_kneaddata_paired	Firmicutes_A	14608	P	28175942	130091	28306033	0.39625
SRR5927716_1_kneaddata_paired	Desulfobacterota_A	11509	P	1218172	11786	1229958	0.01722
SRR5927716_1_kneaddata_paired	Campylobacterota	8700	P	699074	110	699184	0.00979
SRR5927716_1_kneaddata_paired	Firmicutes	12188	P	410818	7575	418393	0.00586
SRR5927716_1_kneaddata_paired	Proteobacteria	22518	P	392513	654	393167	0.00550
SRR5927716_1_kneaddata_paired	Actinobacteriota	615	P	51614	87	51701	0.00072
SRR5927716_1_kneaddata_paired	Cyanobacteria	9876	P	50149	316	50465	0.00071
SRR5927716_1_kneaddata_paired	Deferribacterota	10822	P	30462	109	30571	0.00043
SRR5927716_1_kneaddata_paired	Spirochaetota	32587	P	18452	15	18467	0.00026
SRR5927716_1_kneaddata_paired	Firmicutes_B	17289	P	6842	250	7092	0.00010
SRR5927716_1_kneaddata_paired	Verrucomicrobiota	33333	P	1304	58	1362	0.00002
SRR5927716_1_kneaddata_paired	Firmicutes_I	18140	P	445	0	445	0.00001
SRR5927716_1_kneaddata_paired	Firmicutes_C	17613	P	387	0	387	0.00001
SRR5927716_1_kneaddata_paired	Thermotogota	33086	P	143	0	143	0.00000
SRR5927716_1_kneaddata_paired	Elusimicrobiota	11888	P	33	0	33	0.00000
SRR5927717_1_kneaddata_paired	Bacteroidota	4587	P	40968980	574332	41543312	0.83557
SRR5927717_1_kneaddata_paired	Firmicutes_A	14608	P	6856718	47726	6904444	0.13887
SRR5927717_1_kneaddata_paired	Proteobacteria	22518	P	572175	930	573105	0.01153
SRR5927717_1_kneaddata_paired	Firmicutes	12188	P	228806	4123	232929	0.00468
SRR5927717_1_kneaddata_paired	Campylobacterota	8700	P	174281	136	174417	0.00351
SRR5927717_1_kneaddata_paired	Actinobacteriota	615	P	117711	175	117886	0.00237
SRR5927717_1_kneaddata_paired	Desulfobacterota_A	11509	P	76068	705	76773	0.00154
SRR5927717_1_kneaddata_paired	Cyanobacteria	9876	P	67609	374	67983	0.00137
SRR5927717_1_kneaddata_paired	Spirochaetota	32587	P	21116	19	21135	0.00043
SRR5927717_1_kneaddata_paired	Deferribacterota	10822	P	3569	1	3570	0.00007
SRR5927717_1_kneaddata_paired	Firmicutes_B	17289	P	2207	90	2297	0.00005
SRR5927717_1_kneaddata_paired	Verrucomicrobiota	33333	P	406	15	421	0.00001
SRR5927717_1_kneaddata_paired	Firmicutes_I	18140	P	167	0	167	0.00000
SRR5927717_1_kneaddata_paired	Firmicutes_C	17613	P	78	0	78	0.00000
SRR5927717_1_kneaddata_paired	Elusimicrobiota	11888	P	8	0	8	0.00000
SRR5927717_1_kneaddata_paired	Thermotogota	33086	P	7	0	7	0.00000
SRR5927718_1_kneaddata_paired	Firmicutes_A	14608	P	23138449	217981	23356430	0.66376
SRR5927718_1_kneaddata_paired	Bacteroidota	4587	P	9127758	244871	9372629	0.26636
SRR5927718_1_kneaddata_paired	Campylobacterota	8700	P	1404989	450	1405439	0.03994
SRR5927718_1_kneaddata_paired	Firmicutes	12188	P	473581	14111	487692	0.01386
SRR5927718_1_kneaddata_paired	Desulfobacterota_A	11509	P	328670	6282	334952	0.00952
SRR5927718_1_kneaddata_paired	Proteobacteria	22518	P	79413	327	79740	0.00227
SRR5927718_1_kneaddata_paired	Deferribacterota	10822	P	60384	22	60406	0.00172
SRR5927718_1_kneaddata_paired	Cyanobacteria	9876	P	30690	548	31238	0.00089
SRR5927718_1_kneaddata_paired	Actinobacteriota	615	P	27876	64	27940	0.00079
SRR5927718_1_kneaddata_paired	Spirochaetota	32587	P	26147	45	26192	0.00074
SRR5927718_1_kneaddata_paired	Firmicutes_B	17289	P	3141	240	3381	0.00010
SRR5927718_1_kneaddata_paired	Verrucomicrobiota	33333	P	1017	106	1123	0.00003
SRR5927718_1_kneaddata_paired	Firmicutes_I	18140	P	382	0	382	0.00001
SRR5927718_1_kneaddata_paired	Firmicutes_C	17613	P	269	1	270	0.00001
SRR5927718_1_kneaddata_paired	Elusimicrobiota	11888	P	27	0	27	0.00000
SRR5927718_1_kneaddata_paired	Thermotogota	33086	P	13	0	13	0.00000
SRR5927719_1_kneaddata_paired	Bacteroidota	4587	P	12384502	218516	12603018	0.68843
SRR5927719_1_kneaddata_paired	Firmicutes_A	14608	P	4369684	37823	4407507	0.24076
SRR5927719_1_kneaddata_paired	Firmicutes	12188	P	638521	7749	646270	0.03530
SRR5927719_1_kneaddata_paired	Campylobacterota	8700	P	276632	315	276947	0.01513
SRR5927719_1_kneaddata_paired	Proteobacteria	22518	P	148278	302	148580	0.00812
SRR5927719_1_kneaddata_paired	Cyanobacteria	9876	P	80101	413	80514	0.00440
SRR5927719_1_kneaddata_paired	Actinobacteriota	615	P	76506	168	76674	0.00419
SRR5927719_1_kneaddata_paired	Desulfobacterota_A	11509	P	36231	453	36684	0.00200
SRR5927719_1_kneaddata_paired	Spirochaetota	32587	P	23972	25	23997	0.00131
SRR5927719_1_kneaddata_paired	Deferribacterota	10822	P	5614	2	5616	0.00031
SRR5927719_1_kneaddata_paired	Firmicutes_B	17289	P	761	37	798	0.00004
SRR5927719_1_kneaddata_paired	Verrucomicrobiota	33333	P	231	13	244	0.00001
SRR5927719_1_kneaddata_paired	Firmicutes_I	18140	P	114	0	114	0.00001
SRR5927719_1_kneaddata_paired	Firmicutes_C	17613	P	35	0	35	0.00000
SRR5927719_1_kneaddata_paired	Elusimicrobiota	11888	P	7	0	7	0.00000
SRR5927719_1_kneaddata_paired	Thermotogota	33086	P	3	0	3	0.00000
SRR5927720_1_kneaddata_paired	Bacteroidota	4587	P	40033189	996744	41029933	0.75963
SRR5927720_1_kneaddata_paired	Firmicutes_A	14608	P	7655761	73383	7729144	0.14310
SRR5927720_1_kneaddata_paired	Campylobacterota	8700	P	2693311	246	2693557	0.04987
SRR5927720_1_kneaddata_paired	Firmicutes	12188	P	815298	20554	835852	0.01548
SRR5927720_1_kneaddata_paired	Proteobacteria	22518	P	597044	1512	598556	0.01108
SRR5927720_1_kneaddata_paired	Deferribacterota	10822	P	559698	3443	563141	0.01043
SRR5927720_1_kneaddata_paired	Desulfobacterota_A	11509	P	184963	3143	188106	0.00348
SRR5927720_1_kneaddata_paired	Spirochaetota	32587	P	168365	229	168594	0.00312
SRR5927720_1_kneaddata_paired	Cyanobacteria	9876	P	111520	709	112229	0.00208
SRR5927720_1_kneaddata_paired	Actinobacteriota	615	P	86221	174	86395	0.00160
SRR5927720_1_kneaddata_paired	Firmicutes_B	17289	P	4034	246	4280	0.00008
SRR5927720_1_kneaddata_paired	Verrucomicrobiota	33333	P	2585	42	2627	0.00005
SRR5927720_1_kneaddata_paired	Firmicutes_I	18140	P	226	0	226	0.00000
SRR5927720_1_kneaddata_paired	Firmicutes_C	17613	P	78	0	78	0.00000
SRR5927720_1_kneaddata_paired	Elusimicrobiota	11888	P	22	0	22	0.00000
SRR5927720_1_kneaddata_paired	Thermotogota	33086	P	19	0	19	0.00000
SRR5927721_1_kneaddata_paired	Firmicutes_A	14608	P	14925338	61537	14986875	0.45529
SRR5927721_1_kneaddata_paired	Bacteroidota	4587	P	13312193	201813	13514006	0.41054
SRR5927721_1_kneaddata_paired	Firmicutes	12188	P	1784693	16847	1801540	0.05473
SRR5927721_1_kneaddata_paired	Campylobacterota	8700	P	1461183	162	1461345	0.04439
SRR5927721_1_kneaddata_paired	Deferribacterota	10822	P	346020	1119	347139	0.01055
SRR5927721_1_kneaddata_paired	Desulfobacterota_A	11509	P	303864	2113	305977	0.00930
SRR5927721_1_kneaddata_paired	Proteobacteria	22518	P	295787	348	296135	0.00900
SRR5927721_1_kneaddata_paired	Spirochaetota	32587	P	109878	82	109960	0.00334
SRR5927721_1_kneaddata_paired	Actinobacteriota	615	P	66792	29	66821	0.00203
SRR5927721_1_kneaddata_paired	Cyanobacteria	9876	P	22552	149	22701	0.00069
SRR5927721_1_kneaddata_paired	Firmicutes_B	17289	P	1782	57	1839	0.00006
SRR5927721_1_kneaddata_paired	Verrucomicrobiota	33333	P	1609	77	1686	0.00005
SRR5927721_1_kneaddata_paired	Firmicutes_I	18140	P	854	0	854	0.00003
SRR5927721_1_kneaddata_paired	Firmicutes_C	17613	P	251	0	251	0.00001
SRR5927721_1_kneaddata_paired	Elusimicrobiota	11888	P	85	0	85	0.00000
SRR5927721_1_kneaddata_paired	Thermotogota	33086	P	44	0	44	0.00000
SRR5927722_1_kneaddata_paired	Bacteroidota	4587	P	10644436	147782	10792218	0.80882
SRR5927722_1_kneaddata_paired	Firmicutes_A	14608	P	1758053	14780	1772833	0.13286
SRR5927722_1_kneaddata_paired	Firmicutes	12188	P	325782	3606	329388	0.02469
SRR5927722_1_kneaddata_paired	Campylobacterota	8700	P	160342	33	160375	0.01202
SRR5927722_1_kneaddata_paired	Deferribacterota	10822	P	100952	393	101345	0.00760
SRR5927722_1_kneaddata_paired	Spirochaetota	32587	P	66187	56	66243	0.00496
SRR5927722_1_kneaddata_paired	Proteobacteria	22518	P	58335	153	58488	0.00438
SRR5927722_1_kneaddata_paired	Cyanobacteria	9876	P	30115	191	30306	0.00227
SRR5927722_1_kneaddata_paired	Desulfobacterota_A	11509	P	22809	228	23037	0.00173
SRR5927722_1_kneaddata_paired	Actinobacteriota	615	P	8143	11	8154	0.00061
SRR5927722_1_kneaddata_paired	Firmicutes_B	17289	P	493	19	512	0.00004
SRR5927722_1_kneaddata_paired	Verrucomicrobiota	33333	P	131	5	136	0.00001
SRR5927722_1_kneaddata_paired	Firmicutes_I	18140	P	61	0	61	0.00000
SRR5927722_1_kneaddata_paired	Firmicutes_C	17613	P	25	0	25	0.00000
SRR5927722_1_kneaddata_paired	Thermotogota	33086	P	4	0	4	0.00000
SRR5927722_1_kneaddata_paired	Elusimicrobiota	11888	P	2	0	2	0.00000
SRR5927723_1_kneaddata_paired	Bacteroidota	4587	P	18861641	676800	19538441	0.58789
SRR5927723_1_kneaddata_paired	Firmicutes_A	14608	P	8630904	136049	8766953	0.26379
SRR5927723_1_kneaddata_paired	Firmicutes	12188	P	2170464	61308	2231772	0.06715
SRR5927723_1_kneaddata_paired	Campylobacterota	8700	P	973921	722	974643	0.02933
SRR5927723_1_kneaddata_paired	Desulfobacterota_A	11509	P	665931	15372	681303	0.02050
SRR5927723_1_kneaddata_paired	Proteobacteria	22518	P	497320	1960	499280	0.01502
SRR5927723_1_kneaddata_paired	Deferribacterota	10822	P	307649	182	307831	0.00926
SRR5927723_1_kneaddata_paired	Spirochaetota	32587	P	88053	211	88264	0.00266
SRR5927723_1_kneaddata_paired	Cyanobacteria	9876	P	73233	827	74060	0.00223
SRR5927723_1_kneaddata_paired	Actinobacteriota	615	P	64803	158	64961	0.00195
SRR5927723_1_kneaddata_paired	Firmicutes_B	17289	P	4597	462	5059	0.00015
SRR5927723_1_kneaddata_paired	Verrucomicrobiota	33333	P	927	128	1055	0.00003
SRR5927723_1_kneaddata_paired	Firmicutes_I	18140	P	920	1	921	0.00003
SRR5927723_1_kneaddata_paired	Firmicutes_C	17613	P	252	1	253	0.00001
SRR5927723_1_kneaddata_paired	Elusimicrobiota	11888	P	92	0	92	0.00000
SRR5927723_1_kneaddata_paired	Thermotogota	33086	P	58	0	58	0.00000
SRR5927724_1_kneaddata_paired	Bacteroidota	4587	P	31481956	990075	32472031	0.68625
SRR5927724_1_kneaddata_paired	Firmicutes_A	14608	P	11453084	116500	11569584	0.24451
SRR5927724_1_kneaddata_paired	Campylobacterota	8700	P	1371297	125	1371422	0.02898
SRR5927724_1_kneaddata_paired	Firmicutes	12188	P	672058	12255	684313	0.01446
SRR5927724_1_kneaddata_paired	Deferribacterota	10822	P	430937	3292	434229	0.00918
SRR5927724_1_kneaddata_paired	Proteobacteria	22518	P	210684	1108	211792	0.00448
SRR5927724_1_kneaddata_paired	Desulfobacterota_A	11509	P	185361	3575	188936	0.00399
SRR5927724_1_kneaddata_paired	Spirochaetota	32587	P	184366	312	184678	0.00390
SRR5927724_1_kneaddata_paired	Cyanobacteria	9876	P	114127	950	115077	0.00243
SRR5927724_1_kneaddata_paired	Actinobacteriota	615	P	79754	107	79861	0.00169
SRR5927724_1_kneaddata_paired	Firmicutes_B	17289	P	4937	376	5313	0.00011
SRR5927724_1_kneaddata_paired	Verrucomicrobiota	33333	P	485	42	527	0.00001
SRR5927724_1_kneaddata_paired	Firmicutes_I	18140	P	313	0	313	0.00001
SRR5927724_1_kneaddata_paired	Firmicutes_C	17613	P	146	0	146	0.00000
SRR5927724_1_kneaddata_paired	Thermotogota	33086	P	36	0	36	0.00000
SRR5927724_1_kneaddata_paired	Elusimicrobiota	11888	P	29	0	29	0.00000
SRR5927725_1_kneaddata_paired	Bacteroidota	4587	P	8234442	267944	8502386	0.51134
SRR5927725_1_kneaddata_paired	Firmicutes_A	14608	P	6750301	71400	6821701	0.41026
SRR5927725_1_kneaddata_paired	Firmicutes	12188	P	395980	12275	408255	0.02455
SRR5927725_1_kneaddata_paired	Campylobacterota	8700	P	361777	381	362158	0.02178
SRR5927725_1_kneaddata_paired	Cyanobacteria	9876	P	144509	1007	145516	0.00875
SRR5927725_1_kneaddata_paired	Proteobacteria	22518	P	114860	339	115199	0.00693
SRR5927725_1_kneaddata_paired	Desulfobacterota_A	11509	P	101933	1875	103808	0.00624
SRR5927725_1_kneaddata_paired	Spirochaetota	32587	P	69125	116	69241	0.00416
SRR5927725_1_kneaddata_paired	Deferribacterota	10822	P	53263	25	53288	0.00320
SRR5927725_1_kneaddata_paired	Actinobacteriota	615	P	37119	95	37214	0.00224
SRR5927725_1_kneaddata_paired	Verrucomicrobiota	33333	P	6777	145	6922	0.00042
SRR5927725_1_kneaddata_paired	Firmicutes_B	17289	P	1452	109	1561	0.00009
SRR5927725_1_kneaddata_paired	Firmicutes_I	18140	P	189	0	189	0.00001
SRR5927725_1_kneaddata_paired	Firmicutes_C	17613	P	113	0	113	0.00001
SRR5927725_1_kneaddata_paired	Thermotogota	33086	P	12	0	12	0.00000
SRR5927725_1_kneaddata_paired	Elusimicrobiota	11888	P	11	0	11	0.00000
SRR5927726_1_kneaddata_paired	Bacteroidota	4587	P	6699072	448491	7147563	0.67739
SRR5927726_1_kneaddata_paired	Firmicutes_A	14608	P	1340950	63062	1404012	0.13306
SRR5927726_1_kneaddata_paired	Campylobacterota	8700	P	701245	306	701551	0.06649
SRR5927726_1_kneaddata_paired	Proteobacteria	22518	P	581342	5350	586692	0.05560
SRR5927726_1_kneaddata_paired	Cyanobacteria	9876	P	286536	4487	291023	0.02758
SRR5927726_1_kneaddata_paired	Firmicutes	12188	P	255337	13033	268370	0.02543
SRR5927726_1_kneaddata_paired	Spirochaetota	32587	P	67843	285	68128	0.00646
SRR5927726_1_kneaddata_paired	Actinobacteriota	615	P	53582	151	53733	0.00509
SRR5927726_1_kneaddata_paired	Desulfobacterota_A	11509	P	25062	1159	26221	0.00249
SRR5927726_1_kneaddata_paired	Firmicutes_B	17289	P	1978	382	2360	0.00022
SRR5927726_1_kneaddata_paired	Deferribacterota	10822	P	1715	6	1721	0.00016
SRR5927726_1_kneaddata_paired	Verrucomicrobiota	33333	P	92	16	108	0.00001
SRR5927726_1_kneaddata_paired	Firmicutes_I	18140	P	40	0	40	0.00000
SRR5927726_1_kneaddata_paired	Firmicutes_C	17613	P	18	0	18	0.00000
SRR5927726_1_kneaddata_paired	Elusimicrobiota	11888	P	5	0	5	0.00000
SRR5927726_1_kneaddata_paired	Thermotogota	33086	P	4	0	4	0.00000
SRR5927727_1_kneaddata_paired	Bacteroidota	4587	P	35802618	883271	36685889	0.70203
SRR5927727_1_kneaddata_paired	Firmicutes_A	14608	P	13602820	113258	13716078	0.26247
SRR5927727_1_kneaddata_paired	Proteobacteria	22518	P	518112	1198	519310	0.00994
SRR5927727_1_kneaddata_paired	Firmicutes	12188	P	423327	6240	429567	0.00822
SRR5927727_1_kneaddata_paired	Campylobacterota	8700	P	361157	22	361179	0.00691
SRR5927727_1_kneaddata_paired	Desulfobacterota_A	11509	P	250652	3632	254284	0.00487
SRR5927727_1_kneaddata_paired	Cyanobacteria	9876	P	103748	641	104389	0.00200
SRR5927727_1_kneaddata_paired	Actinobacteriota	615	P	70566	120	70686	0.00135
SRR5927727_1_kneaddata_paired	Deferribacterota	10822	P	65376	358	65734	0.00126
SRR5927727_1_kneaddata_paired	Spirochaetota	32587	P	45024	56	45080	0.00086
SRR5927727_1_kneaddata_paired	Firmicutes_B	17289	P	3274	181	3455	0.00007
SRR5927727_1_kneaddata_paired	Verrucomicrobiota	33333	P	775	54	829	0.00002
SRR5927727_1_kneaddata_paired	Firmicutes_I	18140	P	237	0	237	0.00000
SRR5927727_1_kneaddata_paired	Firmicutes_C	17613	P	128	0	128	0.00000
SRR5927727_1_kneaddata_paired	Thermotogota	33086	P	19	0	19	0.00000
SRR5927727_1_kneaddata_paired	Elusimicrobiota	11888	P	10	0	10	0.00000
SRR5927728_1_kneaddata_paired	Bacteroidota	4587	P	2381711	148735	2530446	0.34436
SRR5927728_1_kneaddata_paired	Firmicutes_A	14608	P	2144896	44056	2188952	0.29788
SRR5927728_1_kneaddata_paired	Firmicutes	12188	P	1912276	66492	1978768	0.26928
SRR5927728_1_kneaddata_paired	Campylobacterota	8700	P	217488	451	217939	0.02966
SRR5927728_1_kneaddata_paired	Proteobacteria	22518	P	135673	569	136242	0.01854
SRR5927728_1_kneaddata_paired	Cyanobacteria	9876	P	118470	1327	119797	0.01630
SRR5927728_1_kneaddata_paired	Deferribacterota	10822	P	58387	809	59196	0.00806
SRR5927728_1_kneaddata_paired	Spirochaetota	32587	P	56201	186	56387	0.00767
SRR5927728_1_kneaddata_paired	Actinobacteriota	615	P	36135	266	36401	0.00495
SRR5927728_1_kneaddata_paired	Desulfobacterota_A	11509	P	21277	639	21916	0.00298
SRR5927728_1_kneaddata_paired	Firmicutes_B	17289	P	1123	156	1279	0.00017
SRR5927728_1_kneaddata_paired	Firmicutes_I	18140	P	612	1	613	0.00008
SRR5927728_1_kneaddata_paired	Verrucomicrobiota	33333	P	265	46	311	0.00004
SRR5927728_1_kneaddata_paired	Firmicutes_C	17613	P	57	0	57	0.00001
SRR5927728_1_kneaddata_paired	Elusimicrobiota	11888	P	26	0	26	0.00000
SRR5927728_1_kneaddata_paired	Thermotogota	33086	P	17	0	17	0.00000
SRR5927729_1_kneaddata_paired	Firmicutes_A	14608	P	34808364	168116	34976480	0.76655
SRR5927729_1_kneaddata_paired	Bacteroidota	4587	P	7947487	139481	8086968	0.17724
SRR5927729_1_kneaddata_paired	Firmicutes	12188	P	1153822	34727	1188549	0.02605
SRR5927729_1_kneaddata_paired	Proteobacteria	22518	P	673400	953	674353	0.01478
SRR5927729_1_kneaddata_paired	Campylobacterota	8700	P	393788	35	393823	0.00863
SRR5927729_1_kneaddata_paired	Desulfobacterota_A	11509	P	186277	1865	188142	0.00412
SRR5927729_1_kneaddata_paired	Spirochaetota	32587	P	53363	48	53411	0.00117
SRR5927729_1_kneaddata_paired	Cyanobacteria	9876	P	20304	241	20545	0.00045
SRR5927729_1_kneaddata_paired	Actinobacteriota	615	P	19552	40	19592	0.00043
SRR5927729_1_kneaddata_paired	Deferribacterota	10822	P	16555	40	16595	0.00036
SRR5927729_1_kneaddata_paired	Firmicutes_B	17289	P	4878	192	5070	0.00011
SRR5927729_1_kneaddata_paired	Verrucomicrobiota	33333	P	3276	197	3473	0.00008
SRR5927729_1_kneaddata_paired	Firmicutes_I	18140	P	803	0	803	0.00002
SRR5927729_1_kneaddata_paired	Firmicutes_C	17613	P	395	0	395	0.00001
SRR5927729_1_kneaddata_paired	Thermotogota	33086	P	32	0	32	0.00000
SRR5927729_1_kneaddata_paired	Elusimicrobiota	11888	P	23	0	23	0.00000
SRR6032561_1_kneaddata_paired	Firmicutes_A	14608	P	17800576	103276	17903852	0.89735
SRR6032561_1_kneaddata_paired	Bacteroidota	4587	P	841884	2599	844483	0.04233
SRR6032561_1_kneaddata_paired	Firmicutes	12188	P	707517	7733	715250	0.03585
SRR6032561_1_kneaddata_paired	Deferribacterota	10822	P	254256	1172	255428	0.01280
SRR6032561_1_kneaddata_paired	Actinobacteriota	615	P	87668	150	87818	0.00440
SRR6032561_1_kneaddata_paired	Firmicutes_B	17289	P	66887	3049	69936	0.00351
SRR6032561_1_kneaddata_paired	Verrucomicrobiota	33333	P	64579	1537	66116	0.00331
SRR6032561_1_kneaddata_paired	Proteobacteria	22518	P	2709	31	2740	0.00014
SRR6032561_1_kneaddata_paired	Cyanobacteria	9876	P	2196	64	2260	0.00011
SRR6032561_1_kneaddata_paired	Desulfobacterota_A	11509	P	1913	302	2215	0.00011
SRR6032561_1_kneaddata_paired	Spirochaetota	32587	P	686	3	689	0.00003
SRR6032561_1_kneaddata_paired	Campylobacterota	8700	P	675	0	675	0.00003
SRR6032561_1_kneaddata_paired	Firmicutes_I	18140	P	253	0	253	0.00001
SRR6032561_1_kneaddata_paired	Firmicutes_C	17613	P	212	0	212	0.00001
SRR6032561_1_kneaddata_paired	Thermotogota	33086	P	60	0	60	0.00000
SRR6032561_1_kneaddata_paired	Elusimicrobiota	11888	P	7	0	7	0.00000
SRR6032562_1_kneaddata_paired	Firmicutes_A	14608	P	12316725	73884	12390609	0.88547
SRR6032562_1_kneaddata_paired	Bacteroidota	4587	P	720043	1939	721982	0.05160
SRR6032562_1_kneaddata_paired	Firmicutes	12188	P	511763	5926	517689	0.03700
SRR6032562_1_kneaddata_paired	Deferribacterota	10822	P	215805	1014	216819	0.01549
SRR6032562_1_kneaddata_paired	Actinobacteriota	615	P	49737	82	49819	0.00356
SRR6032562_1_kneaddata_paired	Firmicutes_B	17289	P	44956	2092	47048	0.00336
SRR6032562_1_kneaddata_paired	Verrucomicrobiota	33333	P	41625	1010	42635	0.00305
SRR6032562_1_kneaddata_paired	Proteobacteria	22518	P	1905	26	1931	0.00014
SRR6032562_1_kneaddata_paired	Cyanobacteria	9876	P	1706	44	1750	0.00013
SRR6032562_1_kneaddata_paired	Desulfobacterota_A	11509	P	1304	214	1518	0.00011
SRR6032562_1_kneaddata_paired	Spirochaetota	32587	P	575	2	577	0.00004
SRR6032562_1_kneaddata_paired	Campylobacterota	8700	P	489	0	489	0.00003
SRR6032562_1_kneaddata_paired	Firmicutes_I	18140	P	152	0	152	0.00001
SRR6032562_1_kneaddata_paired	Firmicutes_C	17613	P	148	0	148	0.00001
SRR6032562_1_kneaddata_paired	Thermotogota	33086	P	52	0	52	0.00000
SRR6032562_1_kneaddata_paired	Elusimicrobiota	11888	P	8	0	8	0.00000
SRR6032563_1_kneaddata_paired	Firmicutes_A	14608	P	19304265	119763	19424028	0.90628
SRR6032563_1_kneaddata_paired	Bacteroidota	4587	P	916405	2777	919182	0.04289
SRR6032563_1_kneaddata_paired	Firmicutes	12188	P	597406	7648	605054	0.02823
SRR6032563_1_kneaddata_paired	Deferribacterota	10822	P	281362	1422	282784	0.01319
SRR6032563_1_kneaddata_paired	Actinobacteriota	615	P	80786	137	80923	0.00378
SRR6032563_1_kneaddata_paired	Firmicutes_B	17289	P	59684	2977	62661	0.00292
SRR6032563_1_kneaddata_paired	Verrucomicrobiota	33333	P	47085	1213	48298	0.00225
SRR6032563_1_kneaddata_paired	Proteobacteria	22518	P	2759	32	2791	0.00013
SRR6032563_1_kneaddata_paired	Cyanobacteria	9876	P	2456	91	2547	0.00012
SRR6032563_1_kneaddata_paired	Desulfobacterota_A	11509	P	2033	339	2372	0.00011
SRR6032563_1_kneaddata_paired	Campylobacterota	8700	P	924	0	924	0.00004
SRR6032563_1_kneaddata_paired	Spirochaetota	32587	P	619	2	621	0.00003
SRR6032563_1_kneaddata_paired	Firmicutes_C	17613	P	278	0	278	0.00001
SRR6032563_1_kneaddata_paired	Firmicutes_I	18140	P	248	0	248	0.00001
SRR6032563_1_kneaddata_paired	Thermotogota	33086	P	32	0	32	0.00000
SRR6032563_1_kneaddata_paired	Elusimicrobiota	11888	P	6	0	6	0.00000
SRR6032564_1_kneaddata_paired	Firmicutes_A	14608	P	16637545	104150	16741695	0.89628
SRR6032564_1_kneaddata_paired	Bacteroidota	4587	P	992016	2797	994813	0.05326
SRR6032564_1_kneaddata_paired	Firmicutes	12188	P	595529	6609	602138	0.03224
SRR6032564_1_kneaddata_paired	Deferribacterota	10822	P	170532	801	171333	0.00917
SRR6032564_1_kneaddata_paired	Firmicutes_B	17289	P	56840	2642	59482	0.00318
SRR6032564_1_kneaddata_paired	Verrucomicrobiota	33333	P	50109	1227	51336	0.00275
SRR6032564_1_kneaddata_paired	Actinobacteriota	615	P	49796	81	49877	0.00267
SRR6032564_1_kneaddata_paired	Proteobacteria	22518	P	2580	26	2606	0.00014
SRR6032564_1_kneaddata_paired	Cyanobacteria	9876	P	2165	50	2215	0.00012
SRR6032564_1_kneaddata_paired	Desulfobacterota_A	11509	P	1452	220	1672	0.00009
SRR6032564_1_kneaddata_paired	Campylobacterota	8700	P	728	0	728	0.00004
SRR6032564_1_kneaddata_paired	Spirochaetota	32587	P	694	3	697	0.00004
SRR6032564_1_kneaddata_paired	Firmicutes_I	18140	P	205	0	205	0.00001
SRR6032564_1_kneaddata_paired	Firmicutes_C	17613	P	183	0	183	0.00001
SRR6032564_1_kneaddata_paired	Thermotogota	33086	P	54	0	54	0.00000
SRR6032564_1_kneaddata_paired	Elusimicrobiota	11888	P	12	0	12	0.00000
SRR6032565_1_kneaddata_paired	Firmicutes_A	14608	P	22344101	142390	22486491	0.93018
SRR6032565_1_kneaddata_paired	Firmicutes	12188	P	704287	8222	712509	0.02947
SRR6032565_1_kneaddata_paired	Bacteroidota	4587	P	607449	2213	609662	0.02522
SRR6032565_1_kneaddata_paired	Deferribacterota	10822	P	205829	944	206773	0.00855
SRR6032565_1_kneaddata_paired	Firmicutes_B	17289	P	66491	3011	69502	0.00288
SRR6032565_1_kneaddata_paired	Actinobacteriota	615	P	65832	101	65933	0.00273
SRR6032565_1_kneaddata_paired	Verrucomicrobiota	33333	P	12560	399	12959	0.00054
SRR6032565_1_kneaddata_paired	Proteobacteria	22518	P	3299	35	3334	0.00014
SRR6032565_1_kneaddata_paired	Desulfobacterota_A	11509	P	2589	435	3024	0.00013
SRR6032565_1_kneaddata_paired	Cyanobacteria	9876	P	2530	122	2652	0.00011
SRR6032565_1_kneaddata_paired	Spirochaetota	32587	P	490	1	491	0.00002
SRR6032565_1_kneaddata_paired	Campylobacterota	8700	P	394	0	394	0.00002
SRR6032565_1_kneaddata_paired	Firmicutes_C	17613	P	267	0	267	0.00001
SRR6032565_1_kneaddata_paired	Firmicutes_I	18140	P	194	0	194	0.00001
SRR6032565_1_kneaddata_paired	Thermotogota	33086	P	40	0	40	0.00000
SRR6032565_1_kneaddata_paired	Elusimicrobiota	11888	P	7	0	7	0.00000
SRR6032566_1_kneaddata_paired	Firmicutes_A	14608	P	15076346	67995	15144341	0.80610
SRR6032566_1_kneaddata_paired	Bacteroidota	4587	P	2264088	17683	2281771	0.12145
SRR6032566_1_kneaddata_paired	Campylobacterota	8700	P	437945	37	437982	0.02331
SRR6032566_1_kneaddata_paired	Firmicutes	12188	P	409827	5191	415018	0.02209
SRR6032566_1_kneaddata_paired	Actinobacteriota	615	P	136828	733	137561	0.00732
SRR6032566_1_kneaddata_paired	Desulfobacterota_A	11509	P	133410	1575	134985	0.00718
SRR6032566_1_kneaddata_paired	Cyanobacteria	9876	P	120365	376	120741	0.00643
SRR6032566_1_kneaddata_paired	Deferribacterota	10822	P	96308	432	96740	0.00515
SRR6032566_1_kneaddata_paired	Proteobacteria	22518	P	15480	75	15555	0.00083
SRR6032566_1_kneaddata_paired	Firmicutes_B	17289	P	948	42	990	0.00005
SRR6032566_1_kneaddata_paired	Verrucomicrobiota	33333	P	647	39	686	0.00004
SRR6032566_1_kneaddata_paired	Spirochaetota	32587	P	430	0	430	0.00002
SRR6032566_1_kneaddata_paired	Firmicutes_I	18140	P	194	0	194	0.00001
SRR6032566_1_kneaddata_paired	Firmicutes_C	17613	P	171	0	171	0.00001
SRR6032566_1_kneaddata_paired	Elusimicrobiota	11888	P	23	0	23	0.00000
SRR6032566_1_kneaddata_paired	Thermotogota	33086	P	13	0	13	0.00000
SRR6032567_1_kneaddata_paired	Firmicutes_A	14608	P	20547205	129259	20676464	0.92599
SRR6032567_1_kneaddata_paired	Bacteroidota	4587	P	738441	2570	741011	0.03319
SRR6032567_1_kneaddata_paired	Firmicutes	12188	P	493265	7634	500899	0.02243
SRR6032567_1_kneaddata_paired	Deferribacterota	10822	P	283355	1498	284853	0.01276
SRR6032567_1_kneaddata_paired	Firmicutes_B	17289	P	46152	2411	48563	0.00217
SRR6032567_1_kneaddata_paired	Actinobacteriota	615	P	43386	72	43458	0.00195
SRR6032567_1_kneaddata_paired	Verrucomicrobiota	33333	P	24570	688	25258	0.00113
SRR6032567_1_kneaddata_paired	Proteobacteria	22518	P	2781	37	2818	0.00013
SRR6032567_1_kneaddata_paired	Cyanobacteria	9876	P	1883	51	1934	0.00009
SRR6032567_1_kneaddata_paired	Desulfobacterota_A	11509	P	1819	326	2145	0.00010
SRR6032567_1_kneaddata_paired	Spirochaetota	32587	P	656	2	658	0.00003
SRR6032567_1_kneaddata_paired	Campylobacterota	8700	P	556	0	556	0.00002
SRR6032567_1_kneaddata_paired	Firmicutes_I	18140	P	224	0	224	0.00001
SRR6032567_1_kneaddata_paired	Firmicutes_C	17613	P	206	0	206	0.00001
SRR6032567_1_kneaddata_paired	Thermotogota	33086	P	40	0	40	0.00000
SRR6032567_1_kneaddata_paired	Elusimicrobiota	11888	P	9	0	9	0.00000
SRR6032568_1_kneaddata_paired	Firmicutes_A	14608	P	19229153	94060	19323213	0.82987
SRR6032568_1_kneaddata_paired	Bacteroidota	4587	P	2399245	21455	2420700	0.10396
SRR6032568_1_kneaddata_paired	Firmicutes	12188	P	571039	6270	577309	0.02479
SRR6032568_1_kneaddata_paired	Campylobacterota	8700	P	432307	31	432338	0.01857
SRR6032568_1_kneaddata_paired	Desulfobacterota_A	11509	P	209079	2975	212054	0.00911
SRR6032568_1_kneaddata_paired	Actinobacteriota	615	P	118841	619	119460	0.00513
SRR6032568_1_kneaddata_paired	Deferribacterota	10822	P	101629	439	102068	0.00438
SRR6032568_1_kneaddata_paired	Cyanobacteria	9876	P	71974	389	72363	0.00311
SRR6032568_1_kneaddata_paired	Proteobacteria	22518	P	21681	88	21769	0.00093
SRR6032568_1_kneaddata_paired	Verrucomicrobiota	33333	P	1426	90	1516	0.00007
SRR6032568_1_kneaddata_paired	Firmicutes_B	17289	P	996	42	1038	0.00004
SRR6032568_1_kneaddata_paired	Spirochaetota	32587	P	348	0	348	0.00001
SRR6032568_1_kneaddata_paired	Firmicutes_I	18140	P	185	0	185	0.00001
SRR6032568_1_kneaddata_paired	Firmicutes_C	17613	P	139	0	139	0.00001
SRR6032568_1_kneaddata_paired	Elusimicrobiota	11888	P	16	0	16	0.00000
SRR6032568_1_kneaddata_paired	Thermotogota	33086	P	13	0	13	0.00000
SRR6032569_1_kneaddata_paired	Firmicutes_A	14608	P	22680876	114083	22794959	0.76743
SRR6032569_1_kneaddata_paired	Bacteroidota	4587	P	4785257	33532	4818789	0.16223
SRR6032569_1_kneaddata_paired	Firmicutes	12188	P	915282	9779	925061	0.03114
SRR6032569_1_kneaddata_paired	Campylobacterota	8700	P	385424	26	385450	0.01298
SRR6032569_1_kneaddata_paired	Desulfobacterota_A	11509	P	309023	3839	312862	0.01053
SRR6032569_1_kneaddata_paired	Actinobacteriota	615	P	205899	786	206685	0.00696
SRR6032569_1_kneaddata_paired	Deferribacterota	10822	P	154613	613	155226	0.00523
SRR6032569_1_kneaddata_paired	Cyanobacteria	9876	P	58337	219	58556	0.00197
SRR6032569_1_kneaddata_paired	Proteobacteria	22518	P	40541	119	40660	0.00137
SRR6032569_1_kneaddata_paired	Verrucomicrobiota	33333	P	2907	174	3081	0.00010
SRR6032569_1_kneaddata_paired	Firmicutes_B	17289	P	790	30	820	0.00003
SRR6032569_1_kneaddata_paired	Spirochaetota	32587	P	444	0	444	0.00001
SRR6032569_1_kneaddata_paired	Firmicutes_I	18140	P	278	0	278	0.00001
SRR6032569_1_kneaddata_paired	Firmicutes_C	17613	P	182	0	182	0.00001
SRR6032569_1_kneaddata_paired	Thermotogota	33086	P	20	0	20	0.00000
SRR6032569_1_kneaddata_paired	Elusimicrobiota	11888	P	14	0	14	0.00000
SRR6032570_1_kneaddata_paired	Firmicutes_A	14608	P	21665607	101782	21767389	0.78816
SRR6032570_1_kneaddata_paired	Bacteroidota	4587	P	3945129	27733	3972862	0.14385
SRR6032570_1_kneaddata_paired	Campylobacterota	8700	P	609227	45	609272	0.02206
SRR6032570_1_kneaddata_paired	Firmicutes	12188	P	605051	6763	611814	0.02215
SRR6032570_1_kneaddata_paired	Desulfobacterota_A	11509	P	176359	2154	178513	0.00646
SRR6032570_1_kneaddata_paired	Actinobacteriota	615	P	156493	631	157124	0.00569
SRR6032570_1_kneaddata_paired	Deferribacterota	10822	P	137973	589	138562	0.00502
SRR6032570_1_kneaddata_paired	Cyanobacteria	9876	P	136242	511	136753	0.00495
SRR6032570_1_kneaddata_paired	Proteobacteria	22518	P	42207	174	42381	0.00153
SRR6032570_1_kneaddata_paired	Verrucomicrobiota	33333	P	1253	78	1331	0.00005
SRR6032570_1_kneaddata_paired	Firmicutes_B	17289	P	1010	42	1052	0.00004
SRR6032570_1_kneaddata_paired	Spirochaetota	32587	P	423	1	424	0.00002
SRR6032570_1_kneaddata_paired	Firmicutes_I	18140	P	242	0	242	0.00001
SRR6032570_1_kneaddata_paired	Firmicutes_C	17613	P	199	0	199	0.00001
SRR6032570_1_kneaddata_paired	Thermotogota	33086	P	28	0	28	0.00000
SRR6032570_1_kneaddata_paired	Elusimicrobiota	11888	P	22	0	22	0.00000
SRR6032571_1_kneaddata_paired	Firmicutes_A	14608	P	20761969	101364	20863333	0.78198
SRR6032571_1_kneaddata_paired	Bacteroidota	4587	P	3684461	28952	3713413	0.13918
SRR6032571_1_kneaddata_paired	Firmicutes	12188	P	957812	10906	968718	0.03631
SRR6032571_1_kneaddata_paired	Campylobacterota	8700	P	538088	39	538127	0.02017
SRR6032571_1_kneaddata_paired	Desulfobacterota_A	11509	P	168843	2104	170947	0.00641
SRR6032571_1_kneaddata_paired	Actinobacteriota	615	P	168490	686	169176	0.00634
SRR6032571_1_kneaddata_paired	Deferribacterota	10822	P	119695	518	120213	0.00451
SRR6032571_1_kneaddata_paired	Cyanobacteria	9876	P	98384	297	98681	0.00370
SRR6032571_1_kneaddata_paired	Proteobacteria	22518	P	33553	107	33660	0.00126
SRR6032571_1_kneaddata_paired	Verrucomicrobiota	33333	P	1967	132	2099	0.00008
SRR6032571_1_kneaddata_paired	Firmicutes_B	17289	P	750	32	782	0.00003
SRR6032571_1_kneaddata_paired	Spirochaetota	32587	P	350	0	350	0.00001
SRR6032571_1_kneaddata_paired	Firmicutes_I	18140	P	285	0	285	0.00001
SRR6032571_1_kneaddata_paired	Firmicutes_C	17613	P	146	0	146	0.00001
SRR6032571_1_kneaddata_paired	Elusimicrobiota	11888	P	23	0	23	0.00000
SRR6032571_1_kneaddata_paired	Thermotogota	33086	P	17	0	17	0.00000
SRR6032572_1_kneaddata_paired	Firmicutes_A	14608	P	15546614	75224	15621838	0.80789
SRR6032572_1_kneaddata_paired	Bacteroidota	4587	P	2336680	17328	2354008	0.12174
SRR6032572_1_kneaddata_paired	Campylobacterota	8700	P	463094	39	463133	0.02395
SRR6032572_1_kneaddata_paired	Firmicutes	12188	P	369084	5178	374262	0.01936
SRR6032572_1_kneaddata_paired	Deferribacterota	10822	P	155412	736	156148	0.00808
SRR6032572_1_kneaddata_paired	Desulfobacterota_A	11509	P	154864	2022	156886	0.00811
SRR6032572_1_kneaddata_paired	Actinobacteriota	615	P	113010	434	113444	0.00587
SRR6032572_1_kneaddata_paired	Cyanobacteria	9876	P	81574	266	81840	0.00423
SRR6032572_1_kneaddata_paired	Proteobacteria	22518	P	12826	55	12881	0.00067
SRR6032572_1_kneaddata_paired	Firmicutes_B	17289	P	773	36	809	0.00004
SRR6032572_1_kneaddata_paired	Verrucomicrobiota	33333	P	563	35	598	0.00003
SRR6032572_1_kneaddata_paired	Spirochaetota	32587	P	354	0	354	0.00002
SRR6032572_1_kneaddata_paired	Firmicutes_I	18140	P	201	0	201	0.00001
SRR6032572_1_kneaddata_paired	Firmicutes_C	17613	P	159	0	159	0.00001
SRR6032572_1_kneaddata_paired	Elusimicrobiota	11888	P	15	0	15	0.00000
SRR6032572_1_kneaddata_paired	Thermotogota	33086	P	14	0	14	0.00000
SRR6032573_1_kneaddata_paired	Firmicutes_A	14608	P	6592037	31929	6623966	0.71495
SRR6032573_1_kneaddata_paired	Bacteroidota	4587	P	1624464	12868	1637332	0.17672
SRR6032573_1_kneaddata_paired	Firmicutes	12188	P	466259	4887	471146	0.05085
SRR6032573_1_kneaddata_paired	Campylobacterota	8700	P	240533	21	240554	0.02596
SRR6032573_1_kneaddata_paired	Desulfobacterota_A	11509	P	92337	1153	93490	0.01009
SRR6032573_1_kneaddata_paired	Actinobacteriota	615	P	86883	307	87190	0.00941
SRR6032573_1_kneaddata_paired	Deferribacterota	10822	P	61349	272	61621	0.00665
SRR6032573_1_kneaddata_paired	Cyanobacteria	9876	P	37196	155	37351	0.00403
SRR6032573_1_kneaddata_paired	Proteobacteria	22518	P	11355	35	11390	0.00123
SRR6032573_1_kneaddata_paired	Verrucomicrobiota	33333	P	276	15	291	0.00003
SRR6032573_1_kneaddata_paired	Firmicutes_B	17289	P	256	11	267	0.00003
SRR6032573_1_kneaddata_paired	Spirochaetota	32587	P	195	0	195	0.00002
SRR6032573_1_kneaddata_paired	Firmicutes_I	18140	P	126	0	126	0.00001
SRR6032573_1_kneaddata_paired	Firmicutes_C	17613	P	59	0	59	0.00001
SRR6032573_1_kneaddata_paired	Thermotogota	33086	P	6	0	6	0.00000
SRR6032573_1_kneaddata_paired	Elusimicrobiota	11888	P	5	0	5	0.00000
SRR6032574_1_kneaddata_paired	Firmicutes_A	14608	P	9076244	53911	9130155	0.68772
SRR6032574_1_kneaddata_paired	Bacteroidota	4587	P	2885825	22762	2908587	0.21909
SRR6032574_1_kneaddata_paired	Firmicutes	12188	P	636099	6215	642314	0.04838
SRR6032574_1_kneaddata_paired	Campylobacterota	8700	P	227085	17	227102	0.01711
SRR6032574_1_kneaddata_paired	Desulfobacterota_A	11509	P	110100	1641	111741	0.00842
SRR6032574_1_kneaddata_paired	Actinobacteriota	615	P	94108	396	94504	0.00712
SRR6032574_1_kneaddata_paired	Deferribacterota	10822	P	63193	283	63476	0.00478
SRR6032574_1_kneaddata_paired	Cyanobacteria	9876	P	61636	340	61976	0.00467
SRR6032574_1_kneaddata_paired	Proteobacteria	22518	P	33984	85	34069	0.00257
SRR6032574_1_kneaddata_paired	Verrucomicrobiota	33333	P	1140	79	1219	0.00009
SRR6032574_1_kneaddata_paired	Firmicutes_B	17289	P	405	17	422	0.00003
SRR6032574_1_kneaddata_paired	Spirochaetota	32587	P	234	0	234	0.00002
SRR6032574_1_kneaddata_paired	Firmicutes_I	18140	P	127	0	127	0.00001
SRR6032574_1_kneaddata_paired	Firmicutes_C	17613	P	62	0	62	0.00000
SRR6032574_1_kneaddata_paired	Elusimicrobiota	11888	P	20	0	20	0.00000
SRR6032574_1_kneaddata_paired	Thermotogota	33086	P	15	0	15	0.00000
SRR6032575_1_kneaddata_paired	Firmicutes_A	14608	P	14177310	72717	14250027	0.83522
SRR6032575_1_kneaddata_paired	Bacteroidota	4587	P	1722293	15158	1737451	0.10183
SRR6032575_1_kneaddata_paired	Campylobacterota	8700	P	381610	25	381635	0.02237
SRR6032575_1_kneaddata_paired	Firmicutes	12188	P	304990	3384	308374	0.01807
SRR6032575_1_kneaddata_paired	Desulfobacterota_A	11509	P	128654	1673	130327	0.00764
SRR6032575_1_kneaddata_paired	Deferribacterota	10822	P	119036	477	119513	0.00700
SRR6032575_1_kneaddata_paired	Actinobacteriota	615	P	64891	224	65115	0.00382
SRR6032575_1_kneaddata_paired	Cyanobacteria	9876	P	56051	201	56252	0.00330
SRR6032575_1_kneaddata_paired	Proteobacteria	22518	P	10893	26	10919	0.00064
SRR6032575_1_kneaddata_paired	Firmicutes_B	17289	P	819	32	851	0.00005
SRR6032575_1_kneaddata_paired	Verrucomicrobiota	33333	P	470	24	494	0.00003
SRR6032575_1_kneaddata_paired	Spirochaetota	32587	P	286	0	286	0.00002
SRR6032575_1_kneaddata_paired	Firmicutes_I	18140	P	113	0	113	0.00001
SRR6032575_1_kneaddata_paired	Firmicutes_C	17613	P	111	0	111	0.00001
SRR6032575_1_kneaddata_paired	Elusimicrobiota	11888	P	12	0	12	0.00000
SRR6032575_1_kneaddata_paired	Thermotogota	33086	P	12	0	12	0.00000
SRR6032576_1_kneaddata_paired	Firmicutes_A	14608	P	20935120	122535	21057655	0.92309
SRR6032576_1_kneaddata_paired	Bacteroidota	4587	P	668497	2235	670732	0.02940
SRR6032576_1_kneaddata_paired	Firmicutes	12188	P	651245	7687	658932	0.02889
SRR6032576_1_kneaddata_paired	Deferribacterota	10822	P	255180	1123	256303	0.01124
SRR6032576_1_kneaddata_paired	Actinobacteriota	615	P	76646	123	76769	0.00337
SRR6032576_1_kneaddata_paired	Firmicutes_B	17289	P	48793	2124	50917	0.00223
SRR6032576_1_kneaddata_paired	Verrucomicrobiota	33333	P	30763	716	31479	0.00138
SRR6032576_1_kneaddata_paired	Proteobacteria	22518	P	2611	36	2647	0.00012
SRR6032576_1_kneaddata_paired	Cyanobacteria	9876	P	2258	53	2311	0.00010
SRR6032576_1_kneaddata_paired	Desulfobacterota_A	11509	P	2034	296	2330	0.00010
SRR6032576_1_kneaddata_paired	Campylobacterota	8700	P	707	0	707	0.00003
SRR6032576_1_kneaddata_paired	Spirochaetota	32587	P	647	2	649	0.00003
SRR6032576_1_kneaddata_paired	Firmicutes_I	18140	P	275	0	275	0.00001
SRR6032576_1_kneaddata_paired	Firmicutes_C	17613	P	228	0	228	0.00001
SRR6032576_1_kneaddata_paired	Thermotogota	33086	P	74	0	74	0.00000
SRR6032576_1_kneaddata_paired	Elusimicrobiota	11888	P	7	0	7	0.00000
SRR6032577_1_kneaddata_paired	Firmicutes_A	14608	P	21989397	138329	22127726	0.95726
SRR6032577_1_kneaddata_paired	Firmicutes	12188	P	290507	4627	295134	0.01277
SRR6032577_1_kneaddata_paired	Bacteroidota	4587	P	284352	1527	285879	0.01237
SRR6032577_1_kneaddata_paired	Deferribacterota	10822	P	266786	1118	267904	0.01159
SRR6032577_1_kneaddata_paired	Firmicutes_B	17289	P	72524	3010	75534	0.00327
SRR6032577_1_kneaddata_paired	Actinobacteriota	615	P	41834	64	41898	0.00181
SRR6032577_1_kneaddata_paired	Cyanobacteria	9876	P	9573	729	10302	0.00045
SRR6032577_1_kneaddata_paired	Verrucomicrobiota	33333	P	4509	181	4690	0.00020
SRR6032577_1_kneaddata_paired	Desulfobacterota_A	11509	P	2728	447	3175	0.00014
SRR6032577_1_kneaddata_paired	Proteobacteria	22518	P	2317	22	2339	0.00010
SRR6032577_1_kneaddata_paired	Spirochaetota	32587	P	452	1	453	0.00002
SRR6032577_1_kneaddata_paired	Firmicutes_C	17613	P	306	0	306	0.00001
SRR6032577_1_kneaddata_paired	Campylobacterota	8700	P	230	0	230	0.00001
SRR6032577_1_kneaddata_paired	Firmicutes_I	18140	P	171	0	171	0.00001
SRR6032577_1_kneaddata_paired	Thermotogota	33086	P	32	0	32	0.00000
SRR6032577_1_kneaddata_paired	Elusimicrobiota	11888	P	9	0	9	0.00000
SRR6032578_1_kneaddata_paired	Firmicutes_A	14608	P	34354120	225216	34579336	0.92037
SRR6032578_1_kneaddata_paired	Firmicutes	12188	P	1375515	14630	1390145	0.03700
SRR6032578_1_kneaddata_paired	Bacteroidota	4587	P	853307	2956	856263	0.02279
SRR6032578_1_kneaddata_paired	Deferribacterota	10822	P	496827	1967	498794	0.01328
SRR6032578_1_kneaddata_paired	Firmicutes_B	17289	P	117315	4593	121908	0.00324
SRR6032578_1_kneaddata_paired	Actinobacteriota	615	P	80379	117	80496	0.00214
SRR6032578_1_kneaddata_paired	Verrucomicrobiota	33333	P	21166	471	21637	0.00058
SRR6032578_1_kneaddata_paired	Cyanobacteria	9876	P	9822	602	10424	0.00028
SRR6032578_1_kneaddata_paired	Proteobacteria	22518	P	4586	46	4632	0.00012
SRR6032578_1_kneaddata_paired	Desulfobacterota_A	11509	P	4073	612	4685	0.00012
SRR6032578_1_kneaddata_paired	Spirochaetota	32587	P	1079	3	1082	0.00003
SRR6032578_1_kneaddata_paired	Campylobacterota	8700	P	972	0	972	0.00003
SRR6032578_1_kneaddata_paired	Firmicutes_C	17613	P	349	0	349	0.00001
SRR6032578_1_kneaddata_paired	Firmicutes_I	18140	P	335	0	335	0.00001
SRR6032578_1_kneaddata_paired	Thermotogota	33086	P	104	0	104	0.00000
SRR6032578_1_kneaddata_paired	Elusimicrobiota	11888	P	22	0	22	0.00000
SRR6032579_1_kneaddata_paired	Firmicutes_A	14608	P	8176548	45267	8221815	0.62388
SRR6032579_1_kneaddata_paired	Firmicutes	12188	P	2469839	30842	2500681	0.18975
SRR6032579_1_kneaddata_paired	Bacteroidota	4587	P	1772669	16230	1788899	0.13574
SRR6032579_1_kneaddata_paired	Campylobacterota	8700	P	271389	25	271414	0.02060
SRR6032579_1_kneaddata_paired	Deferribacterota	10822	P	267256	1751	269007	0.02041
SRR6032579_1_kneaddata_paired	Desulfobacterota_A	11509	P	84289	1755	86044	0.00653
SRR6032579_1_kneaddata_paired	Proteobacteria	22518	P	17522	136	17658	0.00134
SRR6032579_1_kneaddata_paired	Actinobacteriota	615	P	12156	48	12204	0.00093
SRR6032579_1_kneaddata_paired	Cyanobacteria	9876	P	9115	428	9543	0.00072
SRR6032579_1_kneaddata_paired	Firmicutes_B	17289	P	465	30	495	0.00004
SRR6032579_1_kneaddata_paired	Spirochaetota	32587	P	207	0	207	0.00002
SRR6032579_1_kneaddata_paired	Verrucomicrobiota	33333	P	206	19	225	0.00002
SRR6032579_1_kneaddata_paired	Firmicutes_I	18140	P	182	0	182	0.00001
SRR6032579_1_kneaddata_paired	Firmicutes_C	17613	P	79	0	79	0.00001
SRR6032579_1_kneaddata_paired	Elusimicrobiota	11888	P	13	0	13	0.00000
SRR6032579_1_kneaddata_paired	Thermotogota	33086	P	13	0	13	0.00000
SRR6032580_1_kneaddata_paired	Firmicutes_A	14608	P	2609924	18573	2628497	0.55813
SRR6032580_1_kneaddata_paired	Bacteroidota	4587	P	1279315	10382	1289697	0.27385
SRR6032580_1_kneaddata_paired	Firmicutes	12188	P	435280	3420	438700	0.09315
SRR6032580_1_kneaddata_paired	Campylobacterota	8700	P	247095	25	247120	0.05247
SRR6032580_1_kneaddata_paired	Desulfobacterota_A	11509	P	52852	565	53417	0.01134
SRR6032580_1_kneaddata_paired	Deferribacterota	10822	P	44737	186	44923	0.00954
SRR6032580_1_kneaddata_paired	Actinobacteriota	615	P	3516	9	3525	0.00075
SRR6032580_1_kneaddata_paired	Cyanobacteria	9876	P	1846	36	1882	0.00040
SRR6032580_1_kneaddata_paired	Proteobacteria	22518	P	1234	4	1238	0.00026
SRR6032580_1_kneaddata_paired	Firmicutes_B	17289	P	192	7	199	0.00004
SRR6032580_1_kneaddata_paired	Verrucomicrobiota	33333	P	117	6	123	0.00003
SRR6032580_1_kneaddata_paired	Spirochaetota	32587	P	113	0	113	0.00002
SRR6032580_1_kneaddata_paired	Firmicutes_I	18140	P	27	0	27	0.00001
SRR6032580_1_kneaddata_paired	Firmicutes_C	17613	P	25	0	25	0.00001
SRR6032580_1_kneaddata_paired	Thermotogota	33086	P	6	0	6	0.00000
SRR6032580_1_kneaddata_paired	Elusimicrobiota	11888	P	1	0	1	0.00000
SRR6032581_1_kneaddata_paired	Firmicutes_A	14608	P	5053489	30015	5083504	0.63064
SRR6032581_1_kneaddata_paired	Bacteroidota	4587	P	1903536	30291	1933827	0.23991
SRR6032581_1_kneaddata_paired	Campylobacterota	8700	P	724979	110	725089	0.08995
SRR6032581_1_kneaddata_paired	Firmicutes	12188	P	179156	2372	181528	0.02252
SRR6032581_1_kneaddata_paired	Desulfobacterota_A	11509	P	65627	969	66596	0.00826
SRR6032581_1_kneaddata_paired	Deferribacterota	10822	P	44185	224	44409	0.00551
SRR6032581_1_kneaddata_paired	Actinobacteriota	615	P	17409	138	17547	0.00218
SRR6032581_1_kneaddata_paired	Proteobacteria	22518	P	4243	39	4282	0.00053
SRR6032581_1_kneaddata_paired	Cyanobacteria	9876	P	3433	140	3573	0.00044
SRR6032581_1_kneaddata_paired	Verrucomicrobiota	33333	P	132	10	142	0.00002
SRR6032581_1_kneaddata_paired	Spirochaetota	32587	P	121	0	121	0.00002
SRR6032581_1_kneaddata_paired	Firmicutes_B	17289	P	107	5	112	0.00001
SRR6032581_1_kneaddata_paired	Firmicutes_I	18140	P	46	0	46	0.00001
SRR6032581_1_kneaddata_paired	Firmicutes_C	17613	P	10	0	10	0.00000
SRR6032581_1_kneaddata_paired	Elusimicrobiota	11888	P	6	0	6	0.00000
SRR6032581_1_kneaddata_paired	Thermotogota	33086	P	6	0	6	0.00000
SRR6032582_1_kneaddata_paired	Firmicutes_A	14608	P	11083674	58261	11141935	0.65823
SRR6032582_1_kneaddata_paired	Bacteroidota	4587	P	2710554	37211	2747765	0.16233
SRR6032582_1_kneaddata_paired	Firmicutes	12188	P	2626009	24337	2650346	0.15657
SRR6032582_1_kneaddata_paired	Campylobacterota	8700	P	221634	21	221655	0.01309
SRR6032582_1_kneaddata_paired	Desulfobacterota_A	11509	P	80745	1198	81943	0.00484
SRR6032582_1_kneaddata_paired	Deferribacterota	10822	P	52999	268	53267	0.00315
SRR6032582_1_kneaddata_paired	Actinobacteriota	615	P	19989	68	20057	0.00118
SRR6032582_1_kneaddata_paired	Cyanobacteria	9876	P	6670	85	6755	0.00040
SRR6032582_1_kneaddata_paired	Proteobacteria	22518	P	1896	15	1911	0.00011
SRR6032582_1_kneaddata_paired	Verrucomicrobiota	33333	P	481	26	507	0.00003
SRR6032582_1_kneaddata_paired	Firmicutes_B	17289	P	434	21	455	0.00003
SRR6032582_1_kneaddata_paired	Firmicutes_I	18140	P	231	0	231	0.00001
SRR6032582_1_kneaddata_paired	Spirochaetota	32587	P	224	0	224	0.00001
SRR6032582_1_kneaddata_paired	Firmicutes_C	17613	P	101	0	101	0.00001
SRR6032582_1_kneaddata_paired	Thermotogota	33086	P	35	0	35	0.00000
SRR6032582_1_kneaddata_paired	Elusimicrobiota	11888	P	7	0	7	0.00000
SRR6032583_1_kneaddata_paired	Firmicutes_A	14608	P	4906755	42680	4949435	0.70235
SRR6032583_1_kneaddata_paired	Firmicutes	12188	P	1223607	14474	1238081	0.17569
SRR6032583_1_kneaddata_paired	Campylobacterota	8700	P	610914	164	611078	0.08672
SRR6032583_1_kneaddata_paired	Bacteroidota	4587	P	193399	4319	197718	0.02806
SRR6032583_1_kneaddata_paired	Desulfobacterota_A	11509	P	38348	1053	39401	0.00559
SRR6032583_1_kneaddata_paired	Actinobacteriota	615	P	6045	33	6078	0.00086
SRR6032583_1_kneaddata_paired	Cyanobacteria	9876	P	3356	140	3496	0.00050
SRR6032583_1_kneaddata_paired	Proteobacteria	22518	P	875	4	879	0.00012
SRR6032583_1_kneaddata_paired	Deferribacterota	10822	P	212	0	212	0.00003
SRR6032583_1_kneaddata_paired	Verrucomicrobiota	33333	P	163	16	179	0.00003
SRR6032583_1_kneaddata_paired	Firmicutes_B	17289	P	131	9	140	0.00002
SRR6032583_1_kneaddata_paired	Firmicutes_I	18140	P	99	0	99	0.00001
SRR6032583_1_kneaddata_paired	Firmicutes_C	17613	P	64	0	64	0.00001
SRR6032583_1_kneaddata_paired	Spirochaetota	32587	P	60	0	60	0.00001
SRR6032583_1_kneaddata_paired	Elusimicrobiota	11888	P	6	0	6	0.00000
SRR6032583_1_kneaddata_paired	Thermotogota	33086	P	6	0	6	0.00000
SRR6032584_1_kneaddata_paired	Firmicutes_A	14608	P	7300173	34780	7334953	0.71033
SRR6032584_1_kneaddata_paired	Bacteroidota	4587	P	1796962	21044	1818006	0.17606
SRR6032584_1_kneaddata_paired	Campylobacterota	8700	P	543377	46	543423	0.05263
SRR6032584_1_kneaddata_paired	Firmicutes	12188	P	441387	3071	444458	0.04304
SRR6032584_1_kneaddata_paired	Desulfobacterota_A	11509	P	116671	880	117551	0.01138
SRR6032584_1_kneaddata_paired	Deferribacterota	10822	P	48389	151	48540	0.00470
SRR6032584_1_kneaddata_paired	Cyanobacteria	9876	P	7341	286	7627	0.00074
SRR6032584_1_kneaddata_paired	Actinobacteriota	615	P	6938	15	6953	0.00067
SRR6032584_1_kneaddata_paired	Proteobacteria	22518	P	2412	4	2416	0.00023
SRR6032584_1_kneaddata_paired	Firmicutes_B	17289	P	1264	39	1303	0.00013
SRR6032584_1_kneaddata_paired	Verrucomicrobiota	33333	P	405	12	417	0.00004
SRR6032584_1_kneaddata_paired	Spirochaetota	32587	P	236	0	236	0.00002
SRR6032584_1_kneaddata_paired	Firmicutes_C	17613	P	76	0	76	0.00001
SRR6032584_1_kneaddata_paired	Firmicutes_I	18140	P	58	0	58	0.00001
SRR6032584_1_kneaddata_paired	Thermotogota	33086	P	29	0	29	0.00000
SRR6032584_1_kneaddata_paired	Elusimicrobiota	11888	P	12	0	12	0.00000
SRR6032585_1_kneaddata_paired	Firmicutes_A	14608	P	8431485	57054	8488539	0.71818
SRR6032585_1_kneaddata_paired	Firmicutes	12188	P	1559429	6739	1566168	0.13251
SRR6032585_1_kneaddata_paired	Bacteroidota	4587	P	1221495	15410	1236905	0.10465
SRR6032585_1_kneaddata_paired	Campylobacterota	8700	P	458921	46	458967	0.03883
SRR6032585_1_kneaddata_paired	Desulfobacterota_A	11509	P	50649	625	51274	0.00434
SRR6032585_1_kneaddata_paired	Actinobacteriota	615	P	10155	31	10186	0.00086
SRR6032585_1_kneaddata_paired	Cyanobacteria	9876	P	2895	45	2940	0.00025
SRR6032585_1_kneaddata_paired	Deferribacterota	10822	P	2103	7	2110	0.00018
SRR6032585_1_kneaddata_paired	Proteobacteria	22518	P	976	3	979	0.00008
SRR6032585_1_kneaddata_paired	Firmicutes_B	17289	P	460	17	477	0.00004
SRR6032585_1_kneaddata_paired	Firmicutes_I	18140	P	389	0	389	0.00003
SRR6032585_1_kneaddata_paired	Verrucomicrobiota	33333	P	296	15	311	0.00003
SRR6032585_1_kneaddata_paired	Spirochaetota	32587	P	126	0	126	0.00001
SRR6032585_1_kneaddata_paired	Firmicutes_C	17613	P	106	0	106	0.00001
SRR6032585_1_kneaddata_paired	Elusimicrobiota	11888	P	16	0	16	0.00000
SRR6032585_1_kneaddata_paired	Thermotogota	33086	P	16	0	16	0.00000
SRR6032586_1_kneaddata_paired	Firmicutes_A	14608	P	10613676	54523	10668199	0.83208
SRR6032586_1_kneaddata_paired	Firmicutes	12188	P	917367	4224	921591	0.07188
SRR6032586_1_kneaddata_paired	Bacteroidota	4587	P	858133	9278	867411	0.06765
SRR6032586_1_kneaddata_paired	Campylobacterota	8700	P	275474	20	275494	0.02149
SRR6032586_1_kneaddata_paired	Desulfobacterota_A	11509	P	53807	688	54495	0.00425
SRR6032586_1_kneaddata_paired	Deferribacterota	10822	P	22382	94	22476	0.00175
SRR6032586_1_kneaddata_paired	Actinobacteriota	615	P	6449	37	6486	0.00051
SRR6032586_1_kneaddata_paired	Cyanobacteria	9876	P	2317	47	2364	0.00018
SRR6032586_1_kneaddata_paired	Proteobacteria	22518	P	881	3	884	0.00007
SRR6032586_1_kneaddata_paired	Firmicutes_B	17289	P	783	32	815	0.00006
SRR6032586_1_kneaddata_paired	Verrucomicrobiota	33333	P	450	26	476	0.00004
SRR6032586_1_kneaddata_paired	Spirochaetota	32587	P	191	0	191	0.00001
SRR6032586_1_kneaddata_paired	Firmicutes_I	18140	P	112	0	112	0.00001
SRR6032586_1_kneaddata_paired	Firmicutes_C	17613	P	91	0	91	0.00001
SRR6032586_1_kneaddata_paired	Thermotogota	33086	P	11	0	11	0.00000
SRR6032586_1_kneaddata_paired	Elusimicrobiota	11888	P	6	0	6	0.00000
SRR6032587_1_kneaddata_paired	Firmicutes_A	14608	P	6826074	36317	6862391	0.71525
SRR6032587_1_kneaddata_paired	Bacteroidota	4587	P	1576889	13420	1590309	0.16575
SRR6032587_1_kneaddata_paired	Campylobacterota	8700	P	770348	43	770391	0.08030
SRR6032587_1_kneaddata_paired	Firmicutes	12188	P	215280	1840	217120	0.02263
SRR6032587_1_kneaddata_paired	Desulfobacterota_A	11509	P	84160	911	85071	0.00887
SRR6032587_1_kneaddata_paired	Deferribacterota	10822	P	36158	137	36295	0.00378
SRR6032587_1_kneaddata_paired	Actinobacteriota	615	P	17650	74	17724	0.00185
SRR6032587_1_kneaddata_paired	Proteobacteria	22518	P	10057	53	10110	0.00105
SRR6032587_1_kneaddata_paired	Cyanobacteria	9876	P	3559	40	3599	0.00038
SRR6032587_1_kneaddata_paired	Firmicutes_B	17289	P	501	18	519	0.00005
SRR6032587_1_kneaddata_paired	Verrucomicrobiota	33333	P	485	25	510	0.00005
SRR6032587_1_kneaddata_paired	Spirochaetota	32587	P	179	0	179	0.00002
SRR6032587_1_kneaddata_paired	Firmicutes_I	18140	P	89	0	89	0.00001
SRR6032587_1_kneaddata_paired	Firmicutes_C	17613	P	85	0	85	0.00001
SRR6032587_1_kneaddata_paired	Elusimicrobiota	11888	P	5	0	5	0.00000
SRR6032587_1_kneaddata_paired	Thermotogota	33086	P	5	0	5	0.00000
SRR6032588_1_kneaddata_paired	Firmicutes_A	14608	P	6597687	51327	6649014	0.58282
SRR6032588_1_kneaddata_paired	Bacteroidota	4587	P	2296008	32064	2328072	0.20407
SRR6032588_1_kneaddata_paired	Firmicutes	12188	P	1775645	15325	1790970	0.15699
SRR6032588_1_kneaddata_paired	Campylobacterota	8700	P	383924	78	384002	0.03366
SRR6032588_1_kneaddata_paired	Desulfobacterota_A	11509	P	122100	1470	123570	0.01083
SRR6032588_1_kneaddata_paired	Deferribacterota	10822	P	91724	456	92180	0.00808
SRR6032588_1_kneaddata_paired	Actinobacteriota	615	P	33141	88	33229	0.00291
SRR6032588_1_kneaddata_paired	Cyanobacteria	9876	P	3236	51	3287	0.00029
SRR6032588_1_kneaddata_paired	Proteobacteria	22518	P	3035	7	3042	0.00027
SRR6032588_1_kneaddata_paired	Verrucomicrobiota	33333	P	265	19	284	0.00002
SRR6032588_1_kneaddata_paired	Firmicutes_B	17289	P	254	12	266	0.00002
SRR6032588_1_kneaddata_paired	Spirochaetota	32587	P	139	0	139	0.00001
SRR6032588_1_kneaddata_paired	Firmicutes_I	18140	P	118	0	118	0.00001
SRR6032588_1_kneaddata_paired	Firmicutes_C	17613	P	72	0	72	0.00001
SRR6032588_1_kneaddata_paired	Thermotogota	33086	P	18	0	18	0.00000
SRR6032588_1_kneaddata_paired	Elusimicrobiota	11888	P	8	0	8	0.00000
SRR6032589_1_kneaddata_paired	Firmicutes_A	14608	P	19208303	120379	19328682	0.94140
SRR6032589_1_kneaddata_paired	Bacteroidota	4587	P	424821	1502	426323	0.02076
SRR6032589_1_kneaddata_paired	Firmicutes	12188	P	369792	4007	373799	0.01821
SRR6032589_1_kneaddata_paired	Deferribacterota	10822	P	297154	1238	298392	0.01453
SRR6032589_1_kneaddata_paired	Firmicutes_B	17289	P	46385	1909	48294	0.00235
SRR6032589_1_kneaddata_paired	Actinobacteriota	615	P	38741	65	38806	0.00189
SRR6032589_1_kneaddata_paired	Cyanobacteria	9876	P	6418	397	6815	0.00033
SRR6032589_1_kneaddata_paired	Verrucomicrobiota	33333	P	4913	127	5040	0.00025
SRR6032589_1_kneaddata_paired	Desulfobacterota_A	11509	P	2078	336	2414	0.00012
SRR6032589_1_kneaddata_paired	Proteobacteria	22518	P	2068	18	2086	0.00010
SRR6032589_1_kneaddata_paired	Spirochaetota	32587	P	421	1	422	0.00002
SRR6032589_1_kneaddata_paired	Campylobacterota	8700	P	300	0	300	0.00001
SRR6032589_1_kneaddata_paired	Firmicutes_C	17613	P	184	0	184	0.00001
SRR6032589_1_kneaddata_paired	Firmicutes_I	18140	P	132	0	132	0.00001
SRR6032589_1_kneaddata_paired	Thermotogota	33086	P	50	0	50	0.00000
SRR6032589_1_kneaddata_paired	Elusimicrobiota	11888	P	4	0	4	0.00000
SRR6032590_1_kneaddata_paired	Firmicutes_A	14608	P	12197687	86495	12284182	0.94527
SRR6032590_1_kneaddata_paired	Bacteroidota	4587	P	303852	1419	305271	0.02349
SRR6032590_1_kneaddata_paired	Firmicutes	12188	P	254171	3145	257316	0.01980
SRR6032590_1_kneaddata_paired	Deferribacterota	10822	P	88518	419	88937	0.00684
SRR6032590_1_kneaddata_paired	Firmicutes_B	17289	P	26972	1260	28232	0.00217
SRR6032590_1_kneaddata_paired	Actinobacteriota	615	P	24188	44	24232	0.00186
SRR6032590_1_kneaddata_paired	Verrucomicrobiota	33333	P	2158	68	2226	0.00017
SRR6032590_1_kneaddata_paired	Desulfobacterota_A	11509	P	1803	334	2137	0.00016
SRR6032590_1_kneaddata_paired	Proteobacteria	22518	P	1154	12	1166	0.00009
SRR6032590_1_kneaddata_paired	Cyanobacteria	9876	P	903	24	927	0.00007
SRR6032590_1_kneaddata_paired	Spirochaetota	32587	P	302	1	303	0.00002
SRR6032590_1_kneaddata_paired	Campylobacterota	8700	P	212	0	212	0.00002
SRR6032590_1_kneaddata_paired	Firmicutes_C	17613	P	171	0	171	0.00001
SRR6032590_1_kneaddata_paired	Firmicutes_I	18140	P	133	0	133	0.00001
SRR6032590_1_kneaddata_paired	Thermotogota	33086	P	21	0	21	0.00000
SRR6032590_1_kneaddata_paired	Elusimicrobiota	11888	P	5	0	5	0.00000
SRR6032591_1_kneaddata_paired	Firmicutes_A	14608	P	24946389	152740	25099129	0.91895
SRR6032591_1_kneaddata_paired	Firmicutes	12188	P	816674	7656	824330	0.03018
SRR6032591_1_kneaddata_paired	Deferribacterota	10822	P	655634	2738	658372	0.02410
SRR6032591_1_kneaddata_paired	Bacteroidota	4587	P	526522	1743	528265	0.01934
SRR6032591_1_kneaddata_paired	Firmicutes_B	17289	P	74769	3087	77856	0.00285
SRR6032591_1_kneaddata_paired	Proteobacteria	22518	P	58517	263	58780	0.00215
SRR6032591_1_kneaddata_paired	Actinobacteriota	615	P	47497	83	47580	0.00174
SRR6032591_1_kneaddata_paired	Cyanobacteria	9876	P	7870	516	8386	0.00031
SRR6032591_1_kneaddata_paired	Verrucomicrobiota	33333	P	5052	143	5195	0.00019
SRR6032591_1_kneaddata_paired	Desulfobacterota_A	11509	P	2983	496	3479	0.00013
SRR6032591_1_kneaddata_paired	Spirochaetota	32587	P	579	1	580	0.00002
SRR6032591_1_kneaddata_paired	Campylobacterota	8700	P	456	0	456	0.00002
SRR6032591_1_kneaddata_paired	Firmicutes_C	17613	P	255	0	255	0.00001
SRR6032591_1_kneaddata_paired	Firmicutes_I	18140	P	162	0	162	0.00001
SRR6032591_1_kneaddata_paired	Thermotogota	33086	P	51	0	51	0.00000
SRR6032591_1_kneaddata_paired	Elusimicrobiota	11888	P	11	0	11	0.00000
SRR6032592_1_kneaddata_paired	Firmicutes_A	14608	P	13097518	92548	13190066	0.92576
SRR6032592_1_kneaddata_paired	Firmicutes	12188	P	523728	5562	529290	0.03715
SRR6032592_1_kneaddata_paired	Bacteroidota	4587	P	359137	1482	360619	0.02531
SRR6032592_1_kneaddata_paired	Deferribacterota	10822	P	93661	440	94101	0.00660
SRR6032592_1_kneaddata_paired	Firmicutes_B	17289	P	29338	1366	30704	0.00216
SRR6032592_1_kneaddata_paired	Actinobacteriota	615	P	27256	43	27299	0.00192
SRR6032592_1_kneaddata_paired	Verrucomicrobiota	33333	P	7569	194	7763	0.00054
SRR6032592_1_kneaddata_paired	Proteobacteria	22518	P	2668	15	2683	0.00019
SRR6032592_1_kneaddata_paired	Cyanobacteria	9876	P	2102	84	2186	0.00015
SRR6032592_1_kneaddata_paired	Desulfobacterota_A	11509	P	1773	323	2096	0.00015
SRR6032592_1_kneaddata_paired	Spirochaetota	32587	P	379	1	380	0.00003
SRR6032592_1_kneaddata_paired	Campylobacterota	8700	P	266	0	266	0.00002
SRR6032592_1_kneaddata_paired	Firmicutes_C	17613	P	136	0	136	0.00001
SRR6032592_1_kneaddata_paired	Firmicutes_I	18140	P	120	0	120	0.00001
SRR6032592_1_kneaddata_paired	Thermotogota	33086	P	25	0	25	0.00000
SRR6032592_1_kneaddata_paired	Elusimicrobiota	11888	P	11	0	11	0.00000
SRR6032593_1_kneaddata_paired	Firmicutes_A	14608	P	19372846	118798	19491644	0.93657
SRR6032593_1_kneaddata_paired	Firmicutes	12188	P	609512	4400	613912	0.02950
SRR6032593_1_kneaddata_paired	Bacteroidota	4587	P	466774	1307	468081	0.02249
SRR6032593_1_kneaddata_paired	Deferribacterota	10822	P	117084	411	117495	0.00565
SRR6032593_1_kneaddata_paired	Actinobacteriota	615	P	41685	59	41744	0.00201
SRR6032593_1_kneaddata_paired	Firmicutes_B	17289	P	41193	1429	42622	0.00205
SRR6032593_1_kneaddata_paired	Verrucomicrobiota	33333	P	20383	378	20761	0.00100
SRR6032593_1_kneaddata_paired	Cyanobacteria	9876	P	9931	597	10528	0.00051
SRR6032593_1_kneaddata_paired	Proteobacteria	22518	P	1896	20	1916	0.00009
SRR6032593_1_kneaddata_paired	Desulfobacterota_A	11509	P	1630	203	1833	0.00009
SRR6032593_1_kneaddata_paired	Spirochaetota	32587	P	452	1	453	0.00002
SRR6032593_1_kneaddata_paired	Campylobacterota	8700	P	384	0	384	0.00002
SRR6032593_1_kneaddata_paired	Firmicutes_C	17613	P	203	0	203	0.00001
SRR6032593_1_kneaddata_paired	Firmicutes_I	18140	P	128	0	128	0.00001
SRR6032593_1_kneaddata_paired	Thermotogota	33086	P	30	0	30	0.00000
SRR6032593_1_kneaddata_paired	Elusimicrobiota	11888	P	3	0	3	0.00000
SRR6032594_1_kneaddata_paired	Firmicutes_A	14608	P	16365455	104267	16469722	0.93412
SRR6032594_1_kneaddata_paired	Firmicutes	12188	P	595251	7688	602939	0.03420
SRR6032594_1_kneaddata_paired	Bacteroidota	4587	P	262577	1225	263802	0.01496
SRR6032594_1_kneaddata_paired	Deferribacterota	10822	P	210952	963	211915	0.01202
SRR6032594_1_kneaddata_paired	Actinobacteriota	615	P	34489	58	34547	0.00196
SRR6032594_1_kneaddata_paired	Firmicutes_B	17289	P	32782	1477	34259	0.00194
SRR6032594_1_kneaddata_paired	Verrucomicrobiota	33333	P	5522	150	5672	0.00032
SRR6032594_1_kneaddata_paired	Cyanobacteria	9876	P	3069	184	3253	0.00018
SRR6032594_1_kneaddata_paired	Desulfobacterota_A	11509	P	1883	315	2198	0.00012
SRR6032594_1_kneaddata_paired	Proteobacteria	22518	P	1732	14	1746	0.00010
SRR6032594_1_kneaddata_paired	Spirochaetota	32587	P	394	1	395	0.00002
SRR6032594_1_kneaddata_paired	Campylobacterota	8700	P	339	0	339	0.00002
SRR6032594_1_kneaddata_paired	Firmicutes_C	17613	P	231	0	231	0.00001
SRR6032594_1_kneaddata_paired	Firmicutes_I	18140	P	134	0	134	0.00001
SRR6032594_1_kneaddata_paired	Thermotogota	33086	P	26	0	26	0.00000
SRR6032594_1_kneaddata_paired	Elusimicrobiota	11888	P	8	0	8	0.00000
SRR6032595_1_kneaddata_paired	Firmicutes_A	14608	P	20083679	118672	20202351	0.95447
SRR6032595_1_kneaddata_paired	Bacteroidota	4587	P	488684	1720	490404	0.02317
SRR6032595_1_kneaddata_paired	Firmicutes	12188	P	242359	4692	247051	0.01167
SRR6032595_1_kneaddata_paired	Deferribacterota	10822	P	95663	420	96083	0.00454
SRR6032595_1_kneaddata_paired	Firmicutes_B	17289	P	56261	2435	58696	0.00277
SRR6032595_1_kneaddata_paired	Actinobacteriota	615	P	44424	76	44500	0.00210
SRR6032595_1_kneaddata_paired	Verrucomicrobiota	33333	P	11554	280	11834	0.00056
SRR6032595_1_kneaddata_paired	Cyanobacteria	9876	P	7019	484	7503	0.00035
SRR6032595_1_kneaddata_paired	Desulfobacterota_A	11509	P	2485	291	2776	0.00013
SRR6032595_1_kneaddata_paired	Campylobacterota	8700	P	2272	0	2272	0.00011
SRR6032595_1_kneaddata_paired	Proteobacteria	22518	P	1826	27	1853	0.00009
SRR6032595_1_kneaddata_paired	Spirochaetota	32587	P	369	1	370	0.00002
SRR6032595_1_kneaddata_paired	Firmicutes_C	17613	P	191	0	191	0.00001
SRR6032595_1_kneaddata_paired	Firmicutes_I	18140	P	138	0	138	0.00001
SRR6032595_1_kneaddata_paired	Thermotogota	33086	P	25	0	25	0.00000
SRR6032595_1_kneaddata_paired	Elusimicrobiota	11888	P	9	0	9	0.00000
SRR6032596_1_kneaddata_paired	Firmicutes_A	14608	P	22001412	179603	22181015	0.90650
SRR6032596_1_kneaddata_paired	Bacteroidota	4587	P	969450	4525	973975	0.03980
SRR6032596_1_kneaddata_paired	Firmicutes	12188	P	898131	9352	907483	0.03709
SRR6032596_1_kneaddata_paired	Deferribacterota	10822	P	143646	801	144447	0.00590
SRR6032596_1_kneaddata_paired	Actinobacteriota	615	P	120606	239	120845	0.00494
SRR6032596_1_kneaddata_paired	Firmicutes_B	17289	P	95663	5264	100927	0.00412
SRR6032596_1_kneaddata_paired	Verrucomicrobiota	33333	P	31350	910	32260	0.00132
SRR6032596_1_kneaddata_paired	Proteobacteria	22518	P	2336	20	2356	0.00010
SRR6032596_1_kneaddata_paired	Desulfobacterota_A	11509	P	1937	368	2305	0.00009
SRR6032596_1_kneaddata_paired	Cyanobacteria	9876	P	1762	99	1861	0.00008
SRR6032596_1_kneaddata_paired	Spirochaetota	32587	P	496	2	498	0.00002
SRR6032596_1_kneaddata_paired	Campylobacterota	8700	P	332	0	332	0.00001
SRR6032596_1_kneaddata_paired	Firmicutes_C	17613	P	236	0	236	0.00001
SRR6032596_1_kneaddata_paired	Firmicutes_I	18140	P	165	0	165	0.00001
SRR6032596_1_kneaddata_paired	Thermotogota	33086	P	57	0	57	0.00000
SRR6032596_1_kneaddata_paired	Elusimicrobiota	11888	P	11	0	11	0.00000
SRR6032597_1_kneaddata_paired	Firmicutes_A	14608	P	8862108	64125	8926233	0.93147
SRR6032597_1_kneaddata_paired	Firmicutes	12188	P	257276	4454	261730	0.02731
SRR6032597_1_kneaddata_paired	Bacteroidota	4587	P	245816	1349	247165	0.02579
SRR6032597_1_kneaddata_paired	Deferribacterota	10822	P	94373	559	94932	0.00991
SRR6032597_1_kneaddata_paired	Firmicutes_B	17289	P	24116	1415	25531	0.00266
SRR6032597_1_kneaddata_paired	Actinobacteriota	615	P	17148	42	17190	0.00179
SRR6032597_1_kneaddata_paired	Verrucomicrobiota	33333	P	5833	186	6019	0.00063
SRR6032597_1_kneaddata_paired	Cyanobacteria	9876	P	1565	138	1703	0.00018
SRR6032597_1_kneaddata_paired	Desulfobacterota_A	11509	P	972	209	1181	0.00012
SRR6032597_1_kneaddata_paired	Proteobacteria	22518	P	841	13	854	0.00009
SRR6032597_1_kneaddata_paired	Spirochaetota	32587	P	194	0	194	0.00002
SRR6032597_1_kneaddata_paired	Firmicutes_C	17613	P	101	0	101	0.00001
SRR6032597_1_kneaddata_paired	Campylobacterota	8700	P	83	0	83	0.00001
SRR6032597_1_kneaddata_paired	Firmicutes_I	18140	P	64	0	64	0.00001
SRR6032597_1_kneaddata_paired	Elusimicrobiota	11888	P	8	0	8	0.00000
SRR6032597_1_kneaddata_paired	Thermotogota	33086	P	8	0	8	0.00000
SRR6032598_1_kneaddata_paired	Firmicutes_A	14608	P	24084587	126357	24210944	0.76273
SRR6032598_1_kneaddata_paired	Bacteroidota	4587	P	4582200	32729	4614929	0.14539
SRR6032598_1_kneaddata_paired	Firmicutes	12188	P	1442545	15640	1458185	0.04594
SRR6032598_1_kneaddata_paired	Campylobacterota	8700	P	697451	54	697505	0.02197
SRR6032598_1_kneaddata_paired	Actinobacteriota	615	P	250884	940	251824	0.00793
SRR6032598_1_kneaddata_paired	Desulfobacterota_A	11509	P	234216	3252	237468	0.00748
SRR6032598_1_kneaddata_paired	Deferribacterota	10822	P	115338	509	115847	0.00365
SRR6032598_1_kneaddata_paired	Cyanobacteria	9876	P	101578	485	102063	0.00322
SRR6032598_1_kneaddata_paired	Proteobacteria	22518	P	49268	136	49404	0.00156
SRR6032598_1_kneaddata_paired	Verrucomicrobiota	33333	P	1976	126	2102	0.00007
SRR6032598_1_kneaddata_paired	Firmicutes_B	17289	P	1156	50	1206	0.00004
SRR6032598_1_kneaddata_paired	Spirochaetota	32587	P	496	1	497	0.00002
SRR6032598_1_kneaddata_paired	Firmicutes_I	18140	P	353	0	353	0.00001
SRR6032598_1_kneaddata_paired	Firmicutes_C	17613	P	220	0	220	0.00001
SRR6032598_1_kneaddata_paired	Elusimicrobiota	11888	P	26	0	26	0.00000
SRR6032598_1_kneaddata_paired	Thermotogota	33086	P	18	0	18	0.00000
SRR6032599_1_kneaddata_paired	Firmicutes_A	14608	P	16958732	97279	17056011	0.89729
SRR6032599_1_kneaddata_paired	Bacteroidota	4587	P	861314	1908	863222	0.04541
SRR6032599_1_kneaddata_paired	Firmicutes	12188	P	581687	6404	588091	0.03094
SRR6032599_1_kneaddata_paired	Deferribacterota	10822	P	274677	1048	275725	0.01451
SRR6032599_1_kneaddata_paired	Firmicutes_B	17289	P	87035	3279	90314	0.00475
SRR6032599_1_kneaddata_paired	Actinobacteriota	615	P	64473	80	64553	0.00340
SRR6032599_1_kneaddata_paired	Verrucomicrobiota	33333	P	59611	1168	60779	0.00320
SRR6032599_1_kneaddata_paired	Cyanobacteria	9876	P	2439	59	2498	0.00013
SRR6032599_1_kneaddata_paired	Proteobacteria	22518	P	2261	21	2282	0.00012
SRR6032599_1_kneaddata_paired	Desulfobacterota_A	11509	P	1748	163	1911	0.00010
SRR6032599_1_kneaddata_paired	Campylobacterota	8700	P	1442	1	1443	0.00008
SRR6032599_1_kneaddata_paired	Spirochaetota	32587	P	822	2	824	0.00004
SRR6032599_1_kneaddata_paired	Firmicutes_I	18140	P	406	0	406	0.00002
SRR6032599_1_kneaddata_paired	Firmicutes_C	17613	P	179	0	179	0.00001
SRR6032599_1_kneaddata_paired	Thermotogota	33086	P	48	0	48	0.00000
SRR6032599_1_kneaddata_paired	Elusimicrobiota	11888	P	18	0	18	0.00000
SRR6051570_kneaddata	Firmicutes_A	14608	P	13611453	78971	13690424	0.88221
SRR6051570_kneaddata	Bacteroidota	4587	P	1206840	16360	1223200	0.07882
SRR6051570_kneaddata	Firmicutes	12188	P	584979	8669	593648	0.03825
SRR6051570_kneaddata	Cyanobacteria	9876	P	4134	93	4227	0.00027
SRR6051570_kneaddata	Actinobacteriota	615	P	3853	3	3856	0.00025
SRR6051570_kneaddata	Firmicutes_B	17289	P	1014	41	1055	0.00007
SRR6051570_kneaddata	Desulfobacterota_A	11509	P	852	140	992	0.00006
SRR6051570_kneaddata	Proteobacteria	22518	P	356	3	359	0.00002
SRR6051570_kneaddata	Spirochaetota	32587	P	128	0	128	0.00001
SRR6051570_kneaddata	Campylobacterota	8700	P	122	0	122	0.00001
SRR6051570_kneaddata	Verrucomicrobiota	33333	P	87	5	92	0.00001
SRR6051570_kneaddata	Deferribacterota	10822	P	85	0	85	0.00001
SRR6051570_kneaddata	Firmicutes_I	18140	P	61	0	61	0.00000
SRR6051570_kneaddata	Firmicutes_C	17613	P	54	0	54	0.00000
SRR6051570_kneaddata	Elusimicrobiota	11888	P	6	0	6	0.00000
SRR6051570_kneaddata	Thermotogota	33086	P	5	0	5	0.00000
SRR6051571_kneaddata	Firmicutes_A	14608	P	1887663	12280	1899943	0.57426
SRR6051571_kneaddata	Bacteroidota	4587	P	1234227	13528	1247755	0.37713
SRR6051571_kneaddata	Firmicutes	12188	P	154520	2340	156860	0.04741
SRR6051571_kneaddata	Actinobacteriota	615	P	2546	2	2548	0.00077
SRR6051571_kneaddata	Cyanobacteria	9876	P	690	19	709	0.00021
SRR6051571_kneaddata	Firmicutes_B	17289	P	180	7	187	0.00006
SRR6051571_kneaddata	Desulfobacterota_A	11509	P	148	24	172	0.00005
SRR6051571_kneaddata	Proteobacteria	22518	P	93	1	94	0.00003
SRR6051571_kneaddata	Campylobacterota	8700	P	75	0	75	0.00002
SRR6051571_kneaddata	Spirochaetota	32587	P	62	0	62	0.00002
SRR6051571_kneaddata	Deferribacterota	10822	P	47	0	47	0.00001
SRR6051571_kneaddata	Verrucomicrobiota	33333	P	28	1	29	0.00001
SRR6051571_kneaddata	Firmicutes_I	18140	P	23	0	23	0.00001
SRR6051571_kneaddata	Firmicutes_C	17613	P	11	0	11	0.00000
SRR6051571_kneaddata	Elusimicrobiota	11888	P	2	0	2	0.00000
SRR6051571_kneaddata	Thermotogota	33086	P	1	0	1	0.00000
SRR6051572_kneaddata	Bacteroidota	4587	P	1564440	11066	1575506	0.54224
SRR6051572_kneaddata	Firmicutes_A	14608	P	1216193	5516	1221709	0.42048
SRR6051572_kneaddata	Firmicutes	12188	P	101652	1458	103110	0.03549
SRR6051572_kneaddata	Actinobacteriota	615	P	4172	3	4175	0.00144
SRR6051572_kneaddata	Cyanobacteria	9876	P	355	10	365	0.00013
SRR6051572_kneaddata	Firmicutes_B	17289	P	354	14	368	0.00013
SRR6051572_kneaddata	Proteobacteria	22518	P	85	0	85	0.00003
SRR6051572_kneaddata	Desulfobacterota_A	11509	P	70	8	78	0.00003
SRR6051572_kneaddata	Campylobacterota	8700	P	41	0	41	0.00001
SRR6051572_kneaddata	Spirochaetota	32587	P	34	0	34	0.00001
SRR6051572_kneaddata	Verrucomicrobiota	33333	P	21	0	21	0.00001
SRR6051572_kneaddata	Firmicutes_I	18140	P	19	0	19	0.00001
SRR6051572_kneaddata	Deferribacterota	10822	P	13	0	13	0.00000
SRR6051572_kneaddata	Firmicutes_C	17613	P	8	0	8	0.00000
SRR6051572_kneaddata	Elusimicrobiota	11888	P	1	0	1	0.00000
SRR6051573_kneaddata	Bacteroidota	4587	P	752937	5587	758524	0.49379
SRR6051573_kneaddata	Firmicutes_A	14608	P	725262	3957	729219	0.47472
SRR6051573_kneaddata	Firmicutes	12188	P	45150	781	45931	0.02990
SRR6051573_kneaddata	Actinobacteriota	615	P	1836	1	1837	0.00120
SRR6051573_kneaddata	Cyanobacteria	9876	P	294	6	300	0.00020
SRR6051573_kneaddata	Firmicutes_B	17289	P	75	3	78	0.00005
SRR6051573_kneaddata	Proteobacteria	22518	P	55	0	55	0.00004
SRR6051573_kneaddata	Deferribacterota	10822	P	37	0	37	0.00002
SRR6051573_kneaddata	Desulfobacterota_A	11509	P	34	5	39	0.00003
SRR6051573_kneaddata	Spirochaetota	32587	P	29	0	29	0.00002
SRR6051573_kneaddata	Campylobacterota	8700	P	27	0	27	0.00002
SRR6051573_kneaddata	Verrucomicrobiota	33333	P	17	0	17	0.00001
SRR6051573_kneaddata	Firmicutes_I	18140	P	12	0	12	0.00001
SRR6051573_kneaddata	Thermotogota	33086	P	5	0	5	0.00000
SRR6051573_kneaddata	Firmicutes_C	17613	P	2	0	2	0.00000
SRR6051574_kneaddata	Firmicutes_A	14608	P	1839589	10205	1849794	0.49406
SRR6051574_kneaddata	Bacteroidota	4587	P	1660363	19448	1679811	0.44866
SRR6051574_kneaddata	Firmicutes	12188	P	205137	3072	208209	0.05561
SRR6051574_kneaddata	Actinobacteriota	615	P	4976	2	4978	0.00133
SRR6051574_kneaddata	Cyanobacteria	9876	P	552	18	570	0.00015
SRR6051574_kneaddata	Firmicutes_B	17289	P	387	16	403	0.00011
SRR6051574_kneaddata	Desulfobacterota_A	11509	P	97	16	113	0.00003
SRR6051574_kneaddata	Proteobacteria	22518	P	82	0	82	0.00002
SRR6051574_kneaddata	Spirochaetota	32587	P	44	0	44	0.00001
SRR6051574_kneaddata	Campylobacterota	8700	P	26	0	26	0.00001
SRR6051574_kneaddata	Verrucomicrobiota	33333	P	22	1	23	0.00001
SRR6051574_kneaddata	Firmicutes_C	17613	P	14	0	14	0.00000
SRR6051574_kneaddata	Deferribacterota	10822	P	13	0	13	0.00000
SRR6051574_kneaddata	Firmicutes_I	18140	P	6	0	6	0.00000
SRR6051574_kneaddata	Thermotogota	33086	P	4	0	4	0.00000
SRR6051574_kneaddata	Elusimicrobiota	11888	P	2	0	2	0.00000
SRR6051575_kneaddata	Bacteroidota	4587	P	2415809	10618	2426427	0.82735
SRR6051575_kneaddata	Firmicutes_A	14608	P	410342	2058	412400	0.14062
SRR6051575_kneaddata	Firmicutes	12188	P	55557	672	56229	0.01917
SRR6051575_kneaddata	Actinobacteriota	615	P	36868	49	36917	0.01259
SRR6051575_kneaddata	Proteobacteria	22518	P	236	0	236	0.00008
SRR6051575_kneaddata	Cyanobacteria	9876	P	165	4	169	0.00006
SRR6051575_kneaddata	Campylobacterota	8700	P	125	0	125	0.00004
SRR6051575_kneaddata	Firmicutes_B	17289	P	107	5	112	0.00004
SRR6051575_kneaddata	Spirochaetota	32587	P	51	0	51	0.00002
SRR6051575_kneaddata	Desulfobacterota_A	11509	P	35	3	38	0.00001
SRR6051575_kneaddata	Firmicutes_I	18140	P	23	0	23	0.00001
SRR6051575_kneaddata	Verrucomicrobiota	33333	P	19	1	20	0.00001
SRR6051575_kneaddata	Deferribacterota	10822	P	7	0	7	0.00000
SRR6051575_kneaddata	Elusimicrobiota	11888	P	3	0	3	0.00000
SRR6051575_kneaddata	Firmicutes_C	17613	P	1	0	1	0.00000
SRR6051575_kneaddata	Thermotogota	33086	P	1	0	1	0.00000
SRR6051576_kneaddata	Bacteroidota	4587	P	1294298	20670	1314968	0.47007
SRR6051576_kneaddata	Firmicutes_A	14608	P	1263792	5304	1269096	0.45367
SRR6051576_kneaddata	Firmicutes	12188	P	161961	1731	163692	0.05852
SRR6051576_kneaddata	Actinobacteriota	615	P	47569	44	47613	0.01702
SRR6051576_kneaddata	Cyanobacteria	9876	P	1081	54	1135	0.00041
SRR6051576_kneaddata	Campylobacterota	8700	P	167	0	167	0.00006
SRR6051576_kneaddata	Proteobacteria	22518	P	144	0	144	0.00005
SRR6051576_kneaddata	Desulfobacterota_A	11509	P	132	17	149	0.00005
SRR6051576_kneaddata	Firmicutes_B	17289	P	117	4	121	0.00004
SRR6051576_kneaddata	Spirochaetota	32587	P	95	0	95	0.00003
SRR6051576_kneaddata	Deferribacterota	10822	P	77	0	77	0.00003
SRR6051576_kneaddata	Verrucomicrobiota	33333	P	66	2	68	0.00002
SRR6051576_kneaddata	Firmicutes_I	18140	P	48	0	48	0.00002
SRR6051576_kneaddata	Thermotogota	33086	P	7	0	7	0.00000
SRR6051576_kneaddata	Firmicutes_C	17613	P	3	0	3	0.00000
SRR6051576_kneaddata	Elusimicrobiota	11888	P	2	0	2	0.00000
SRR6051577_kneaddata	Firmicutes_A	14608	P	800104	5188	805292	0.42911
SRR6051577_kneaddata	Bacteroidota	4587	P	729764	26464	756228	0.40297
SRR6051577_kneaddata	Firmicutes	12188	P	227757	3347	231104	0.12315
SRR6051577_kneaddata	Actinobacteriota	615	P	82393	116	82509	0.04397
SRR6051577_kneaddata	Cyanobacteria	9876	P	547	20	567	0.00030
SRR6051577_kneaddata	Campylobacterota	8700	P	207	0	207	0.00011
SRR6051577_kneaddata	Firmicutes_B	17289	P	179	9	188	0.00010
SRR6051577_kneaddata	Proteobacteria	22518	P	139	0	139	0.00007
SRR6051577_kneaddata	Spirochaetota	32587	P	113	0	113	0.00006
SRR6051577_kneaddata	Firmicutes_I	18140	P	96	0	96	0.00005
SRR6051577_kneaddata	Deferribacterota	10822	P	78	0	78	0.00004
SRR6051577_kneaddata	Desulfobacterota_A	11509	P	60	9	69	0.00004
SRR6051577_kneaddata	Verrucomicrobiota	33333	P	40	3	43	0.00002
SRR6051577_kneaddata	Thermotogota	33086	P	6	0	6	0.00000
SRR6051577_kneaddata	Elusimicrobiota	11888	P	4	0	4	0.00000
SRR6051577_kneaddata	Firmicutes_C	17613	P	3	0	3	0.00000
SRR6051578_kneaddata	Bacteroidota	4587	P	1977582	14000	1991582	0.54807
SRR6051578_kneaddata	Firmicutes_A	14608	P	1387384	6966	1394350	0.38372
SRR6051578_kneaddata	Firmicutes	12188	P	225835	2770	228605	0.06291
SRR6051578_kneaddata	Actinobacteriota	615	P	15584	19	15603	0.00429
SRR6051578_kneaddata	Cyanobacteria	9876	P	2495	192	2687	0.00074
SRR6051578_kneaddata	Firmicutes_B	17289	P	206	9	215	0.00006
SRR6051578_kneaddata	Campylobacterota	8700	P	184	0	184	0.00005
SRR6051578_kneaddata	Proteobacteria	22518	P	136	0	136	0.00004
SRR6051578_kneaddata	Spirochaetota	32587	P	124	0	124	0.00003
SRR6051578_kneaddata	Desulfobacterota_A	11509	P	101	13	114	0.00003
SRR6051578_kneaddata	Firmicutes_I	18140	P	87	0	87	0.00002
SRR6051578_kneaddata	Deferribacterota	10822	P	66	0	66	0.00002
SRR6051578_kneaddata	Verrucomicrobiota	33333	P	34	2	36	0.00001
SRR6051578_kneaddata	Firmicutes_C	17613	P	7	0	7	0.00000
SRR6051578_kneaddata	Thermotogota	33086	P	5	0	5	0.00000
SRR6051578_kneaddata	Elusimicrobiota	11888	P	2	0	2	0.00000
SRR6051579_kneaddata	Bacteroidota	4587	P	1257358	7761	1265119	0.64418
SRR6051579_kneaddata	Firmicutes_A	14608	P	424853	1975	426828	0.21734
SRR6051579_kneaddata	Firmicutes	12188	P	128306	1320	129626	0.06600
SRR6051579_kneaddata	Verrucomicrobiota	33333	P	68950	3907	72857	0.03710
SRR6051579_kneaddata	Actinobacteriota	615	P	67574	67	67641	0.03444
SRR6051579_kneaddata	Cyanobacteria	9876	P	1171	69	1240	0.00063
SRR6051579_kneaddata	Campylobacterota	8700	P	122	0	122	0.00006
SRR6051579_kneaddata	Proteobacteria	22518	P	121	0	121	0.00006
SRR6051579_kneaddata	Spirochaetota	32587	P	89	0	89	0.00005
SRR6051579_kneaddata	Firmicutes_B	17289	P	83	3	86	0.00004
SRR6051579_kneaddata	Deferribacterota	10822	P	65	0	65	0.00003
SRR6051579_kneaddata	Desulfobacterota_A	11509	P	60	5	65	0.00003
SRR6051579_kneaddata	Firmicutes_I	18140	P	44	0	44	0.00002
SRR6051579_kneaddata	Firmicutes_C	17613	P	3	0	3	0.00000
SRR6051579_kneaddata	Thermotogota	33086	P	3	0	3	0.00000
SRR6051579_kneaddata	Elusimicrobiota	11888	P	2	0	2	0.00000
SRR6051580_kneaddata	Bacteroidota	4587	P	1457087	22894	1479981	0.62889
SRR6051580_kneaddata	Firmicutes_A	14608	P	618243	3865	622108	0.26435
SRR6051580_kneaddata	Firmicutes	12188	P	153645	1408	155053	0.06589
SRR6051580_kneaddata	Verrucomicrobiota	33333	P	61992	3902	65894	0.02800
SRR6051580_kneaddata	Actinobacteriota	615	P	28917	30	28947	0.01230
SRR6051580_kneaddata	Cyanobacteria	9876	P	600	29	629	0.00027
SRR6051580_kneaddata	Campylobacterota	8700	P	144	0	144	0.00006
SRR6051580_kneaddata	Spirochaetota	32587	P	142	0	142	0.00006
SRR6051580_kneaddata	Proteobacteria	22518	P	123	1	124	0.00005
SRR6051580_kneaddata	Firmicutes_B	17289	P	101	4	105	0.00004
SRR6051580_kneaddata	Firmicutes_I	18140	P	65	0	65	0.00003
SRR6051580_kneaddata	Desulfobacterota_A	11509	P	64	6	70	0.00003
SRR6051580_kneaddata	Deferribacterota	10822	P	60	0	60	0.00003
SRR6051580_kneaddata	Firmicutes_C	17613	P	9	0	9	0.00000
SRR6051580_kneaddata	Thermotogota	33086	P	3	0	3	0.00000
SRR6051580_kneaddata	Elusimicrobiota	11888	P	1	0	1	0.00000
SRR6051581_kneaddata	Bacteroidota	4587	P	4510942	15716	4526658	0.76958
SRR6051581_kneaddata	Firmicutes_A	14608	P	912932	3779	916711	0.15585
SRR6051581_kneaddata	Verrucomicrobiota	33333	P	274889	10146	285035	0.04846
SRR6051581_kneaddata	Firmicutes	12188	P	144938	1119	146057	0.02483
SRR6051581_kneaddata	Actinobacteriota	615	P	5913	5	5918	0.00101
SRR6051581_kneaddata	Firmicutes_B	17289	P	674	16	690	0.00012
SRR6051581_kneaddata	Cyanobacteria	9876	P	456	7	463	0.00008
SRR6051581_kneaddata	Deferribacterota	10822	P	97	0	97	0.00002
SRR6051581_kneaddata	Desulfobacterota_A	11509	P	93	8	101	0.00002
SRR6051581_kneaddata	Proteobacteria	22518	P	91	0	91	0.00002
SRR6051581_kneaddata	Campylobacterota	8700	P	76	0	76	0.00001
SRR6051581_kneaddata	Firmicutes_I	18140	P	45	0	45	0.00001
SRR6051581_kneaddata	Spirochaetota	32587	P	35	0	35	0.00001
SRR6051581_kneaddata	Firmicutes_C	17613	P	15	0	15	0.00000
SRR6051581_kneaddata	Thermotogota	33086	P	4	0	4	0.00000
SRR6051581_kneaddata	Elusimicrobiota	11888	P	1	0	1	0.00000
SRR6051582_kneaddata	Firmicutes_A	14608	P	1477444	10542	1487986	0.63134
SRR6051582_kneaddata	Bacteroidota	4587	P	785367	10894	796261	0.33785
SRR6051582_kneaddata	Firmicutes	12188	P	58877	907	59784	0.02537
SRR6051582_kneaddata	Actinobacteriota	615	P	11917	13	11930	0.00506
SRR6051582_kneaddata	Firmicutes_B	17289	P	306	12	318	0.00014
SRR6051582_kneaddata	Cyanobacteria	9876	P	163	4	167	0.00007
SRR6051582_kneaddata	Proteobacteria	22518	P	128	2	130	0.00006
SRR6051582_kneaddata	Verrucomicrobiota	33333	P	102	6	108	0.00005
SRR6051582_kneaddata	Desulfobacterota_A	11509	P	90	13	103	0.00004
SRR6051582_kneaddata	Spirochaetota	32587	P	35	0	35	0.00001
SRR6051582_kneaddata	Campylobacterota	8700	P	22	0	22	0.00001
SRR6051582_kneaddata	Firmicutes_C	17613	P	11	0	11	0.00000
SRR6051582_kneaddata	Firmicutes_I	18140	P	7	0	7	0.00000
SRR6051582_kneaddata	Deferribacterota	10822	P	4	0	4	0.00000
SRR6051582_kneaddata	Thermotogota	33086	P	1	0	1	0.00000
SRR6051583_kneaddata	Bacteroidota	4587	P	1359897	14578	1374475	0.44810
SRR6051583_kneaddata	Firmicutes_A	14608	P	1354666	10222	1364888	0.44498
SRR6051583_kneaddata	Firmicutes	12188	P	319204	4529	323733	0.10554
SRR6051583_kneaddata	Actinobacteriota	615	P	3009	1	3010	0.00098
SRR6051583_kneaddata	Cyanobacteria	9876	P	405	11	416	0.00014
SRR6051583_kneaddata	Desulfobacterota_A	11509	P	202	38	240	0.00008
SRR6051583_kneaddata	Proteobacteria	22518	P	164	2	166	0.00005
SRR6051583_kneaddata	Firmicutes_B	17289	P	136	6	142	0.00005
SRR6051583_kneaddata	Campylobacterota	8700	P	64	0	64	0.00002
SRR6051583_kneaddata	Spirochaetota	32587	P	60	0	60	0.00002
SRR6051583_kneaddata	Deferribacterota	10822	P	55	0	55	0.00002
SRR6051583_kneaddata	Verrucomicrobiota	33333	P	32	1	33	0.00001
SRR6051583_kneaddata	Firmicutes_I	18140	P	14	0	14	0.00000
SRR6051583_kneaddata	Firmicutes_C	17613	P	3	0	3	0.00000
SRR6051583_kneaddata	Elusimicrobiota	11888	P	2	0	2	0.00000
SRR6051583_kneaddata	Thermotogota	33086	P	2	0	2	0.00000
SRR6051584_kneaddata	Bacteroidota	4587	P	1512725	12489	1525214	0.56032
SRR6051584_kneaddata	Firmicutes_A	14608	P	865436	3806	869242	0.31934
SRR6051584_kneaddata	Firmicutes	12188	P	209749	2412	212161	0.07794
SRR6051584_kneaddata	Actinobacteriota	615	P	114043	127	114170	0.04194
SRR6051584_kneaddata	Cyanobacteria	9876	P	383	18	401	0.00015
SRR6051584_kneaddata	Firmicutes_B	17289	P	301	12	313	0.00012
SRR6051584_kneaddata	Proteobacteria	22518	P	118	0	118	0.00004
SRR6051584_kneaddata	Desulfobacterota_A	11509	P	113	13	126	0.00005
SRR6051584_kneaddata	Campylobacterota	8700	P	109	0	109	0.00004
SRR6051584_kneaddata	Spirochaetota	32587	P	48	0	48	0.00002
SRR6051584_kneaddata	Firmicutes_I	18140	P	43	0	43	0.00002
SRR6051584_kneaddata	Deferribacterota	10822	P	32	0	32	0.00001
SRR6051584_kneaddata	Verrucomicrobiota	33333	P	32	1	33	0.00001
SRR6051584_kneaddata	Firmicutes_C	17613	P	4	0	4	0.00000
SRR6051584_kneaddata	Elusimicrobiota	11888	P	2	0	2	0.00000
SRR6051584_kneaddata	Thermotogota	33086	P	1	0	1	0.00000
SRR6051702_kneaddata	Bacteroidota	4587	P	7452840	25381	7478221	0.77192
SRR6051702_kneaddata	Firmicutes_A	14608	P	1487708	5949	1493657	0.15418
SRR6051702_kneaddata	Verrucomicrobiota	33333	P	458013	16083	474096	0.04894
SRR6051702_kneaddata	Firmicutes	12188	P	228860	1701	230561	0.02380
SRR6051702_kneaddata	Actinobacteriota	615	P	8395	7	8402	0.00087
SRR6051702_kneaddata	Firmicutes_B	17289	P	1401	31	1432	0.00015
SRR6051702_kneaddata	Cyanobacteria	9876	P	677	9	686	0.00007
SRR6051702_kneaddata	Proteobacteria	22518	P	176	0	176	0.00002
SRR6051702_kneaddata	Deferribacterota	10822	P	172	0	172	0.00002
SRR6051702_kneaddata	Desulfobacterota_A	11509	P	168	14	182	0.00002
SRR6051702_kneaddata	Campylobacterota	8700	P	127	0	127	0.00001
SRR6051702_kneaddata	Firmicutes_I	18140	P	77	0	77	0.00001
SRR6051702_kneaddata	Spirochaetota	32587	P	38	0	38	0.00000
SRR6051702_kneaddata	Firmicutes_C	17613	P	21	0	21	0.00000
SRR6051702_kneaddata	Thermotogota	33086	P	10	0	10	0.00000
SRR6051702_kneaddata	Elusimicrobiota	11888	P	1	0	1	0.00000
SRR6051703_kneaddata	Firmicutes_A	14608	P	8804324	61738	8866062	0.63081
SRR6051703_kneaddata	Bacteroidota	4587	P	4726170	64239	4790409	0.34083
SRR6051703_kneaddata	Firmicutes	12188	P	329096	4893	333989	0.02376
SRR6051703_kneaddata	Actinobacteriota	615	P	59053	63	59116	0.00421
SRR6051703_kneaddata	Firmicutes_B	17289	P	2015	80	2095	0.00015
SRR6051703_kneaddata	Cyanobacteria	9876	P	976	27	1003	0.00007
SRR6051703_kneaddata	Proteobacteria	22518	P	786	16	802	0.00006
SRR6051703_kneaddata	Desulfobacterota_A	11509	P	531	75	606	0.00004
SRR6051703_kneaddata	Verrucomicrobiota	33333	P	434	27	461	0.00003
SRR6051703_kneaddata	Spirochaetota	32587	P	249	0	249	0.00002
SRR6051703_kneaddata	Campylobacterota	8700	P	121	0	121	0.00001
SRR6051703_kneaddata	Firmicutes_I	18140	P	76	0	76	0.00001
SRR6051703_kneaddata	Firmicutes_C	17613	P	71	0	71	0.00001
SRR6051703_kneaddata	Deferribacterota	10822	P	40	0	40	0.00000
SRR6051703_kneaddata	Elusimicrobiota	11888	P	3	0	3	0.00000
SRR6051703_kneaddata	Thermotogota	33086	P	3	0	3	0.00000
SRR6051704_kneaddata	Bacteroidota	4587	P	3707658	39600	3747258	0.45224
SRR6051704_kneaddata	Firmicutes_A	14608	P	3707334	27657	3734991	0.45075
SRR6051704_kneaddata	Firmicutes	12188	P	782635	10776	793411	0.09575
SRR6051704_kneaddata	Actinobacteriota	615	P	7144	4	7148	0.00086
SRR6051704_kneaddata	Cyanobacteria	9876	P	1213	33	1246	0.00015
SRR6051704_kneaddata	Desulfobacterota_A	11509	P	499	88	587	0.00007
SRR6051704_kneaddata	Proteobacteria	22518	P	420	5	425	0.00005
SRR6051704_kneaddata	Firmicutes_B	17289	P	397	17	414	0.00005
SRR6051704_kneaddata	Campylobacterota	8700	P	156	0	156	0.00002
SRR6051704_kneaddata	Spirochaetota	32587	P	142	0	142	0.00002
SRR6051704_kneaddata	Deferribacterota	10822	P	123	0	123	0.00001
SRR6051704_kneaddata	Verrucomicrobiota	33333	P	94	6	100	0.00001
SRR6051704_kneaddata	Firmicutes_I	18140	P	42	0	42	0.00001
SRR6051704_kneaddata	Firmicutes_C	17613	P	17	0	17	0.00000
SRR6051704_kneaddata	Thermotogota	33086	P	16	0	16	0.00000
SRR6051704_kneaddata	Elusimicrobiota	11888	P	2	0	2	0.00000
SRR6051705_kneaddata	Bacteroidota	4587	P	4036307	63636	4099943	0.48202
SRR6051705_kneaddata	Firmicutes_A	14608	P	3807641	16162	3823803	0.44955
SRR6051705_kneaddata	Firmicutes	12188	P	456228	4901	461129	0.05421
SRR6051705_kneaddata	Actinobacteriota	615	P	114324	102	114426	0.01345
SRR6051705_kneaddata	Cyanobacteria	9876	P	3486	162	3648	0.00043
SRR6051705_kneaddata	Campylobacterota	8700	P	553	0	553	0.00007
SRR6051705_kneaddata	Spirochaetota	32587	P	394	0	394	0.00005
SRR6051705_kneaddata	Firmicutes_B	17289	P	392	13	405	0.00005
SRR6051705_kneaddata	Proteobacteria	22518	P	391	2	393	0.00005
SRR6051705_kneaddata	Desulfobacterota_A	11509	P	382	46	428	0.00005
SRR6051705_kneaddata	Deferribacterota	10822	P	246	0	246	0.00003
SRR6051705_kneaddata	Verrucomicrobiota	33333	P	201	7	208	0.00002
SRR6051705_kneaddata	Firmicutes_I	18140	P	157	0	157	0.00002
SRR6051705_kneaddata	Firmicutes_C	17613	P	25	0	25	0.00000
SRR6051705_kneaddata	Thermotogota	33086	P	23	0	23	0.00000
SRR6051705_kneaddata	Elusimicrobiota	11888	P	8	0	8	0.00000
SRR6051706_kneaddata	Bacteroidota	4587	P	5213947	43264	5257211	0.56642
SRR6051706_kneaddata	Firmicutes_A	14608	P	3016827	12830	3029657	0.32642
SRR6051706_kneaddata	Firmicutes	12188	P	676958	7443	684401	0.07374
SRR6051706_kneaddata	Actinobacteriota	615	P	305614	323	305937	0.03296
SRR6051706_kneaddata	Cyanobacteria	9876	P	1151	53	1204	0.00013
SRR6051706_kneaddata	Firmicutes_B	17289	P	1096	43	1139	0.00012
SRR6051706_kneaddata	Proteobacteria	22518	P	450	2	452	0.00005
SRR6051706_kneaddata	Campylobacterota	8700	P	407	0	407	0.00004
SRR6051706_kneaddata	Desulfobacterota_A	11509	P	372	50	422	0.00005
SRR6051706_kneaddata	Spirochaetota	32587	P	205	0	205	0.00002
SRR6051706_kneaddata	Firmicutes_I	18140	P	167	0	167	0.00002
SRR6051706_kneaddata	Deferribacterota	10822	P	106	0	106	0.00001
SRR6051706_kneaddata	Verrucomicrobiota	33333	P	64	3	67	0.00001
SRR6051706_kneaddata	Firmicutes_C	17613	P	26	0	26	0.00000
SRR6051706_kneaddata	Thermotogota	33086	P	9	0	9	0.00000
SRR6051706_kneaddata	Elusimicrobiota	11888	P	8	0	8	0.00000
SRR6051707_kneaddata	Bacteroidota	4587	P	46806361	282329	47088690	0.64769
SRR6051707_kneaddata	Firmicutes_A	14608	P	15861326	71801	15933127	0.21915
SRR6051707_kneaddata	Firmicutes	12188	P	4823457	48286	4871743	0.06701
SRR6051707_kneaddata	Verrucomicrobiota	33333	P	2559936	138677	2698613	0.03712
SRR6051707_kneaddata	Actinobacteriota	615	P	2035955	1948	2037903	0.02803
SRR6051707_kneaddata	Cyanobacteria	9876	P	47167	2615	49782	0.00068
SRR6051707_kneaddata	Campylobacterota	8700	P	4965	3	4968	0.00007
SRR6051707_kneaddata	Proteobacteria	22518	P	4410	13	4423	0.00006
SRR6051707_kneaddata	Spirochaetota	32587	P	3104	8	3112	0.00004
SRR6051707_kneaddata	Desulfobacterota_A	11509	P	2755	251	3006	0.00004
SRR6051707_kneaddata	Firmicutes_B	17289	P	2629	92	2721	0.00004
SRR6051707_kneaddata	Deferribacterota	10822	P	2300	3	2303	0.00003
SRR6051707_kneaddata	Firmicutes_I	18140	P	1866	0	1866	0.00003
SRR6051707_kneaddata	Thermotogota	33086	P	157	0	157	0.00000
SRR6051707_kneaddata	Firmicutes_C	17613	P	96	0	96	0.00000
SRR6051707_kneaddata	Elusimicrobiota	11888	P	87	0	87	0.00000
SRR6051708_kneaddata	Bacteroidota	4587	P	8475968	129664	8605632	0.63809
SRR6051708_kneaddata	Firmicutes_A	14608	P	3472557	21648	3494205	0.25909
SRR6051708_kneaddata	Firmicutes	12188	P	865187	7697	872884	0.06472
SRR6051708_kneaddata	Verrucomicrobiota	33333	P	353127	21361	374488	0.02777
SRR6051708_kneaddata	Actinobacteriota	615	P	131317	134	131451	0.00975
SRR6051708_kneaddata	Cyanobacteria	9876	P	3642	179	3821	0.00028
SRR6051708_kneaddata	Campylobacterota	8700	P	856	0	856	0.00006
SRR6051708_kneaddata	Spirochaetota	32587	P	820	2	822	0.00006
SRR6051708_kneaddata	Proteobacteria	22518	P	746	8	754	0.00006
SRR6051708_kneaddata	Firmicutes_B	17289	P	612	24	636	0.00005
SRR6051708_kneaddata	Firmicutes_I	18140	P	375	0	375	0.00003
SRR6051708_kneaddata	Desulfobacterota_A	11509	P	339	36	375	0.00003
SRR6051708_kneaddata	Deferribacterota	10822	P	258	0	258	0.00002
SRR6051708_kneaddata	Firmicutes_C	17613	P	22	0	22	0.00000
SRR6051708_kneaddata	Thermotogota	33086	P	17	0	17	0.00000
SRR6051708_kneaddata	Elusimicrobiota	11888	P	10	0	10	0.00000
SRR6051709_kneaddata	Firmicutes_A	14608	P	4062878	25841	4088719	0.56774
SRR6051709_kneaddata	Bacteroidota	4587	P	2762189	30056	2792245	0.38772
SRR6051709_kneaddata	Firmicutes	12188	P	308327	4597	312924	0.04345
SRR6051709_kneaddata	Actinobacteriota	615	P	4661	3	4664	0.00065
SRR6051709_kneaddata	Cyanobacteria	9876	P	1474	40	1514	0.00021
SRR6051709_kneaddata	Firmicutes_B	17289	P	452	19	471	0.00007
SRR6051709_kneaddata	Desulfobacterota_A	11509	P	372	61	433	0.00006
SRR6051709_kneaddata	Proteobacteria	22518	P	210	1	211	0.00003
SRR6051709_kneaddata	Campylobacterota	8700	P	147	0	147	0.00002
SRR6051709_kneaddata	Spirochaetota	32587	P	142	0	142	0.00002
SRR6051709_kneaddata	Deferribacterota	10822	P	103	0	103	0.00001
SRR6051709_kneaddata	Verrucomicrobiota	33333	P	51	3	54	0.00001
SRR6051709_kneaddata	Firmicutes_I	18140	P	32	0	32	0.00000
SRR6051709_kneaddata	Firmicutes_C	17613	P	13	0	13	0.00000
SRR6051709_kneaddata	Thermotogota	33086	P	8	0	8	0.00000
SRR6051709_kneaddata	Elusimicrobiota	11888	P	5	0	5	0.00000
SRR6051710_kneaddata	Bacteroidota	4587	P	4392272	30245	4422517	0.54785
SRR6051710_kneaddata	Firmicutes_A	14608	P	3346612	14786	3361398	0.41640
SRR6051710_kneaddata	Firmicutes	12188	P	272662	3731	276393	0.03424
SRR6051710_kneaddata	Actinobacteriota	615	P	9130	6	9136	0.00113
SRR6051710_kneaddata	Firmicutes_B	17289	P	1118	43	1161	0.00014
SRR6051710_kneaddata	Cyanobacteria	9876	P	1052	31	1083	0.00013
SRR6051710_kneaddata	Proteobacteria	22518	P	230	2	232	0.00003
SRR6051710_kneaddata	Desulfobacterota_A	11509	P	163	22	185	0.00002
SRR6051710_kneaddata	Campylobacterota	8700	P	104	0	104	0.00001
SRR6051710_kneaddata	Spirochaetota	32587	P	92	0	92	0.00001
SRR6051710_kneaddata	Firmicutes_I	18140	P	55	0	55	0.00001
SRR6051710_kneaddata	Verrucomicrobiota	33333	P	49	2	51	0.00001
SRR6051710_kneaddata	Deferribacterota	10822	P	37	0	37	0.00000
SRR6051710_kneaddata	Firmicutes_C	17613	P	34	0	34	0.00000
SRR6051710_kneaddata	Thermotogota	33086	P	7	0	7	0.00000
SRR6051710_kneaddata	Elusimicrobiota	11888	P	1	0	1	0.00000
SRR6051711_kneaddata	Bacteroidota	4587	P	8460063	62157	8522220	0.50458
SRR6051711_kneaddata	Firmicutes_A	14608	P	7816804	42160	7858964	0.46531
SRR6051711_kneaddata	Firmicutes	12188	P	477310	7944	485254	0.02873
SRR6051711_kneaddata	Actinobacteriota	615	P	16780	10	16790	0.00099
SRR6051711_kneaddata	Cyanobacteria	9876	P	2947	61	3008	0.00018
SRR6051711_kneaddata	Firmicutes_B	17289	P	886	37	923	0.00005
SRR6051711_kneaddata	Proteobacteria	22518	P	604	4	608	0.00004
SRR6051711_kneaddata	Desulfobacterota_A	11509	P	454	66	520	0.00003
SRR6051711_kneaddata	Campylobacterota	8700	P	416	0	416	0.00002
SRR6051711_kneaddata	Spirochaetota	32587	P	329	0	329	0.00002
SRR6051711_kneaddata	Deferribacterota	10822	P	290	0	290	0.00002
SRR6051711_kneaddata	Verrucomicrobiota	33333	P	130	4	134	0.00001
SRR6051711_kneaddata	Firmicutes_I	18140	P	98	0	98	0.00001
SRR6051711_kneaddata	Firmicutes_C	17613	P	53	0	53	0.00000
SRR6051711_kneaddata	Thermotogota	33086	P	41	0	41	0.00000
SRR6051711_kneaddata	Elusimicrobiota	11888	P	3	0	3	0.00000
SRR6051712_kneaddata	Firmicutes_A	14608	P	2778902	15326	2794228	0.49094
SRR6051712_kneaddata	Bacteroidota	4587	P	2565858	30062	2595920	0.45609
SRR6051712_kneaddata	Firmicutes	12188	P	289127	4192	293319	0.05154
SRR6051712_kneaddata	Actinobacteriota	615	P	6072	3	6075	0.00107
SRR6051712_kneaddata	Cyanobacteria	9876	P	859	28	887	0.00016
SRR6051712_kneaddata	Firmicutes_B	17289	P	688	28	716	0.00013
SRR6051712_kneaddata	Desulfobacterota_A	11509	P	139	23	162	0.00003
SRR6051712_kneaddata	Proteobacteria	22518	P	126	1	127	0.00002
SRR6051712_kneaddata	Spirochaetota	32587	P	76	0	76	0.00001
SRR6051712_kneaddata	Campylobacterota	8700	P	32	0	32	0.00001
SRR6051712_kneaddata	Firmicutes_C	17613	P	23	0	23	0.00000
SRR6051712_kneaddata	Deferribacterota	10822	P	19	0	19	0.00000
SRR6051712_kneaddata	Verrucomicrobiota	33333	P	19	1	20	0.00000
SRR6051712_kneaddata	Firmicutes_I	18140	P	14	0	14	0.00000
SRR6051712_kneaddata	Thermotogota	33086	P	2	0	2	0.00000
SRR6051713_kneaddata	Bacteroidota	4587	P	7248282	29647	7277929	0.83802
SRR6051713_kneaddata	Firmicutes_A	14608	P	1156846	5505	1162351	0.13384
SRR6051713_kneaddata	Firmicutes	12188	P	153667	1728	155395	0.01789
SRR6051713_kneaddata	Actinobacteriota	615	P	86476	106	86582	0.00997
SRR6051713_kneaddata	Proteobacteria	22518	P	710	1	711	0.00008
SRR6051713_kneaddata	Cyanobacteria	9876	P	495	10	505	0.00006
SRR6051713_kneaddata	Campylobacterota	8700	P	371	0	371	0.00004
SRR6051713_kneaddata	Firmicutes_B	17289	P	331	14	345	0.00004
SRR6051713_kneaddata	Spirochaetota	32587	P	152	0	152	0.00002
SRR6051713_kneaddata	Desulfobacterota_A	11509	P	103	9	112	0.00001
SRR6051713_kneaddata	Firmicutes_I	18140	P	90	0	90	0.00001
SRR6051713_kneaddata	Verrucomicrobiota	33333	P	36	1	37	0.00000
SRR6051713_kneaddata	Deferribacterota	10822	P	26	0	26	0.00000
SRR6051713_kneaddata	Firmicutes_C	17613	P	6	0	6	0.00000
SRR6051713_kneaddata	Elusimicrobiota	11888	P	4	0	4	0.00000
SRR6051713_kneaddata	Thermotogota	33086	P	2	0	2	0.00000
SRR6051714_kneaddata	Firmicutes_A	14608	P	69	0	69	0.72632
SRR6051714_kneaddata	Bacteroidota	4587	P	20	0	20	0.21053
SRR6051714_kneaddata	Firmicutes	12188	P	4	0	4	0.04211
SRR6051714_kneaddata	Proteobacteria	22518	P	1	0	1	0.01053
SRR6051714_kneaddata	Verrucomicrobiota	33333	P	1	0	1	0.01053
SRR6051715_kneaddata	Firmicutes_A	14608	P	6113378	39077	6152455	0.43214
SRR6051715_kneaddata	Bacteroidota	4587	P	5707158	204611	5911769	0.41523
SRR6051715_kneaddata	Firmicutes	12188	P	1640399	23998	1664397	0.11690
SRR6051715_kneaddata	Actinobacteriota	615	P	495631	681	496312	0.03486
SRR6051715_kneaddata	Cyanobacteria	9876	P	4185	159	4344	0.00031
SRR6051715_kneaddata	Campylobacterota	8700	P	1868	1	1869	0.00013
SRR6051715_kneaddata	Firmicutes_B	17289	P	1618	86	1704	0.00012
SRR6051715_kneaddata	Spirochaetota	32587	P	973	5	978	0.00007
SRR6051715_kneaddata	Proteobacteria	22518	P	909	6	915	0.00006
SRR6051715_kneaddata	Firmicutes_I	18140	P	732	0	732	0.00005
SRR6051715_kneaddata	Deferribacterota	10822	P	626	1	627	0.00004
SRR6051715_kneaddata	Desulfobacterota_A	11509	P	523	81	604	0.00004
SRR6051715_kneaddata	Verrucomicrobiota	33333	P	363	26	389	0.00003
SRR6051715_kneaddata	Thermotogota	33086	P	41	0	41	0.00000
SRR6051715_kneaddata	Firmicutes_C	17613	P	36	0	36	0.00000
SRR6051715_kneaddata	Elusimicrobiota	11888	P	18	0	18	0.00000
SRR6051716_kneaddata	Bacteroidota	4587	P	3461147	23893	3485040	0.54759
SRR6051716_kneaddata	Firmicutes_A	14608	P	2455937	11793	2467730	0.38774
SRR6051716_kneaddata	Firmicutes	12188	P	379318	4413	383731	0.06029
SRR6051716_kneaddata	Actinobacteriota	615	P	21186	22	21208	0.00333
SRR6051716_kneaddata	Cyanobacteria	9876	P	4483	321	4804	0.00075
SRR6051716_kneaddata	Firmicutes_B	17289	P	427	17	444	0.00007
SRR6051716_kneaddata	Campylobacterota	8700	P	396	0	396	0.00006
SRR6051716_kneaddata	Proteobacteria	22518	P	228	1	229	0.00004
SRR6051716_kneaddata	Spirochaetota	32587	P	225	0	225	0.00004
SRR6051716_kneaddata	Desulfobacterota_A	11509	P	197	27	224	0.00004
SRR6051716_kneaddata	Firmicutes_I	18140	P	144	0	144	0.00002
SRR6051716_kneaddata	Deferribacterota	10822	P	111	0	111	0.00002
SRR6051716_kneaddata	Verrucomicrobiota	33333	P	56	3	59	0.00001
SRR6051716_kneaddata	Firmicutes_C	17613	P	11	0	11	0.00000
SRR6051716_kneaddata	Thermotogota	33086	P	5	0	5	0.00000
SRR6440127_1_kneaddata_paired	Bacteroidota	4587	P	20963063	142626	21105689	0.86761
SRR6440127_1_kneaddata_paired	Firmicutes_A	14608	P	2351019	47228	2398247	0.09859
SRR6440127_1_kneaddata_paired	Proteobacteria	22518	P	306633	610	307243	0.01263
SRR6440127_1_kneaddata_paired	Verrucomicrobiota	33333	P	169988	15867	185855	0.00764
SRR6440127_1_kneaddata_paired	Firmicutes	12188	P	166775	2482	169257	0.00696
SRR6440127_1_kneaddata_paired	Cyanobacteria	9876	P	93250	4608	97858	0.00402
SRR6440127_1_kneaddata_paired	Actinobacteriota	615	P	35589	189	35778	0.00147
SRR6440127_1_kneaddata_paired	Desulfobacterota_A	11509	P	24300	494	24794	0.00102
SRR6440127_1_kneaddata_paired	Firmicutes_B	17289	P	598	35	633	0.00003
SRR6440127_1_kneaddata_paired	Campylobacterota	8700	P	312	0	312	0.00001
SRR6440127_1_kneaddata_paired	Spirochaetota	32587	P	280	0	280	0.00001
SRR6440127_1_kneaddata_paired	Deferribacterota	10822	P	193	0	193	0.00001
SRR6440127_1_kneaddata_paired	Firmicutes_I	18140	P	111	0	111	0.00000
SRR6440127_1_kneaddata_paired	Firmicutes_C	17613	P	43	0	43	0.00000
SRR6440127_1_kneaddata_paired	Thermotogota	33086	P	14	0	14	0.00000
SRR6440127_1_kneaddata_paired	Elusimicrobiota	11888	P	2	0	2	0.00000
SRR6440128_1_kneaddata_paired	Firmicutes_A	14608	P	11251322	277310	11528632	0.60421
SRR6440128_1_kneaddata_paired	Bacteroidota	4587	P	5140981	79939	5220920	0.27363
SRR6440128_1_kneaddata_paired	Desulfobacterota_A	11509	P	2028523	50078	2078601	0.10894
SRR6440128_1_kneaddata_paired	Cyanobacteria	9876	P	137466	1552	139018	0.00729
SRR6440128_1_kneaddata_paired	Proteobacteria	22518	P	50383	45	50428	0.00264
SRR6440128_1_kneaddata_paired	Firmicutes	12188	P	33624	1129	34753	0.00182
SRR6440128_1_kneaddata_paired	Actinobacteriota	615	P	17799	49	17848	0.00094
SRR6440128_1_kneaddata_paired	Campylobacterota	8700	P	5029	0	5029	0.00026
SRR6440128_1_kneaddata_paired	Spirochaetota	32587	P	4461	9	4470	0.00023
SRR6440128_1_kneaddata_paired	Verrucomicrobiota	33333	P	375	49	424	0.00002
SRR6440128_1_kneaddata_paired	Firmicutes_B	17289	P	341	34	375	0.00002
SRR6440128_1_kneaddata_paired	Firmicutes_I	18140	P	28	0	28	0.00000
SRR6440129_1_kneaddata_paired	Bacteroidota	4587	P	18656240	138710	18794950	0.79480
SRR6440129_1_kneaddata_paired	Firmicutes_A	14608	P	3325205	40062	3365267	0.14231
SRR6440129_1_kneaddata_paired	Verrucomicrobiota	33333	P	781168	62266	843434	0.03567
SRR6440129_1_kneaddata_paired	Proteobacteria	22518	P	297392	1008	298400	0.01262
SRR6440129_1_kneaddata_paired	Firmicutes	12188	P	228508	1543	230051	0.00973
SRR6440129_1_kneaddata_paired	Actinobacteriota	615	P	52501	404	52905	0.00224
SRR6440129_1_kneaddata_paired	Desulfobacterota_A	11509	P	43678	666	44344	0.00188
SRR6440129_1_kneaddata_paired	Cyanobacteria	9876	P	16553	167	16720	0.00071
SRR6440129_1_kneaddata_paired	Firmicutes_B	17289	P	414	20	434	0.00002
SRR6440129_1_kneaddata_paired	Campylobacterota	8700	P	396	0	396	0.00002
SRR6440129_1_kneaddata_paired	Spirochaetota	32587	P	248	0	248	0.00001
SRR6440129_1_kneaddata_paired	Firmicutes_I	18140	P	140	0	140	0.00001
SRR6440129_1_kneaddata_paired	Deferribacterota	10822	P	100	0	100	0.00000
SRR6440129_1_kneaddata_paired	Firmicutes_C	17613	P	52	0	52	0.00000
SRR6440129_1_kneaddata_paired	Thermotogota	33086	P	17	0	17	0.00000
SRR6440129_1_kneaddata_paired	Elusimicrobiota	11888	P	6	0	6	0.00000
SRR6440130_1_kneaddata_paired	Firmicutes_A	14608	P	20587668	74096	20661764	0.83263
SRR6440130_1_kneaddata_paired	Bacteroidota	4587	P	3892646	12520	3905166	0.15737
SRR6440130_1_kneaddata_paired	Verrucomicrobiota	33333	P	62100	2241	64341	0.00259
SRR6440130_1_kneaddata_paired	Firmicutes	12188	P	55160	542	55702	0.00224
SRR6440130_1_kneaddata_paired	Proteobacteria	22518	P	48335	229	48564	0.00196
SRR6440130_1_kneaddata_paired	Desulfobacterota_A	11509	P	43903	1262	45165	0.00182
SRR6440130_1_kneaddata_paired	Cyanobacteria	9876	P	24914	59	24973	0.00101
SRR6440130_1_kneaddata_paired	Actinobacteriota	615	P	7284	5	7289	0.00029
SRR6440130_1_kneaddata_paired	Firmicutes_B	17289	P	1331	29	1360	0.00005
SRR6440130_1_kneaddata_paired	Spirochaetota	32587	P	461	0	461	0.00002
SRR6440130_1_kneaddata_paired	Deferribacterota	10822	P	124	0	124	0.00000
SRR6440130_1_kneaddata_paired	Firmicutes_I	18140	P	16	0	16	0.00000
SRR6440130_1_kneaddata_paired	Campylobacterota	8700	P	9	0	9	0.00000
SRR6440130_1_kneaddata_paired	Elusimicrobiota	11888	P	7	0	7	0.00000
SRR6440130_1_kneaddata_paired	Thermotogota	33086	P	1	0	1	0.00000
SRR6440131_1_kneaddata_paired	Firmicutes_A	14608	P	13967277	87343	14054620	0.68452
SRR6440131_1_kneaddata_paired	Bacteroidota	4587	P	5928355	47665	5976020	0.29106
SRR6440131_1_kneaddata_paired	Firmicutes	12188	P	194652	1498	196150	0.00955
SRR6440131_1_kneaddata_paired	Desulfobacterota_A	11509	P	142983	1658	144641	0.00704
SRR6440131_1_kneaddata_paired	Proteobacteria	22518	P	94506	223	94729	0.00461
SRR6440131_1_kneaddata_paired	Verrucomicrobiota	33333	P	34747	2382	37129	0.00181
SRR6440131_1_kneaddata_paired	Cyanobacteria	9876	P	22921	111	23032	0.00112
SRR6440131_1_kneaddata_paired	Actinobacteriota	615	P	3698	3	3701	0.00018
SRR6440131_1_kneaddata_paired	Spirochaetota	32587	P	844	3	847	0.00004
SRR6440131_1_kneaddata_paired	Campylobacterota	8700	P	264	0	264	0.00001
SRR6440131_1_kneaddata_paired	Firmicutes_B	17289	P	254	11	265	0.00001
SRR6440131_1_kneaddata_paired	Firmicutes_I	18140	P	227	0	227	0.00001
SRR6440131_1_kneaddata_paired	Firmicutes_C	17613	P	226	0	226	0.00001
SRR6440131_1_kneaddata_paired	Thermotogota	33086	P	119	0	119	0.00001
SRR6440131_1_kneaddata_paired	Deferribacterota	10822	P	36	0	36	0.00000
SRR6440132_1_kneaddata_paired	Firmicutes_A	14608	P	931116	116898	1048014	0.73737
SRR6440132_1_kneaddata_paired	Firmicutes_I	18140	P	125375	722	126097	0.08872
SRR6440132_1_kneaddata_paired	Firmicutes	12188	P	111151	3056	114207	0.08035
SRR6440132_1_kneaddata_paired	Bacteroidota	4587	P	75386	14527	89913	0.06326
SRR6440132_1_kneaddata_paired	Proteobacteria	22518	P	13747	327	14074	0.00990
SRR6440132_1_kneaddata_paired	Actinobacteriota	615	P	13593	96	13689	0.00963
SRR6440132_1_kneaddata_paired	Cyanobacteria	9876	P	7394	234	7628	0.00537
SRR6440132_1_kneaddata_paired	Desulfobacterota_A	11509	P	3330	357	3687	0.00259
SRR6440132_1_kneaddata_paired	Spirochaetota	32587	P	1802	15	1817	0.00128
SRR6440132_1_kneaddata_paired	Deferribacterota	10822	P	722	0	722	0.00051
SRR6440132_1_kneaddata_paired	Verrucomicrobiota	33333	P	497	228	725	0.00051
SRR6440132_1_kneaddata_paired	Firmicutes_B	17289	P	474	194	668	0.00047
SRR6440132_1_kneaddata_paired	Campylobacterota	8700	P	23	0	23	0.00002
SRR6440132_1_kneaddata_paired	Firmicutes_C	17613	P	15	0	15	0.00001
SRR6440132_1_kneaddata_paired	Thermotogota	33086	P	1	0	1	0.00000
SRR6440133_1_kneaddata_paired	Firmicutes_A	14608	P	20937972	153953	21091925	0.79957
SRR6440133_1_kneaddata_paired	Bacteroidota	4587	P	4505885	31751	4537636	0.17202
SRR6440133_1_kneaddata_paired	Firmicutes	12188	P	199360	2228	201588	0.00764
SRR6440133_1_kneaddata_paired	Proteobacteria	22518	P	193803	1118	194921	0.00739
SRR6440133_1_kneaddata_paired	Verrucomicrobiota	33333	P	168695	13336	182031	0.00690
SRR6440133_1_kneaddata_paired	Desulfobacterota_A	11509	P	99081	1743	100824	0.00382
SRR6440133_1_kneaddata_paired	Cyanobacteria	9876	P	64108	365	64473	0.00244
SRR6440133_1_kneaddata_paired	Actinobacteriota	615	P	2294	10	2304	0.00009
SRR6440133_1_kneaddata_paired	Firmicutes_B	17289	P	1948	95	2043	0.00008
SRR6440133_1_kneaddata_paired	Deferribacterota	10822	P	515	0	515	0.00002
SRR6440133_1_kneaddata_paired	Spirochaetota	32587	P	387	1	388	0.00001
SRR6440133_1_kneaddata_paired	Firmicutes_C	17613	P	156	0	156	0.00001
SRR6440133_1_kneaddata_paired	Campylobacterota	8700	P	112	0	112	0.00000
SRR6440133_1_kneaddata_paired	Firmicutes_I	18140	P	96	0	96	0.00000
SRR6440133_1_kneaddata_paired	Thermotogota	33086	P	13	0	13	0.00000
SRR6440133_1_kneaddata_paired	Elusimicrobiota	11888	P	1	0	1	0.00000
SRR6440134_1_kneaddata_paired	Bacteroidota	4587	P	10221579	59928	10281507	0.42687
SRR6440134_1_kneaddata_paired	Firmicutes_A	14608	P	9512348	95719	9608067	0.39891
SRR6440134_1_kneaddata_paired	Proteobacteria	22518	P	2204532	3873	2208405	0.09169
SRR6440134_1_kneaddata_paired	Desulfobacterota_A	11509	P	1769982	16364	1786346	0.07417
SRR6440134_1_kneaddata_paired	Firmicutes	12188	P	151587	1245	152832	0.00635
SRR6440134_1_kneaddata_paired	Cyanobacteria	9876	P	22460	95	22555	0.00094
SRR6440134_1_kneaddata_paired	Actinobacteriota	615	P	21536	60	21596	0.00090
SRR6440134_1_kneaddata_paired	Firmicutes_B	17289	P	1804	59	1863	0.00008
SRR6440134_1_kneaddata_paired	Verrucomicrobiota	33333	P	933	38	971	0.00004
SRR6440134_1_kneaddata_paired	Spirochaetota	32587	P	530	1	531	0.00002
SRR6440134_1_kneaddata_paired	Campylobacterota	8700	P	331	0	331	0.00001
SRR6440134_1_kneaddata_paired	Firmicutes_C	17613	P	226	0	226	0.00001
SRR6440134_1_kneaddata_paired	Firmicutes_I	18140	P	213	0	213	0.00001
SRR6440134_1_kneaddata_paired	Deferribacterota	10822	P	142	0	142	0.00001
SRR6440134_1_kneaddata_paired	Elusimicrobiota	11888	P	8	0	8	0.00000
SRR6440134_1_kneaddata_paired	Thermotogota	33086	P	8	0	8	0.00000
SRR6440135_1_kneaddata_paired	Bacteroidota	4587	P	9883097	15554	9898651	0.41695
SRR6440135_1_kneaddata_paired	Firmicutes_A	14608	P	9113385	61481	9174866	0.38646
SRR6440135_1_kneaddata_paired	Desulfobacterota_A	11509	P	3942082	10371	3952453	0.16649
SRR6440135_1_kneaddata_paired	Firmicutes	12188	P	557758	288	558046	0.02351
SRR6440135_1_kneaddata_paired	Proteobacteria	22518	P	68438	113	68551	0.00289
SRR6440135_1_kneaddata_paired	Cyanobacteria	9876	P	52048	65	52113	0.00220
SRR6440135_1_kneaddata_paired	Actinobacteriota	615	P	33489	9	33498	0.00141
SRR6440135_1_kneaddata_paired	Spirochaetota	32587	P	1402	0	1402	0.00006
SRR6440135_1_kneaddata_paired	Verrucomicrobiota	33333	P	469	6	475	0.00002
SRR6440135_1_kneaddata_paired	Campylobacterota	8700	P	350	0	350	0.00001
SRR6440135_1_kneaddata_paired	Firmicutes_B	17289	P	148	1	149	0.00001
SRR6440135_1_kneaddata_paired	Firmicutes_C	17613	P	5	0	5	0.00000
SRR6440135_1_kneaddata_paired	Deferribacterota	10822	P	2	0	2	0.00000
SRR6440135_1_kneaddata_paired	Firmicutes_I	18140	P	2	0	2	0.00000
SRR6440136_1_kneaddata_paired	Firmicutes_A	14608	P	13988798	106195	14094993	0.54908
SRR6440136_1_kneaddata_paired	Bacteroidota	4587	P	8011016	52199	8063215	0.31411
SRR6440136_1_kneaddata_paired	Desulfobacterota_A	11509	P	2997401	15304	3012705	0.11736
SRR6440136_1_kneaddata_paired	Proteobacteria	22518	P	295759	7	295766	0.01152
SRR6440136_1_kneaddata_paired	Firmicutes	12188	P	172481	776	173257	0.00675
SRR6440136_1_kneaddata_paired	Cyanobacteria	9876	P	15794	63	15857	0.00062
SRR6440136_1_kneaddata_paired	Actinobacteriota	615	P	13004	111	13115	0.00051
SRR6440136_1_kneaddata_paired	Spirochaetota	32587	P	666	0	666	0.00003
SRR6440136_1_kneaddata_paired	Verrucomicrobiota	33333	P	467	13	480	0.00002
SRR6440136_1_kneaddata_paired	Campylobacterota	8700	P	169	0	169	0.00001
SRR6440136_1_kneaddata_paired	Firmicutes_B	17289	P	94	1	95	0.00000
SRR6440136_1_kneaddata_paired	Deferribacterota	10822	P	83	0	83	0.00000
SRR6440136_1_kneaddata_paired	Firmicutes_I	18140	P	2	0	2	0.00000
SRR6440136_1_kneaddata_paired	Firmicutes_C	17613	P	1	0	1	0.00000
SRR6440137_1_kneaddata_paired	Firmicutes_A	14608	P	14886696	60304	14947000	0.75086
SRR6440137_1_kneaddata_paired	Bacteroidota	4587	P	4224542	19562	4244104	0.21320
SRR6440137_1_kneaddata_paired	Desulfobacterota_A	11509	P	207423	1468	208891	0.01049
SRR6440137_1_kneaddata_paired	Proteobacteria	22518	P	194836	697	195533	0.00982
SRR6440137_1_kneaddata_paired	Firmicutes	12188	P	165771	4850	170621	0.00857
SRR6440137_1_kneaddata_paired	Actinobacteriota	615	P	113014	152	113166	0.00568
SRR6440137_1_kneaddata_paired	Cyanobacteria	9876	P	13458	43	13501	0.00068
SRR6440137_1_kneaddata_paired	Verrucomicrobiota	33333	P	11878	542	12420	0.00062
SRR6440137_1_kneaddata_paired	Spirochaetota	32587	P	820	0	820	0.00004
SRR6440137_1_kneaddata_paired	Firmicutes_B	17289	P	292	8	300	0.00002
SRR6440137_1_kneaddata_paired	Thermotogota	33086	P	156	0	156	0.00001
SRR6440137_1_kneaddata_paired	Firmicutes_I	18140	P	51	0	51	0.00000
SRR6440137_1_kneaddata_paired	Deferribacterota	10822	P	25	0	25	0.00000
SRR6440137_1_kneaddata_paired	Campylobacterota	8700	P	21	0	21	0.00000
SRR6440138_1_kneaddata_paired	Firmicutes_A	14608	P	9348133	69421	9417554	0.55687
SRR6440138_1_kneaddata_paired	Bacteroidota	4587	P	6674565	47730	6722295	0.39750
SRR6440138_1_kneaddata_paired	Proteobacteria	22518	P	347382	1795	349177	0.02065
SRR6440138_1_kneaddata_paired	Cyanobacteria	9876	P	219808	1146	220954	0.01307
SRR6440138_1_kneaddata_paired	Firmicutes	12188	P	103164	1156	104320	0.00617
SRR6440138_1_kneaddata_paired	Desulfobacterota_A	11509	P	62743	749	63492	0.00375
SRR6440138_1_kneaddata_paired	Verrucomicrobiota	33333	P	22032	1434	23466	0.00139
SRR6440138_1_kneaddata_paired	Actinobacteriota	615	P	7932	24	7956	0.00047
SRR6440138_1_kneaddata_paired	Spirochaetota	32587	P	1039	1	1040	0.00006
SRR6440138_1_kneaddata_paired	Firmicutes_B	17289	P	511	24	535	0.00003
SRR6440138_1_kneaddata_paired	Deferribacterota	10822	P	344	1	345	0.00002
SRR6440138_1_kneaddata_paired	Firmicutes_I	18140	P	322	0	322	0.00002
SRR6440138_1_kneaddata_paired	Campylobacterota	8700	P	112	0	112	0.00001
SRR6440138_1_kneaddata_paired	Firmicutes_C	17613	P	35	0	35	0.00000
SRR6945375_1_kneaddata_paired	Firmicutes_A	14608	P	4742110	37486	4779596	0.55541
SRR6945375_1_kneaddata_paired	Bacteroidota	4587	P	3092805	24172	3116977	0.36221
SRR6945375_1_kneaddata_paired	Firmicutes	12188	P	396558	4873	401431	0.04665
SRR6945375_1_kneaddata_paired	Campylobacterota	8700	P	116216	10	116226	0.01351
SRR6945375_1_kneaddata_paired	Deferribacterota	10822	P	64249	394	64643	0.00751
SRR6945375_1_kneaddata_paired	Desulfobacterota_A	11509	P	63793	275	64068	0.00745
SRR6945375_1_kneaddata_paired	Actinobacteriota	615	P	41280	587	41867	0.00487
SRR6945375_1_kneaddata_paired	Proteobacteria	22518	P	17689	64	17753	0.00206
SRR6945375_1_kneaddata_paired	Cyanobacteria	9876	P	1543	51	1594	0.00019
SRR6945375_1_kneaddata_paired	Firmicutes_B	17289	P	349	21	370	0.00004
SRR6945375_1_kneaddata_paired	Spirochaetota	32587	P	332	0	332	0.00004
SRR6945375_1_kneaddata_paired	Firmicutes_I	18140	P	310	0	310	0.00004
SRR6945375_1_kneaddata_paired	Verrucomicrobiota	33333	P	222	18	240	0.00003
SRR6945375_1_kneaddata_paired	Firmicutes_C	17613	P	74	0	74	0.00001
SRR6945375_1_kneaddata_paired	Thermotogota	33086	P	11	0	11	0.00000
SRR6945375_1_kneaddata_paired	Elusimicrobiota	11888	P	5	0	5	0.00000
SRR6945376_1_kneaddata_paired	Firmicutes_A	14608	P	3325123	25077	3350200	0.52405
SRR6945376_1_kneaddata_paired	Bacteroidota	4587	P	2261094	14600	2275694	0.35597
SRR6945376_1_kneaddata_paired	Campylobacterota	8700	P	317217	7	317224	0.04962
SRR6945376_1_kneaddata_paired	Firmicutes	12188	P	220053	1880	221933	0.03472
SRR6945376_1_kneaddata_paired	Actinobacteriota	615	P	78166	528	78694	0.01231
SRR6945376_1_kneaddata_paired	Desulfobacterota_A	11509	P	67358	212	67570	0.01057
SRR6945376_1_kneaddata_paired	Deferribacterota	10822	P	65975	338	66313	0.01037
SRR6945376_1_kneaddata_paired	Proteobacteria	22518	P	11738	33	11771	0.00184
SRR6945376_1_kneaddata_paired	Cyanobacteria	9876	P	2462	63	2525	0.00040
SRR6945376_1_kneaddata_paired	Spirochaetota	32587	P	300	0	300	0.00005
SRR6945376_1_kneaddata_paired	Verrucomicrobiota	33333	P	258	17	275	0.00004
SRR6945376_1_kneaddata_paired	Firmicutes_B	17289	P	206	10	216	0.00003
SRR6945376_1_kneaddata_paired	Firmicutes_I	18140	P	149	0	149	0.00002
SRR6945376_1_kneaddata_paired	Firmicutes_C	17613	P	52	0	52	0.00001
SRR6945376_1_kneaddata_paired	Elusimicrobiota	11888	P	16	0	16	0.00000
SRR6945376_1_kneaddata_paired	Thermotogota	33086	P	3	0	3	0.00000
SRR6945377_1_kneaddata_paired	Firmicutes_A	14608	P	5001251	25807	5027058	0.56405
SRR6945377_1_kneaddata_paired	Bacteroidota	4587	P	3438924	18135	3457059	0.38789
SRR6945377_1_kneaddata_paired	Firmicutes	12188	P	229052	5289	234341	0.02629
SRR6945377_1_kneaddata_paired	Desulfobacterota_A	11509	P	73737	551	74288	0.00834
SRR6945377_1_kneaddata_paired	Actinobacteriota	615	P	69502	379	69881	0.00784
SRR6945377_1_kneaddata_paired	Campylobacterota	8700	P	28324	1	28325	0.00318
SRR6945377_1_kneaddata_paired	Proteobacteria	22518	P	11214	41	11255	0.00126
SRR6945377_1_kneaddata_paired	Deferribacterota	10822	P	5708	23	5731	0.00064
SRR6945377_1_kneaddata_paired	Cyanobacteria	9876	P	2778	55	2833	0.00032
SRR6945377_1_kneaddata_paired	Firmicutes_B	17289	P	671	28	699	0.00008
SRR6945377_1_kneaddata_paired	Verrucomicrobiota	33333	P	420	22	442	0.00005
SRR6945377_1_kneaddata_paired	Firmicutes_I	18140	P	342	0	342	0.00004
SRR6945377_1_kneaddata_paired	Spirochaetota	32587	P	137	0	137	0.00002
SRR6945377_1_kneaddata_paired	Firmicutes_C	17613	P	73	0	73	0.00001
SRR6945377_1_kneaddata_paired	Elusimicrobiota	11888	P	19	0	19	0.00000
SRR6945378_1_kneaddata_paired	Firmicutes_A	14608	P	4413864	28354	4442218	0.69594
SRR6945378_1_kneaddata_paired	Bacteroidota	4587	P	1481308	28866	1510174	0.23659
SRR6945378_1_kneaddata_paired	Firmicutes	12188	P	200760	1427	202187	0.03168
SRR6945378_1_kneaddata_paired	Campylobacterota	8700	P	126995	10	127005	0.01990
SRR6945378_1_kneaddata_paired	Deferribacterota	10822	P	41272	200	41472	0.00650
SRR6945378_1_kneaddata_paired	Desulfobacterota_A	11509	P	37032	176	37208	0.00583
SRR6945378_1_kneaddata_paired	Actinobacteriota	615	P	14895	96	14991	0.00235
SRR6945378_1_kneaddata_paired	Proteobacteria	22518	P	4066	17	4083	0.00064
SRR6945378_1_kneaddata_paired	Cyanobacteria	9876	P	2051	72	2123	0.00033
SRR6945378_1_kneaddata_paired	Firmicutes_B	17289	P	724	35	759	0.00012
SRR6945378_1_kneaddata_paired	Firmicutes_I	18140	P	247	0	247	0.00004
SRR6945378_1_kneaddata_paired	Verrucomicrobiota	33333	P	238	16	254	0.00004
SRR6945378_1_kneaddata_paired	Spirochaetota	32587	P	199	0	199	0.00003
SRR6945378_1_kneaddata_paired	Firmicutes_C	17613	P	62	0	62	0.00001
SRR6945378_1_kneaddata_paired	Elusimicrobiota	11888	P	9	0	9	0.00000
SRR6945378_1_kneaddata_paired	Thermotogota	33086	P	6	0	6	0.00000
SRR6945379_1_kneaddata_paired	Bacteroidota	4587	P	7243559	38302	7281861	0.59144
SRR6945379_1_kneaddata_paired	Firmicutes_A	14608	P	4329457	38297	4367754	0.35475
SRR6945379_1_kneaddata_paired	Firmicutes	12188	P	185778	556	186334	0.01513
SRR6945379_1_kneaddata_paired	Desulfobacterota_A	11509	P	175151	754	175905	0.01429
SRR6945379_1_kneaddata_paired	Verrucomicrobiota	33333	P	155820	2231	158051	0.01284
SRR6945379_1_kneaddata_paired	Campylobacterota	8700	P	55973	1	55974	0.00455
SRR6945379_1_kneaddata_paired	Proteobacteria	22518	P	52707	112	52819	0.00429
SRR6945379_1_kneaddata_paired	Actinobacteriota	615	P	15932	119	16051	0.00130
SRR6945379_1_kneaddata_paired	Deferribacterota	10822	P	15411	54	15465	0.00126
SRR6945379_1_kneaddata_paired	Cyanobacteria	9876	P	1094	12	1106	0.00009
SRR6945379_1_kneaddata_paired	Spirochaetota	32587	P	443	0	443	0.00004
SRR6945379_1_kneaddata_paired	Firmicutes_I	18140	P	377	0	377	0.00003
SRR6945379_1_kneaddata_paired	Thermotogota	33086	P	23	0	23	0.00000
SRR6945379_1_kneaddata_paired	Firmicutes_C	17613	P	13	0	13	0.00000
SRR6945379_1_kneaddata_paired	Firmicutes_B	17289	P	1	0	1	0.00000
SRR6945380_1_kneaddata_paired	Firmicutes_A	14608	P	6598749	54855	6653604	0.47739
SRR6945380_1_kneaddata_paired	Bacteroidota	4587	P	6280725	55468	6336193	0.45462
SRR6945380_1_kneaddata_paired	Firmicutes	12188	P	533519	5217	538736	0.03865
SRR6945380_1_kneaddata_paired	Actinobacteriota	615	P	121870	2492	124362	0.00892
SRR6945380_1_kneaddata_paired	Desulfobacterota_A	11509	P	119133	783	119916	0.00860
SRR6945380_1_kneaddata_paired	Campylobacterota	8700	P	64362	6	64368	0.00462
SRR6945380_1_kneaddata_paired	Deferribacterota	10822	P	47827	304	48131	0.00345
SRR6945380_1_kneaddata_paired	Proteobacteria	22518	P	46066	195	46261	0.00332
SRR6945380_1_kneaddata_paired	Cyanobacteria	9876	P	3277	142	3419	0.00025
SRR6945380_1_kneaddata_paired	Firmicutes_B	17289	P	947	60	1007	0.00007
SRR6945380_1_kneaddata_paired	Firmicutes_I	18140	P	464	0	464	0.00003
SRR6945380_1_kneaddata_paired	Spirochaetota	32587	P	388	0	388	0.00003
SRR6945380_1_kneaddata_paired	Verrucomicrobiota	33333	P	319	25	344	0.00002
SRR6945380_1_kneaddata_paired	Firmicutes_C	17613	P	106	0	106	0.00001
SRR6945380_1_kneaddata_paired	Elusimicrobiota	11888	P	15	0	15	0.00000
SRR6945380_1_kneaddata_paired	Thermotogota	33086	P	5	0	5	0.00000
SRR6945381_1_kneaddata_paired	Bacteroidota	4587	P	9446272	58436	9504708	0.49444
SRR6945381_1_kneaddata_paired	Firmicutes_A	14608	P	8562958	62526	8625484	0.44870
SRR6945381_1_kneaddata_paired	Desulfobacterota_A	11509	P	346610	767	347377	0.01807
SRR6945381_1_kneaddata_paired	Firmicutes	12188	P	245905	3287	249192	0.01296
SRR6945381_1_kneaddata_paired	Campylobacterota	8700	P	219401	4	219405	0.01141
SRR6945381_1_kneaddata_paired	Actinobacteriota	615	P	154862	929	155791	0.00810
SRR6945381_1_kneaddata_paired	Proteobacteria	22518	P	84972	163	85135	0.00443
SRR6945381_1_kneaddata_paired	Deferribacterota	10822	P	29949	153	30102	0.00157
SRR6945381_1_kneaddata_paired	Cyanobacteria	9876	P	3580	110	3690	0.00019
SRR6945381_1_kneaddata_paired	Spirochaetota	32587	P	1039	1	1040	0.00005
SRR6945381_1_kneaddata_paired	Verrucomicrobiota	33333	P	657	44	701	0.00004
SRR6945381_1_kneaddata_paired	Firmicutes_B	17289	P	304	15	319	0.00002
SRR6945381_1_kneaddata_paired	Firmicutes_I	18140	P	221	0	221	0.00001
SRR6945381_1_kneaddata_paired	Firmicutes_C	17613	P	131	0	131	0.00001
SRR6945381_1_kneaddata_paired	Elusimicrobiota	11888	P	31	0	31	0.00000
SRR6945381_1_kneaddata_paired	Thermotogota	33086	P	8	0	8	0.00000
SRR6945382_1_kneaddata_paired	Bacteroidota	4587	P	6871378	86934	6958312	0.51948
SRR6945382_1_kneaddata_paired	Firmicutes_A	14608	P	4672606	47196	4719802	0.35236
SRR6945382_1_kneaddata_paired	Verrucomicrobiota	33333	P	572724	9317	582041	0.04345
SRR6945382_1_kneaddata_paired	Firmicutes	12188	P	437354	993	438347	0.03273
SRR6945382_1_kneaddata_paired	Desulfobacterota_A	11509	P	375941	2403	378344	0.02825
SRR6945382_1_kneaddata_paired	Deferribacterota	10822	P	167532	677	168209	0.01256
SRR6945382_1_kneaddata_paired	Proteobacteria	22518	P	94362	165	94527	0.00706
SRR6945382_1_kneaddata_paired	Campylobacterota	8700	P	51482	2	51484	0.00384
SRR6945382_1_kneaddata_paired	Actinobacteriota	615	P	1102	3	1105	0.00008
SRR6945382_1_kneaddata_paired	Cyanobacteria	9876	P	1074	41	1115	0.00008
SRR6945382_1_kneaddata_paired	Spirochaetota	32587	P	730	0	730	0.00005
SRR6945382_1_kneaddata_paired	Firmicutes_I	18140	P	684	0	684	0.00005
SRR6945382_1_kneaddata_paired	Thermotogota	33086	P	67	0	67	0.00001
SRR6945382_1_kneaddata_paired	Firmicutes_C	17613	P	7	0	7	0.00000
SRR6945382_1_kneaddata_paired	Firmicutes_B	17289	P	6	0	6	0.00000
SRR6945382_1_kneaddata_paired	Elusimicrobiota	11888	P	1	0	1	0.00000
SRR6945383_1_kneaddata_paired	Firmicutes_A	14608	P	6042284	37885	6080169	0.61965
SRR6945383_1_kneaddata_paired	Bacteroidota	4587	P	2779573	50472	2830045	0.28842
SRR6945383_1_kneaddata_paired	Firmicutes	12188	P	489341	3595	492936	0.05024
SRR6945383_1_kneaddata_paired	Campylobacterota	8700	P	159379	12	159391	0.01624
SRR6945383_1_kneaddata_paired	Deferribacterota	10822	P	89500	423	89923	0.00916
SRR6945383_1_kneaddata_paired	Desulfobacterota_A	11509	P	76415	307	76722	0.00782
SRR6945383_1_kneaddata_paired	Actinobacteriota	615	P	65373	285	65658	0.00669
SRR6945383_1_kneaddata_paired	Proteobacteria	22518	P	13666	35	13701	0.00140
SRR6945383_1_kneaddata_paired	Cyanobacteria	9876	P	1502	34	1536	0.00016
SRR6945383_1_kneaddata_paired	Firmicutes_B	17289	P	980	46	1026	0.00010
SRR6945383_1_kneaddata_paired	Firmicutes_I	18140	P	471	0	471	0.00005
SRR6945383_1_kneaddata_paired	Spirochaetota	32587	P	331	0	331	0.00003
SRR6945383_1_kneaddata_paired	Verrucomicrobiota	33333	P	290	18	308	0.00003
SRR6945383_1_kneaddata_paired	Firmicutes_C	17613	P	62	0	62	0.00001
SRR6945383_1_kneaddata_paired	Elusimicrobiota	11888	P	13	0	13	0.00000
SRR6945383_1_kneaddata_paired	Thermotogota	33086	P	3	0	3	0.00000
SRR6945384_1_kneaddata_paired	Firmicutes_A	14608	P	5877846	39954	5917800	0.63105
SRR6945384_1_kneaddata_paired	Bacteroidota	4587	P	2786488	21115	2807603	0.29939
SRR6945384_1_kneaddata_paired	Firmicutes	12188	P	330256	2338	332594	0.03547
SRR6945384_1_kneaddata_paired	Campylobacterota	8700	P	140179	4	140183	0.01495
SRR6945384_1_kneaddata_paired	Desulfobacterota_A	11509	P	82666	788	83454	0.00890
SRR6945384_1_kneaddata_paired	Deferribacterota	10822	P	57111	293	57404	0.00612
SRR6945384_1_kneaddata_paired	Actinobacteriota	615	P	26698	195	26893	0.00287
SRR6945384_1_kneaddata_paired	Proteobacteria	22518	P	7990	47	8037	0.00086
SRR6945384_1_kneaddata_paired	Cyanobacteria	9876	P	1751	51	1802	0.00019
SRR6945384_1_kneaddata_paired	Firmicutes_I	18140	P	584	0	584	0.00006
SRR6945384_1_kneaddata_paired	Verrucomicrobiota	33333	P	454	28	482	0.00005
SRR6945384_1_kneaddata_paired	Firmicutes_B	17289	P	424	21	445	0.00005
SRR6945384_1_kneaddata_paired	Spirochaetota	32587	P	233	0	233	0.00002
SRR6945384_1_kneaddata_paired	Firmicutes_C	17613	P	104	0	104	0.00001
SRR6945384_1_kneaddata_paired	Elusimicrobiota	11888	P	18	0	18	0.00000
SRR6945384_1_kneaddata_paired	Thermotogota	33086	P	8	0	8	0.00000
SRR6945385_1_kneaddata_paired	Firmicutes_A	14608	P	6746741	36723	6783464	0.62741
SRR6945385_1_kneaddata_paired	Bacteroidota	4587	P	3692897	48449	3741346	0.34604
SRR6945385_1_kneaddata_paired	Desulfobacterota_A	11509	P	93616	607	94223	0.00871
SRR6945385_1_kneaddata_paired	Campylobacterota	8700	P	69836	4	69840	0.00646
SRR6945385_1_kneaddata_paired	Firmicutes	12188	P	58724	717	59441	0.00550
SRR6945385_1_kneaddata_paired	Actinobacteriota	615	P	25836	143	25979	0.00240
SRR6945385_1_kneaddata_paired	Deferribacterota	10822	P	24038	79	24117	0.00223
SRR6945385_1_kneaddata_paired	Proteobacteria	22518	P	8673	31	8704	0.00081
SRR6945385_1_kneaddata_paired	Cyanobacteria	9876	P	2961	151	3112	0.00029
SRR6945385_1_kneaddata_paired	Verrucomicrobiota	33333	P	509	23	532	0.00005
SRR6945385_1_kneaddata_paired	Firmicutes_B	17289	P	451	15	466	0.00004
SRR6945385_1_kneaddata_paired	Spirochaetota	32587	P	343	0	343	0.00003
SRR6945385_1_kneaddata_paired	Firmicutes_C	17613	P	135	0	135	0.00001
SRR6945385_1_kneaddata_paired	Firmicutes_I	18140	P	74	0	74	0.00001
SRR6945385_1_kneaddata_paired	Thermotogota	33086	P	7	0	7	0.00000
SRR6945385_1_kneaddata_paired	Elusimicrobiota	11888	P	2	0	2	0.00000
SRR6945386_1_kneaddata_paired	Firmicutes_A	14608	P	8120085	71814	8191899	0.68997
SRR6945386_1_kneaddata_paired	Bacteroidota	4587	P	2697182	50083	2747265	0.23139
SRR6945386_1_kneaddata_paired	Firmicutes	12188	P	551612	6200	557812	0.04698
SRR6945386_1_kneaddata_paired	Desulfobacterota_A	11509	P	228609	664	229273	0.01931
SRR6945386_1_kneaddata_paired	Actinobacteriota	615	P	80297	627	80924	0.00682
SRR6945386_1_kneaddata_paired	Campylobacterota	8700	P	37792	6	37798	0.00318
SRR6945386_1_kneaddata_paired	Proteobacteria	22518	P	14627	71	14698	0.00124
SRR6945386_1_kneaddata_paired	Deferribacterota	10822	P	6667	37	6704	0.00056
SRR6945386_1_kneaddata_paired	Cyanobacteria	9876	P	3139	251	3390	0.00029
SRR6945386_1_kneaddata_paired	Spirochaetota	32587	P	1729	1	1730	0.00015
SRR6945386_1_kneaddata_paired	Firmicutes_B	17289	P	753	43	796	0.00007
SRR6945386_1_kneaddata_paired	Verrucomicrobiota	33333	P	337	17	354	0.00003
SRR6945386_1_kneaddata_paired	Firmicutes_C	17613	P	107	0	107	0.00001
SRR6945386_1_kneaddata_paired	Firmicutes_I	18140	P	97	0	97	0.00001
SRR6945386_1_kneaddata_paired	Elusimicrobiota	11888	P	9	0	9	0.00000
SRR6945386_1_kneaddata_paired	Thermotogota	33086	P	5	0	5	0.00000
SRR6945387_1_kneaddata_paired	Firmicutes_A	14608	P	3373363	16100	3389463	0.61127
SRR6945387_1_kneaddata_paired	Bacteroidota	4587	P	1628533	18056	1646589	0.29695
SRR6945387_1_kneaddata_paired	Campylobacterota	8700	P	275442	3	275445	0.04967
SRR6945387_1_kneaddata_paired	Firmicutes	12188	P	76097	704	76801	0.01385
SRR6945387_1_kneaddata_paired	Deferribacterota	10822	P	65947	199	66146	0.01193
SRR6945387_1_kneaddata_paired	Desulfobacterota_A	11509	P	64039	327	64366	0.01161
SRR6945387_1_kneaddata_paired	Actinobacteriota	615	P	19627	93	19720	0.00356
SRR6945387_1_kneaddata_paired	Proteobacteria	22518	P	4065	17	4082	0.00074
SRR6945387_1_kneaddata_paired	Cyanobacteria	9876	P	1671	47	1718	0.00031
SRR6945387_1_kneaddata_paired	Verrucomicrobiota	33333	P	234	10	244	0.00004
SRR6945387_1_kneaddata_paired	Spirochaetota	32587	P	163	0	163	0.00003
SRR6945387_1_kneaddata_paired	Firmicutes_B	17289	P	109	3	112	0.00002
SRR6945387_1_kneaddata_paired	Firmicutes_I	18140	P	69	0	69	0.00001
SRR6945387_1_kneaddata_paired	Firmicutes_C	17613	P	34	0	34	0.00001
SRR6945387_1_kneaddata_paired	Thermotogota	33086	P	9	0	9	0.00000
SRR6945387_1_kneaddata_paired	Elusimicrobiota	11888	P	5	0	5	0.00000
SRR6945388_1_kneaddata_paired	Bacteroidota	4587	P	7513390	80940	7594330	0.55281
SRR6945388_1_kneaddata_paired	Firmicutes_A	14608	P	4803574	50271	4853845	0.35332
SRR6945388_1_kneaddata_paired	Verrucomicrobiota	33333	P	533069	9001	542070	0.03946
SRR6945388_1_kneaddata_paired	Desulfobacterota_A	11509	P	326667	1722	328389	0.02390
SRR6945388_1_kneaddata_paired	Firmicutes	12188	P	218483	907	219390	0.01597
SRR6945388_1_kneaddata_paired	Proteobacteria	22518	P	122925	214	123139	0.00896
SRR6945388_1_kneaddata_paired	Deferribacterota	10822	P	37673	159	37832	0.00275
SRR6945388_1_kneaddata_paired	Campylobacterota	8700	P	36378	1	36379	0.00265
SRR6945388_1_kneaddata_paired	Actinobacteriota	615	P	861	2	863	0.00006
SRR6945388_1_kneaddata_paired	Cyanobacteria	9876	P	664	21	685	0.00005
SRR6945388_1_kneaddata_paired	Spirochaetota	32587	P	477	0	477	0.00003
SRR6945388_1_kneaddata_paired	Firmicutes_I	18140	P	215	0	215	0.00002
SRR6945388_1_kneaddata_paired	Thermotogota	33086	P	53	0	53	0.00000
SRR6945388_1_kneaddata_paired	Firmicutes_C	17613	P	12	0	12	0.00000
SRR6945388_1_kneaddata_paired	Firmicutes_B	17289	P	7	0	7	0.00000
SRR6945388_1_kneaddata_paired	Elusimicrobiota	11888	P	2	0	2	0.00000
SRR6945389_1_kneaddata_paired	Firmicutes_A	14608	P	4135970	20995	4156965	0.54402
SRR6945389_1_kneaddata_paired	Bacteroidota	4587	P	2913025	31218	2944243	0.38531
SRR6945389_1_kneaddata_paired	Campylobacterota	8700	P	243245	3	243248	0.03183
SRR6945389_1_kneaddata_paired	Desulfobacterota_A	11509	P	102199	810	103009	0.01348
SRR6945389_1_kneaddata_paired	Firmicutes	12188	P	95205	897	96102	0.01258
SRR6945389_1_kneaddata_paired	Actinobacteriota	615	P	42728	240	42968	0.00562
SRR6945389_1_kneaddata_paired	Deferribacterota	10822	P	41241	126	41367	0.00541
SRR6945389_1_kneaddata_paired	Proteobacteria	22518	P	11468	39	11507	0.00151
SRR6945389_1_kneaddata_paired	Cyanobacteria	9876	P	951	19	970	0.00013
SRR6945389_1_kneaddata_paired	Firmicutes_B	17289	P	250	7	257	0.00003
SRR6945389_1_kneaddata_paired	Verrucomicrobiota	33333	P	208	8	216	0.00003
SRR6945389_1_kneaddata_paired	Spirochaetota	32587	P	194	0	194	0.00003
SRR6945389_1_kneaddata_paired	Firmicutes_C	17613	P	64	0	64	0.00001
SRR6945389_1_kneaddata_paired	Firmicutes_I	18140	P	64	0	64	0.00001
SRR6945389_1_kneaddata_paired	Elusimicrobiota	11888	P	6	0	6	0.00000
SRR6945389_1_kneaddata_paired	Thermotogota	33086	P	3	0	3	0.00000
SRR6945390_1_kneaddata_paired	Bacteroidota	4587	P	6474190	48650	6522840	0.50543
SRR6945390_1_kneaddata_paired	Firmicutes_A	14608	P	5454710	29650	5484360	0.42496
SRR6945390_1_kneaddata_paired	Desulfobacterota_A	11509	P	352787	513	353300	0.02738
SRR6945390_1_kneaddata_paired	Firmicutes	12188	P	277686	12507	290193	0.02249
SRR6945390_1_kneaddata_paired	Actinobacteriota	615	P	102233	408	102641	0.00795
SRR6945390_1_kneaddata_paired	Campylobacterota	8700	P	68770	4	68774	0.00533
SRR6945390_1_kneaddata_paired	Proteobacteria	22518	P	57428	87	57515	0.00446
SRR6945390_1_kneaddata_paired	Deferribacterota	10822	P	20642	64	20706	0.00160
SRR6945390_1_kneaddata_paired	Spirochaetota	32587	P	2261	1	2262	0.00018
SRR6945390_1_kneaddata_paired	Cyanobacteria	9876	P	1533	39	1572	0.00012
SRR6945390_1_kneaddata_paired	Verrucomicrobiota	33333	P	572	24	596	0.00005
SRR6945390_1_kneaddata_paired	Firmicutes_B	17289	P	524	16	540	0.00004
SRR6945390_1_kneaddata_paired	Firmicutes_I	18140	P	113	0	113	0.00001
SRR6945390_1_kneaddata_paired	Firmicutes_C	17613	P	92	0	92	0.00001
SRR6945390_1_kneaddata_paired	Elusimicrobiota	11888	P	16	0	16	0.00000
SRR6945390_1_kneaddata_paired	Thermotogota	33086	P	6	0	6	0.00000
SRR6945391_1_kneaddata_paired	Firmicutes_A	14608	P	5660179	22809	5682988	0.49360
SRR6945391_1_kneaddata_paired	Bacteroidota	4587	P	5226521	50250	5276771	0.45832
SRR6945391_1_kneaddata_paired	Desulfobacterota_A	11509	P	162561	327	162888	0.01415
SRR6945391_1_kneaddata_paired	Firmicutes	12188	P	149397	1038	150435	0.01307
SRR6945391_1_kneaddata_paired	Campylobacterota	8700	P	110150	1	110151	0.00957
SRR6945391_1_kneaddata_paired	Actinobacteriota	615	P	96661	287	96948	0.00842
SRR6945391_1_kneaddata_paired	Proteobacteria	22518	P	20018	62	20080	0.00174
SRR6945391_1_kneaddata_paired	Deferribacterota	10822	P	9520	26	9546	0.00083
SRR6945391_1_kneaddata_paired	Cyanobacteria	9876	P	1528	31	1559	0.00014
SRR6945391_1_kneaddata_paired	Firmicutes_B	17289	P	617	17	634	0.00006
SRR6945391_1_kneaddata_paired	Spirochaetota	32587	P	603	0	603	0.00005
SRR6945391_1_kneaddata_paired	Verrucomicrobiota	33333	P	378	12	390	0.00003
SRR6945391_1_kneaddata_paired	Firmicutes_I	18140	P	113	0	113	0.00001
SRR6945391_1_kneaddata_paired	Firmicutes_C	17613	P	104	0	104	0.00001
SRR6945391_1_kneaddata_paired	Thermotogota	33086	P	16	0	16	0.00000
SRR6945391_1_kneaddata_paired	Elusimicrobiota	11888	P	13	0	13	0.00000
SRR6945392_1_kneaddata_paired	Firmicutes_A	14608	P	6155426	33536	6188962	0.53314
SRR6945392_1_kneaddata_paired	Bacteroidota	4587	P	4766354	44740	4811094	0.41445
SRR6945392_1_kneaddata_paired	Desulfobacterota_A	11509	P	229802	670	230472	0.01985
SRR6945392_1_kneaddata_paired	Firmicutes	12188	P	134794	1295	136089	0.01172
SRR6945392_1_kneaddata_paired	Campylobacterota	8700	P	133289	2	133291	0.01148
SRR6945392_1_kneaddata_paired	Actinobacteriota	615	P	77941	333	78274	0.00674
SRR6945392_1_kneaddata_paired	Proteobacteria	22518	P	21309	55	21364	0.00184
SRR6945392_1_kneaddata_paired	Deferribacterota	10822	P	5455	16	5471	0.00047
SRR6945392_1_kneaddata_paired	Cyanobacteria	9876	P	1721	24	1745	0.00015
SRR6945392_1_kneaddata_paired	Spirochaetota	32587	P	664	0	664	0.00006
SRR6945392_1_kneaddata_paired	Verrucomicrobiota	33333	P	406	17	423	0.00004
SRR6945392_1_kneaddata_paired	Firmicutes_B	17289	P	379	11	390	0.00003
SRR6945392_1_kneaddata_paired	Firmicutes_I	18140	P	129	0	129	0.00001
SRR6945392_1_kneaddata_paired	Firmicutes_C	17613	P	82	0	82	0.00001
SRR6945392_1_kneaddata_paired	Elusimicrobiota	11888	P	10	0	10	0.00000
SRR6945392_1_kneaddata_paired	Thermotogota	33086	P	5	0	5	0.00000
SRR6945393_1_kneaddata_paired	Firmicutes_A	14608	P	6230234	27293	6257527	0.55525
SRR6945393_1_kneaddata_paired	Bacteroidota	4587	P	4341625	43848	4385473	0.38913
SRR6945393_1_kneaddata_paired	Verrucomicrobiota	33333	P	231814	2666	234480	0.02081
SRR6945393_1_kneaddata_paired	Desulfobacterota_A	11509	P	121585	971	122556	0.01087
SRR6945393_1_kneaddata_paired	Firmicutes	12188	P	113507	966	114473	0.01016
SRR6945393_1_kneaddata_paired	Campylobacterota	8700	P	93126	5	93131	0.00826
SRR6945393_1_kneaddata_paired	Proteobacteria	22518	P	27330	74	27404	0.00243
SRR6945393_1_kneaddata_paired	Actinobacteriota	615	P	26200	131	26331	0.00234
SRR6945393_1_kneaddata_paired	Deferribacterota	10822	P	5558	15	5573	0.00049
SRR6945393_1_kneaddata_paired	Cyanobacteria	9876	P	2228	45	2273	0.00020
SRR6945393_1_kneaddata_paired	Firmicutes_B	17289	P	258	7	265	0.00002
SRR6945393_1_kneaddata_paired	Spirochaetota	32587	P	138	0	138	0.00001
SRR6945393_1_kneaddata_paired	Firmicutes_C	17613	P	104	0	104	0.00001
SRR6945393_1_kneaddata_paired	Firmicutes_I	18140	P	84	0	84	0.00001
SRR6945393_1_kneaddata_paired	Elusimicrobiota	11888	P	18	0	18	0.00000
SRR6945393_1_kneaddata_paired	Thermotogota	33086	P	5	0	5	0.00000
SRR6945394_1_kneaddata_paired	Firmicutes_A	14608	P	5773486	33392	5806878	0.65630
SRR6945394_1_kneaddata_paired	Bacteroidota	4587	P	2203432	32543	2235975	0.25271
SRR6945394_1_kneaddata_paired	Campylobacterota	8700	P	351353	7	351360	0.03971
SRR6945394_1_kneaddata_paired	Firmicutes	12188	P	208495	2330	210825	0.02383
SRR6945394_1_kneaddata_paired	Desulfobacterota_A	11509	P	136686	1320	138006	0.01560
SRR6945394_1_kneaddata_paired	Actinobacteriota	615	P	75915	539	76454	0.00864
SRR6945394_1_kneaddata_paired	Deferribacterota	10822	P	16043	70	16113	0.00182
SRR6945394_1_kneaddata_paired	Proteobacteria	22518	P	7950	41	7991	0.00090
SRR6945394_1_kneaddata_paired	Cyanobacteria	9876	P	2709	137	2846	0.00032
SRR6945394_1_kneaddata_paired	Firmicutes_B	17289	P	672	29	701	0.00008
SRR6945394_1_kneaddata_paired	Verrucomicrobiota	33333	P	288	17	305	0.00003
SRR6945394_1_kneaddata_paired	Spirochaetota	32587	P	264	0	264	0.00003
SRR6945394_1_kneaddata_paired	Firmicutes_C	17613	P	101	0	101	0.00001
SRR6945394_1_kneaddata_paired	Firmicutes_I	18140	P	98	0	98	0.00001
SRR6945394_1_kneaddata_paired	Elusimicrobiota	11888	P	8	0	8	0.00000
SRR6945394_1_kneaddata_paired	Thermotogota	33086	P	7	0	7	0.00000
SRR6945397_1_kneaddata_paired	Firmicutes_A	14608	P	2737346	14754	2752100	0.61144
SRR6945397_1_kneaddata_paired	Bacteroidota	4587	P	1439101	18367	1457468	0.32381
SRR6945397_1_kneaddata_paired	Firmicutes	12188	P	140566	930	141496	0.03144
SRR6945397_1_kneaddata_paired	Campylobacterota	8700	P	77798	4	77802	0.01729
SRR6945397_1_kneaddata_paired	Desulfobacterota_A	11509	P	29996	357	30353	0.00674
SRR6945397_1_kneaddata_paired	Actinobacteriota	615	P	22395	79	22474	0.00499
SRR6945397_1_kneaddata_paired	Deferribacterota	10822	P	9196	35	9231	0.00205
SRR6945397_1_kneaddata_paired	Proteobacteria	22518	P	7975	20	7995	0.00178
SRR6945397_1_kneaddata_paired	Cyanobacteria	9876	P	1380	20	1400	0.00031
SRR6945397_1_kneaddata_paired	Firmicutes_B	17289	P	286	10	296	0.00007
SRR6945397_1_kneaddata_paired	Firmicutes_I	18140	P	164	0	164	0.00004
SRR6945397_1_kneaddata_paired	Verrucomicrobiota	33333	P	145	6	151	0.00003
SRR6945397_1_kneaddata_paired	Spirochaetota	32587	P	50	0	50	0.00001
SRR6945397_1_kneaddata_paired	Firmicutes_C	17613	P	39	0	39	0.00001
SRR6945397_1_kneaddata_paired	Elusimicrobiota	11888	P	2	0	2	0.00000
SRR6945398_1_kneaddata_paired	Bacteroidota	4587	P	3651711	47033	3698744	0.47910
SRR6945398_1_kneaddata_paired	Firmicutes_A	14608	P	3601289	20400	3621689	0.46912
SRR6945398_1_kneaddata_paired	Desulfobacterota_A	11509	P	129872	832	130704	0.01693
SRR6945398_1_kneaddata_paired	Firmicutes	12188	P	104456	1025	105481	0.01366
SRR6945398_1_kneaddata_paired	Campylobacterota	8700	P	83909	5	83914	0.01087
SRR6945398_1_kneaddata_paired	Actinobacteriota	615	P	39220	157	39377	0.00510
SRR6945398_1_kneaddata_paired	Deferribacterota	10822	P	20380	74	20454	0.00265
SRR6945398_1_kneaddata_paired	Proteobacteria	22518	P	17009	57	17066	0.00221
SRR6945398_1_kneaddata_paired	Cyanobacteria	9876	P	1536	27	1563	0.00020
SRR6945398_1_kneaddata_paired	Firmicutes_B	17289	P	470	17	487	0.00006
SRR6945398_1_kneaddata_paired	Spirochaetota	32587	P	323	0	323	0.00004
SRR6945398_1_kneaddata_paired	Verrucomicrobiota	33333	P	232	10	242	0.00003
SRR6945398_1_kneaddata_paired	Firmicutes_C	17613	P	65	0	65	0.00001
SRR6945398_1_kneaddata_paired	Firmicutes_I	18140	P	47	0	47	0.00001
SRR6945398_1_kneaddata_paired	Elusimicrobiota	11888	P	6	0	6	0.00000
SRR6945398_1_kneaddata_paired	Thermotogota	33086	P	3	0	3	0.00000
SRR6945399_1_kneaddata_paired	Firmicutes_A	14608	P	5074854	21007	5095861	0.55621
SRR6945399_1_kneaddata_paired	Bacteroidota	4587	P	3275583	26730	3302313	0.36044
SRR6945399_1_kneaddata_paired	Campylobacterota	8700	P	363478	4	363482	0.03967
SRR6945399_1_kneaddata_paired	Firmicutes	12188	P	147307	2371	149678	0.01634
SRR6945399_1_kneaddata_paired	Desulfobacterota_A	11509	P	128977	237	129214	0.01410
SRR6945399_1_kneaddata_paired	Actinobacteriota	615	P	46232	373	46605	0.00509
SRR6945399_1_kneaddata_paired	Deferribacterota	10822	P	42661	124	42785	0.00467
SRR6945399_1_kneaddata_paired	Proteobacteria	22518	P	28678	44	28722	0.00314
SRR6945399_1_kneaddata_paired	Cyanobacteria	9876	P	1610	36	1646	0.00018
SRR6945399_1_kneaddata_paired	Firmicutes_B	17289	P	472	13	485	0.00005
SRR6945399_1_kneaddata_paired	Spirochaetota	32587	P	465	0	465	0.00005
SRR6945399_1_kneaddata_paired	Verrucomicrobiota	33333	P	308	11	319	0.00003
SRR6945399_1_kneaddata_paired	Firmicutes_I	18140	P	108	0	108	0.00001
SRR6945399_1_kneaddata_paired	Firmicutes_C	17613	P	95	0	95	0.00001
SRR6945399_1_kneaddata_paired	Elusimicrobiota	11888	P	9	0	9	0.00000
SRR6945399_1_kneaddata_paired	Thermotogota	33086	P	4	0	4	0.00000
SRR6945400_1_kneaddata_paired	Firmicutes_A	14608	P	2582193	11045	2593238	0.51175
SRR6945400_1_kneaddata_paired	Bacteroidota	4587	P	1509437	15504	1524941	0.30093
SRR6945400_1_kneaddata_paired	Campylobacterota	8700	P	568489	6	568495	0.11219
SRR6945400_1_kneaddata_paired	Firmicutes	12188	P	127282	866	128148	0.02529
SRR6945400_1_kneaddata_paired	Desulfobacterota_A	11509	P	112767	630	113397	0.02238
SRR6945400_1_kneaddata_paired	Deferribacterota	10822	P	75106	212	75318	0.01486
SRR6945400_1_kneaddata_paired	Actinobacteriota	615	P	53349	185	53534	0.01056
SRR6945400_1_kneaddata_paired	Proteobacteria	22518	P	8479	17	8496	0.00168
SRR6945400_1_kneaddata_paired	Cyanobacteria	9876	P	1162	11	1173	0.00023
SRR6945400_1_kneaddata_paired	Spirochaetota	32587	P	295	0	295	0.00006
SRR6945400_1_kneaddata_paired	Verrucomicrobiota	33333	P	141	5	146	0.00003
SRR6945400_1_kneaddata_paired	Firmicutes_B	17289	P	109	3	112	0.00002
SRR6945400_1_kneaddata_paired	Firmicutes_I	18140	P	55	0	55	0.00001
SRR6945400_1_kneaddata_paired	Firmicutes_C	17613	P	43	0	43	0.00001
SRR6945400_1_kneaddata_paired	Elusimicrobiota	11888	P	3	0	3	0.00000
SRR6945400_1_kneaddata_paired	Thermotogota	33086	P	2	0	2	0.00000
SRR6945401_1_kneaddata_paired	Firmicutes_A	14608	P	8377997	60311	8438308	0.70038
SRR6945401_1_kneaddata_paired	Bacteroidota	4587	P	2457354	24309	2481663	0.20598
SRR6945401_1_kneaddata_paired	Firmicutes	12188	P	371077	6069	377146	0.03130
SRR6945401_1_kneaddata_paired	Campylobacterota	8700	P	252630	19	252649	0.02097
SRR6945401_1_kneaddata_paired	Verrucomicrobiota	33333	P	220222	4206	224428	0.01863
SRR6945401_1_kneaddata_paired	Deferribacterota	10822	P	102031	484	102515	0.00851
SRR6945401_1_kneaddata_paired	Desulfobacterota_A	11509	P	76894	1115	78009	0.00647
SRR6945401_1_kneaddata_paired	Actinobacteriota	615	P	56592	251	56843	0.00472
SRR6945401_1_kneaddata_paired	Proteobacteria	22518	P	27876	85	27961	0.00232
SRR6945401_1_kneaddata_paired	Cyanobacteria	9876	P	7381	594	7975	0.00066
SRR6945401_1_kneaddata_paired	Firmicutes_B	17289	P	295	14	309	0.00003
SRR6945401_1_kneaddata_paired	Spirochaetota	32587	P	251	0	251	0.00002
SRR6945401_1_kneaddata_paired	Firmicutes_C	17613	P	84	0	84	0.00001
SRR6945401_1_kneaddata_paired	Firmicutes_I	18140	P	73	0	73	0.00001
SRR6945401_1_kneaddata_paired	Thermotogota	33086	P	9	0	9	0.00000
SRR6945401_1_kneaddata_paired	Elusimicrobiota	11888	P	6	0	6	0.00000
SRR6945402_1_kneaddata_paired	Firmicutes_A	14608	P	5835508	31661	5867169	0.57853
SRR6945402_1_kneaddata_paired	Bacteroidota	4587	P	3542254	35682	3577936	0.35280
SRR6945402_1_kneaddata_paired	Campylobacterota	8700	P	264647	4	264651	0.02610
SRR6945402_1_kneaddata_paired	Desulfobacterota_A	11509	P	144895	1065	145960	0.01439
SRR6945402_1_kneaddata_paired	Firmicutes	12188	P	143545	1376	144921	0.01429
SRR6945402_1_kneaddata_paired	Deferribacterota	10822	P	60283	188	60471	0.00596
SRR6945402_1_kneaddata_paired	Actinobacteriota	615	P	56899	218	57117	0.00563
SRR6945402_1_kneaddata_paired	Proteobacteria	22518	P	17491	66	17557	0.00173
SRR6945402_1_kneaddata_paired	Cyanobacteria	9876	P	4108	83	4191	0.00041
SRR6945402_1_kneaddata_paired	Verrucomicrobiota	33333	P	519	22	541	0.00005
SRR6945402_1_kneaddata_paired	Firmicutes_B	17289	P	409	12	421	0.00004
SRR6945402_1_kneaddata_paired	Spirochaetota	32587	P	280	0	280	0.00003
SRR6945402_1_kneaddata_paired	Firmicutes_C	17613	P	105	0	105	0.00001
SRR6945402_1_kneaddata_paired	Firmicutes_I	18140	P	91	0	91	0.00001
SRR6945402_1_kneaddata_paired	Elusimicrobiota	11888	P	11	0	11	0.00000
SRR6945402_1_kneaddata_paired	Thermotogota	33086	P	6	0	6	0.00000
SRR6945403_1_kneaddata_paired	Firmicutes_A	14608	P	5802660	34692	5837352	0.55053
SRR6945403_1_kneaddata_paired	Bacteroidota	4587	P	4034294	50331	4084625	0.38523
SRR6945403_1_kneaddata_paired	Firmicutes	12188	P	312481	2579	315060	0.02971
SRR6945403_1_kneaddata_paired	Campylobacterota	8700	P	145139	8	145147	0.01369
SRR6945403_1_kneaddata_paired	Desulfobacterota_A	11509	P	121500	736	122236	0.01153
SRR6945403_1_kneaddata_paired	Actinobacteriota	615	P	48947	196	49143	0.00463
SRR6945403_1_kneaddata_paired	Deferribacterota	10822	P	24939	89	25028	0.00236
SRR6945403_1_kneaddata_paired	Proteobacteria	22518	P	19661	74	19735	0.00186
SRR6945403_1_kneaddata_paired	Cyanobacteria	9876	P	3155	103	3258	0.00031
SRR6945403_1_kneaddata_paired	Verrucomicrobiota	33333	P	814	22	836	0.00008
SRR6945403_1_kneaddata_paired	Spirochaetota	32587	P	315	0	315	0.00003
SRR6945403_1_kneaddata_paired	Firmicutes_B	17289	P	243	8	251	0.00002
SRR6945403_1_kneaddata_paired	Firmicutes_I	18140	P	92	0	92	0.00001
SRR6945403_1_kneaddata_paired	Firmicutes_C	17613	P	90	0	90	0.00001
SRR6945403_1_kneaddata_paired	Elusimicrobiota	11888	P	12	0	12	0.00000
SRR6945403_1_kneaddata_paired	Thermotogota	33086	P	6	0	6	0.00000
SRR6945404_1_kneaddata_paired	Firmicutes_A	14608	P	9896078	79605	9975683	0.73394
SRR6945404_1_kneaddata_paired	Bacteroidota	4587	P	2816794	60891	2877685	0.21172
SRR6945404_1_kneaddata_paired	Firmicutes	12188	P	389998	3711	393709	0.02897
SRR6945404_1_kneaddata_paired	Campylobacterota	8700	P	243558	21	243579	0.01792
SRR6945404_1_kneaddata_paired	Desulfobacterota_A	11509	P	47766	730	48496	0.00357
SRR6945404_1_kneaddata_paired	Deferribacterota	10822	P	28599	147	28746	0.00211
SRR6945404_1_kneaddata_paired	Actinobacteriota	615	P	12954	64	13018	0.00096
SRR6945404_1_kneaddata_paired	Proteobacteria	22518	P	4149	58	4207	0.00031
SRR6945404_1_kneaddata_paired	Cyanobacteria	9876	P	3294	106	3400	0.00025
SRR6945404_1_kneaddata_paired	Firmicutes_B	17289	P	2088	107	2195	0.00016
SRR6945404_1_kneaddata_paired	Verrucomicrobiota	33333	P	493	36	529	0.00004
SRR6945404_1_kneaddata_paired	Firmicutes_I	18140	P	445	0	445	0.00003
SRR6945404_1_kneaddata_paired	Spirochaetota	32587	P	112	0	112	0.00001
SRR6945404_1_kneaddata_paired	Firmicutes_C	17613	P	74	0	74	0.00001
SRR6945404_1_kneaddata_paired	Thermotogota	33086	P	8	0	8	0.00000
SRR6945404_1_kneaddata_paired	Elusimicrobiota	11888	P	6	0	6	0.00000
SRR6945405_1_kneaddata_paired	Firmicutes_A	14608	P	5718675	29894	5748569	0.56039
SRR6945405_1_kneaddata_paired	Bacteroidota	4587	P	3748614	35526	3784140	0.36889
SRR6945405_1_kneaddata_paired	Desulfobacterota_A	11509	P	238219	1870	240089	0.02340
SRR6945405_1_kneaddata_paired	Campylobacterota	8700	P	201511	3	201514	0.01964
SRR6945405_1_kneaddata_paired	Firmicutes	12188	P	159106	1707	160813	0.01568
SRR6945405_1_kneaddata_paired	Actinobacteriota	615	P	51735	275	52010	0.00507
SRR6945405_1_kneaddata_paired	Deferribacterota	10822	P	40745	135	40880	0.00399
SRR6945405_1_kneaddata_paired	Proteobacteria	22518	P	21920	52	21972	0.00214
SRR6945405_1_kneaddata_paired	Cyanobacteria	9876	P	6589	188	6777	0.00066
SRR6945405_1_kneaddata_paired	Firmicutes_B	17289	P	498	16	514	0.00005
SRR6945405_1_kneaddata_paired	Spirochaetota	32587	P	295	0	295	0.00003
SRR6945405_1_kneaddata_paired	Verrucomicrobiota	33333	P	283	12	295	0.00003
SRR6945405_1_kneaddata_paired	Firmicutes_I	18140	P	112	0	112	0.00001
SRR6945405_1_kneaddata_paired	Firmicutes_C	17613	P	96	0	96	0.00001
SRR6945405_1_kneaddata_paired	Thermotogota	33086	P	19	0	19	0.00000
SRR6945405_1_kneaddata_paired	Elusimicrobiota	11888	P	13	0	13	0.00000
SRR6945406_1_kneaddata_paired	Firmicutes_A	14608	P	5613430	27701	5641131	0.59088
SRR6945406_1_kneaddata_paired	Bacteroidota	4587	P	3073825	40317	3114142	0.32619
SRR6945406_1_kneaddata_paired	Firmicutes	12188	P	311543	1629	313172	0.03280
SRR6945406_1_kneaddata_paired	Deferribacterota	10822	P	173603	577	174180	0.01824
SRR6945406_1_kneaddata_paired	Desulfobacterota_A	11509	P	135408	1153	136561	0.01430
SRR6945406_1_kneaddata_paired	Campylobacterota	8700	P	92672	4	92676	0.00971
SRR6945406_1_kneaddata_paired	Actinobacteriota	615	P	58091	201	58292	0.00611
SRR6945406_1_kneaddata_paired	Proteobacteria	22518	P	14027	74	14101	0.00148
SRR6945406_1_kneaddata_paired	Cyanobacteria	9876	P	1638	29	1667	0.00017
SRR6945406_1_kneaddata_paired	Firmicutes_B	17289	P	410	13	423	0.00004
SRR6945406_1_kneaddata_paired	Spirochaetota	32587	P	291	0	291	0.00003
SRR6945406_1_kneaddata_paired	Verrucomicrobiota	33333	P	258	10	268	0.00003
SRR6945406_1_kneaddata_paired	Firmicutes_I	18140	P	77	0	77	0.00001
SRR6945406_1_kneaddata_paired	Firmicutes_C	17613	P	55	0	55	0.00001
SRR6945406_1_kneaddata_paired	Elusimicrobiota	11888	P	11	0	11	0.00000
SRR6945406_1_kneaddata_paired	Thermotogota	33086	P	4	0	4	0.00000
SRR6945407_1_kneaddata_paired	Firmicutes_A	14608	P	4207840	28212	4236052	0.52821
SRR6945407_1_kneaddata_paired	Bacteroidota	4587	P	3375384	22930	3398314	0.42375
SRR6945407_1_kneaddata_paired	Firmicutes	12188	P	217411	839	218250	0.02721
SRR6945407_1_kneaddata_paired	Desulfobacterota_A	11509	P	68609	306	68915	0.00859
SRR6945407_1_kneaddata_paired	Campylobacterota	8700	P	37400	3	37403	0.00466
SRR6945407_1_kneaddata_paired	Actinobacteriota	615	P	37376	377	37753	0.00471
SRR6945407_1_kneaddata_paired	Proteobacteria	22518	P	11058	35	11093	0.00138
SRR6945407_1_kneaddata_paired	Deferribacterota	10822	P	8569	40	8609	0.00107
SRR6945407_1_kneaddata_paired	Cyanobacteria	9876	P	1823	56	1879	0.00023
SRR6945407_1_kneaddata_paired	Verrucomicrobiota	33333	P	463	31	494	0.00006
SRR6945407_1_kneaddata_paired	Firmicutes_I	18140	P	423	0	423	0.00005
SRR6945407_1_kneaddata_paired	Spirochaetota	32587	P	229	0	229	0.00003
SRR6945407_1_kneaddata_paired	Firmicutes_B	17289	P	182	8	190	0.00002
SRR6945407_1_kneaddata_paired	Firmicutes_C	17613	P	63	0	63	0.00001
SRR6945407_1_kneaddata_paired	Elusimicrobiota	11888	P	8	0	8	0.00000
SRR6945407_1_kneaddata_paired	Thermotogota	33086	P	5	0	5	0.00000
SRR6945408_1_kneaddata_paired	Firmicutes_A	14608	P	6652063	49706	6701769	0.64329
SRR6945408_1_kneaddata_paired	Bacteroidota	4587	P	2536100	19037	2555137	0.24526
SRR6945408_1_kneaddata_paired	Verrucomicrobiota	33333	P	569961	6808	576769	0.05536
SRR6945408_1_kneaddata_paired	Desulfobacterota_A	11509	P	272420	761	273181	0.02622
SRR6945408_1_kneaddata_paired	Firmicutes	12188	P	236642	293	236935	0.02274
SRR6945408_1_kneaddata_paired	Proteobacteria	22518	P	61189	88	61277	0.00588
SRR6945408_1_kneaddata_paired	Campylobacterota	8700	P	8158	0	8158	0.00078
SRR6945408_1_kneaddata_paired	Deferribacterota	10822	P	2536	7	2543	0.00024
SRR6945408_1_kneaddata_paired	Actinobacteriota	615	P	832	1	833	0.00008
SRR6945408_1_kneaddata_paired	Cyanobacteria	9876	P	607	7	614	0.00006
SRR6945408_1_kneaddata_paired	Firmicutes_I	18140	P	373	0	373	0.00004
SRR6945408_1_kneaddata_paired	Spirochaetota	32587	P	243	0	243	0.00002
SRR6945408_1_kneaddata_paired	Thermotogota	33086	P	44	0	44	0.00000
SRR6945408_1_kneaddata_paired	Firmicutes_B	17289	P	4	0	4	0.00000
SRR6945408_1_kneaddata_paired	Firmicutes_C	17613	P	3	0	3	0.00000
SRR6945408_1_kneaddata_paired	Elusimicrobiota	11888	P	1	0	1	0.00000
SRR6945409_1_kneaddata_paired	Bacteroidota	4587	P	2972569	25021	2997590	0.50102
SRR6945409_1_kneaddata_paired	Firmicutes_A	14608	P	2715018	20134	2735152	0.45715
SRR6945409_1_kneaddata_paired	Firmicutes	12188	P	129911	633	130544	0.02182
SRR6945409_1_kneaddata_paired	Desulfobacterota_A	11509	P	43963	220	44183	0.00738
SRR6945409_1_kneaddata_paired	Campylobacterota	8700	P	32943	3	32946	0.00551
SRR6945409_1_kneaddata_paired	Actinobacteriota	615	P	28034	365	28399	0.00475
SRR6945409_1_kneaddata_paired	Proteobacteria	22518	P	8146	38	8184	0.00137
SRR6945409_1_kneaddata_paired	Deferribacterota	10822	P	4337	24	4361	0.00073
SRR6945409_1_kneaddata_paired	Cyanobacteria	9876	P	680	13	693	0.00012
SRR6945409_1_kneaddata_paired	Firmicutes_B	17289	P	303	17	320	0.00005
SRR6945409_1_kneaddata_paired	Firmicutes_I	18140	P	238	0	238	0.00004
SRR6945409_1_kneaddata_paired	Verrucomicrobiota	33333	P	201	10	211	0.00004
SRR6945409_1_kneaddata_paired	Spirochaetota	32587	P	124	0	124	0.00002
SRR6945409_1_kneaddata_paired	Firmicutes_C	17613	P	46	0	46	0.00001
SRR6945409_1_kneaddata_paired	Elusimicrobiota	11888	P	7	0	7	0.00000
SRR6945409_1_kneaddata_paired	Thermotogota	33086	P	2	0	2	0.00000
SRR6945410_1_kneaddata_paired	Bacteroidota	4587	P	3824626	28469	3853095	0.47521
SRR6945410_1_kneaddata_paired	Firmicutes_A	14608	P	3755116	20693	3775809	0.46567
SRR6945410_1_kneaddata_paired	Firmicutes	12188	P	184024	1497	185521	0.02288
SRR6945410_1_kneaddata_paired	Desulfobacterota_A	11509	P	114406	469	114875	0.01417
SRR6945410_1_kneaddata_paired	Actinobacteriota	615	P	76205	541	76746	0.00947
SRR6945410_1_kneaddata_paired	Campylobacterota	8700	P	74691	7	74698	0.00921
SRR6945410_1_kneaddata_paired	Proteobacteria	22518	P	12879	77	12956	0.00160
SRR6945410_1_kneaddata_paired	Deferribacterota	10822	P	10643	47	10690	0.00132
SRR6945410_1_kneaddata_paired	Cyanobacteria	9876	P	2610	59	2669	0.00033
SRR6945410_1_kneaddata_paired	Verrucomicrobiota	33333	P	384	17	401	0.00005
SRR6945410_1_kneaddata_paired	Spirochaetota	32587	P	343	0	343	0.00004
SRR6945410_1_kneaddata_paired	Firmicutes_I	18140	P	258	0	258	0.00003
SRR6945410_1_kneaddata_paired	Firmicutes_B	17289	P	130	5	135	0.00002
SRR6945410_1_kneaddata_paired	Firmicutes_C	17613	P	61	0	61	0.00001
SRR6945410_1_kneaddata_paired	Elusimicrobiota	11888	P	5	0	5	0.00000
SRR6945410_1_kneaddata_paired	Thermotogota	33086	P	3	0	3	0.00000
SRR6945411_1_kneaddata_paired	Bacteroidota	4587	P	2370371	17238	2387609	0.51416
SRR6945411_1_kneaddata_paired	Firmicutes_A	14608	P	1912882	12074	1924956	0.41453
SRR6945411_1_kneaddata_paired	Firmicutes	12188	P	178311	597	178908	0.03853
SRR6945411_1_kneaddata_paired	Desulfobacterota_A	11509	P	52197	239	52436	0.01129
SRR6945411_1_kneaddata_paired	Campylobacterota	8700	P	50231	1	50232	0.01082
SRR6945411_1_kneaddata_paired	Actinobacteriota	615	P	26316	235	26551	0.00572
SRR6945411_1_kneaddata_paired	Deferribacterota	10822	P	12136	58	12194	0.00263
SRR6945411_1_kneaddata_paired	Proteobacteria	22518	P	9021	28	9049	0.00195
SRR6945411_1_kneaddata_paired	Cyanobacteria	9876	P	888	18	906	0.00020
SRR6945411_1_kneaddata_paired	Firmicutes_I	18140	P	338	0	338	0.00007
SRR6945411_1_kneaddata_paired	Verrucomicrobiota	33333	P	190	11	201	0.00004
SRR6945411_1_kneaddata_paired	Spirochaetota	32587	P	185	0	185	0.00004
SRR6945411_1_kneaddata_paired	Firmicutes_B	17289	P	98	4	102	0.00002
SRR6945411_1_kneaddata_paired	Firmicutes_C	17613	P	43	0	43	0.00001
SRR6945411_1_kneaddata_paired	Elusimicrobiota	11888	P	16	0	16	0.00000
SRR6945411_1_kneaddata_paired	Thermotogota	33086	P	1	0	1	0.00000
SRR6945412_1_kneaddata_paired	Firmicutes_A	14608	P	5912030	49296	5961326	0.49562
SRR6945412_1_kneaddata_paired	Bacteroidota	4587	P	4503812	48404	4552216	0.37847
SRR6945412_1_kneaddata_paired	Verrucomicrobiota	33333	P	912161	12515	924676	0.07688
SRR6945412_1_kneaddata_paired	Desulfobacterota_A	11509	P	268775	1201	269976	0.02245
SRR6945412_1_kneaddata_paired	Firmicutes	12188	P	209605	430	210035	0.01746
SRR6945412_1_kneaddata_paired	Proteobacteria	22518	P	83965	127	84092	0.00699
SRR6945412_1_kneaddata_paired	Campylobacterota	8700	P	16359	1	16360	0.00136
SRR6945412_1_kneaddata_paired	Deferribacterota	10822	P	7360	24	7384	0.00061
SRR6945412_1_kneaddata_paired	Actinobacteriota	615	P	685	1	686	0.00006
SRR6945412_1_kneaddata_paired	Cyanobacteria	9876	P	530	10	540	0.00004
SRR6945412_1_kneaddata_paired	Spirochaetota	32587	P	358	0	358	0.00003
SRR6945412_1_kneaddata_paired	Firmicutes_I	18140	P	356	0	356	0.00003
SRR6945412_1_kneaddata_paired	Thermotogota	33086	P	36	0	36	0.00000
SRR6945412_1_kneaddata_paired	Firmicutes_B	17289	P	5	0	5	0.00000
SRR6945412_1_kneaddata_paired	Firmicutes_C	17613	P	4	0	4	0.00000
SRR6945412_1_kneaddata_paired	Elusimicrobiota	11888	P	1	0	1	0.00000
SRR6945413_1_kneaddata_paired	Firmicutes_A	14608	P	3644294	26143	3670437	0.76450
SRR6945413_1_kneaddata_paired	Bacteroidota	4587	P	763699	16991	780690	0.16261
SRR6945413_1_kneaddata_paired	Firmicutes	12188	P	262985	1061	264046	0.05500
SRR6945413_1_kneaddata_paired	Desulfobacterota_A	11509	P	44720	243	44963	0.00937
SRR6945413_1_kneaddata_paired	Actinobacteriota	615	P	21915	130	22045	0.00459
SRR6945413_1_kneaddata_paired	Campylobacterota	8700	P	9054	1	9055	0.00189
SRR6945413_1_kneaddata_paired	Deferribacterota	10822	P	3669	21	3690	0.00077
SRR6945413_1_kneaddata_paired	Proteobacteria	22518	P	3600	15	3615	0.00075
SRR6945413_1_kneaddata_paired	Cyanobacteria	9876	P	1145	22	1167	0.00024
SRR6945413_1_kneaddata_paired	Firmicutes_B	17289	P	475	28	503	0.00010
SRR6945413_1_kneaddata_paired	Firmicutes_I	18140	P	400	0	400	0.00008
SRR6945413_1_kneaddata_paired	Verrucomicrobiota	33333	P	195	14	209	0.00004
SRR6945413_1_kneaddata_paired	Spirochaetota	32587	P	173	0	173	0.00004
SRR6945413_1_kneaddata_paired	Firmicutes_C	17613	P	52	0	52	0.00001
SRR6945413_1_kneaddata_paired	Elusimicrobiota	11888	P	12	0	12	0.00000
SRR6945413_1_kneaddata_paired	Thermotogota	33086	P	3	0	3	0.00000
SRR6945414_1_kneaddata_paired	Firmicutes_A	14608	P	5108010	38430	5146440	0.55908
SRR6945414_1_kneaddata_paired	Bacteroidota	4587	P	3630591	37145	3667736	0.39844
SRR6945414_1_kneaddata_paired	Firmicutes	12188	P	154265	1268	155533	0.01690
SRR6945414_1_kneaddata_paired	Desulfobacterota_A	11509	P	115830	287	116117	0.01261
SRR6945414_1_kneaddata_paired	Campylobacterota	8700	P	57415	6	57421	0.00624
SRR6945414_1_kneaddata_paired	Actinobacteriota	615	P	35406	313	35719	0.00388
SRR6945414_1_kneaddata_paired	Deferribacterota	10822	P	12632	65	12697	0.00138
SRR6945414_1_kneaddata_paired	Proteobacteria	22518	P	10466	27	10493	0.00114
SRR6945414_1_kneaddata_paired	Cyanobacteria	9876	P	1863	30	1893	0.00021
SRR6945414_1_kneaddata_paired	Spirochaetota	32587	P	412	0	412	0.00004
SRR6945414_1_kneaddata_paired	Verrucomicrobiota	33333	P	300	15	315	0.00003
SRR6945414_1_kneaddata_paired	Firmicutes_I	18140	P	235	0	235	0.00003
SRR6945414_1_kneaddata_paired	Firmicutes_B	17289	P	134	6	140	0.00002
SRR6945414_1_kneaddata_paired	Firmicutes_C	17613	P	75	0	75	0.00001
SRR6945414_1_kneaddata_paired	Elusimicrobiota	11888	P	12	0	12	0.00000
SRR6945414_1_kneaddata_paired	Thermotogota	33086	P	5	0	5	0.00000
SRR6945415_1_kneaddata_paired	Firmicutes_A	14608	P	4091405	23545	4114950	0.67558
SRR6945415_1_kneaddata_paired	Bacteroidota	4587	P	1702836	28113	1730949	0.28418
SRR6945415_1_kneaddata_paired	Firmicutes	12188	P	114002	548	114550	0.01881
SRR6945415_1_kneaddata_paired	Desulfobacterota_A	11509	P	54874	295	55169	0.00906
SRR6945415_1_kneaddata_paired	Campylobacterota	8700	P	35056	2	35058	0.00576
SRR6945415_1_kneaddata_paired	Actinobacteriota	615	P	25027	153	25180	0.00413
SRR6945415_1_kneaddata_paired	Deferribacterota	10822	P	9319	41	9360	0.00154
SRR6945415_1_kneaddata_paired	Proteobacteria	22518	P	3700	19	3719	0.00061
SRR6945415_1_kneaddata_paired	Cyanobacteria	9876	P	962	13	975	0.00016
SRR6945415_1_kneaddata_paired	Firmicutes_B	17289	P	385	17	402	0.00007
SRR6945415_1_kneaddata_paired	Verrucomicrobiota	33333	P	238	12	250	0.00004
SRR6945415_1_kneaddata_paired	Firmicutes_I	18140	P	169	0	169	0.00003
SRR6945415_1_kneaddata_paired	Spirochaetota	32587	P	144	0	144	0.00002
SRR6945415_1_kneaddata_paired	Firmicutes_C	17613	P	62	0	62	0.00001
SRR6945415_1_kneaddata_paired	Elusimicrobiota	11888	P	12	0	12	0.00000
SRR6945416_1_kneaddata_paired	Bacteroidota	4587	P	4688350	22942	4711292	0.47166
SRR6945416_1_kneaddata_paired	Firmicutes_A	14608	P	4621149	38259	4659408	0.46647
SRR6945416_1_kneaddata_paired	Verrucomicrobiota	33333	P	209111	2756	211867	0.02121
SRR6945416_1_kneaddata_paired	Desulfobacterota_A	11509	P	165739	678	166417	0.01666
SRR6945416_1_kneaddata_paired	Proteobacteria	22518	P	88388	141	88529	0.00886
SRR6945416_1_kneaddata_paired	Firmicutes	12188	P	58893	269	59162	0.00592
SRR6945416_1_kneaddata_paired	Campylobacterota	8700	P	47781	0	47781	0.00478
SRR6945416_1_kneaddata_paired	Actinobacteriota	615	P	30274	199	30473	0.00305
SRR6945416_1_kneaddata_paired	Deferribacterota	10822	P	12561	41	12602	0.00126
SRR6945416_1_kneaddata_paired	Cyanobacteria	9876	P	613	12	625	0.00006
SRR6945416_1_kneaddata_paired	Spirochaetota	32587	P	398	0	398	0.00004
SRR6945416_1_kneaddata_paired	Firmicutes_I	18140	P	80	0	80	0.00001
SRR6945416_1_kneaddata_paired	Thermotogota	33086	P	51	0	51	0.00001
SRR6945416_1_kneaddata_paired	Firmicutes_C	17613	P	8	0	8	0.00000
SRR6945416_1_kneaddata_paired	Firmicutes_B	17289	P	3	0	3	0.00000
SRR6945416_1_kneaddata_paired	Elusimicrobiota	11888	P	2	0	2	0.00000
SRR7533631_1_kneaddata_paired	Bacteroidota	4587	P	11169188	46661	11215849	0.63022
SRR7533631_1_kneaddata_paired	Firmicutes_A	14608	P	5178914	31456	5210370	0.29277
SRR7533631_1_kneaddata_paired	Firmicutes	12188	P	878348	7925	886273	0.04980
SRR7533631_1_kneaddata_paired	Proteobacteria	22518	P	205930	226	206156	0.01158
SRR7533631_1_kneaddata_paired	Campylobacterota	8700	P	92954	26	92980	0.00522
SRR7533631_1_kneaddata_paired	Actinobacteriota	615	P	90091	317	90408	0.00508
SRR7533631_1_kneaddata_paired	Desulfobacterota_A	11509	P	42256	194	42450	0.00239
SRR7533631_1_kneaddata_paired	Firmicutes_C	17613	P	33791	78	33869	0.00190
SRR7533631_1_kneaddata_paired	Cyanobacteria	9876	P	15678	249	15927	0.00089
SRR7533631_1_kneaddata_paired	Deferribacterota	10822	P	782	0	782	0.00004
SRR7533631_1_kneaddata_paired	Verrucomicrobiota	33333	P	592	16	608	0.00003
SRR7533631_1_kneaddata_paired	Spirochaetota	32587	P	331	0	331	0.00002
SRR7533631_1_kneaddata_paired	Firmicutes_B	17289	P	294	11	305	0.00002
SRR7533631_1_kneaddata_paired	Firmicutes_I	18140	P	193	0	193	0.00001
SRR7533631_1_kneaddata_paired	Thermotogota	33086	P	141	0	141	0.00001
SRR7533631_1_kneaddata_paired	Elusimicrobiota	11888	P	13	0	13	0.00000
SRR7533632_1_kneaddata_paired	Bacteroidota	4587	P	8776498	39745	8816243	0.61282
SRR7533632_1_kneaddata_paired	Firmicutes_A	14608	P	4878651	20708	4899359	0.34056
SRR7533632_1_kneaddata_paired	Firmicutes	12188	P	310342	3224	313566	0.02180
SRR7533632_1_kneaddata_paired	Desulfobacterota_A	11509	P	127916	752	128668	0.00894
SRR7533632_1_kneaddata_paired	Proteobacteria	22518	P	97642	130	97772	0.00680
SRR7533632_1_kneaddata_paired	Actinobacteriota	615	P	69051	181	69232	0.00481
SRR7533632_1_kneaddata_paired	Campylobacterota	8700	P	39691	1	39692	0.00276
SRR7533632_1_kneaddata_paired	Cyanobacteria	9876	P	15017	219	15236	0.00106
SRR7533632_1_kneaddata_paired	Deferribacterota	10822	P	3404	0	3404	0.00024
SRR7533632_1_kneaddata_paired	Verrucomicrobiota	33333	P	1853	21	1874	0.00013
SRR7533632_1_kneaddata_paired	Firmicutes_C	17613	P	368	0	368	0.00003
SRR7533632_1_kneaddata_paired	Firmicutes_B	17289	P	332	11	343	0.00002
SRR7533632_1_kneaddata_paired	Spirochaetota	32587	P	285	0	285	0.00002
SRR7533632_1_kneaddata_paired	Firmicutes_I	18140	P	164	0	164	0.00001
SRR7533632_1_kneaddata_paired	Elusimicrobiota	11888	P	49	0	49	0.00000
SRR7533632_1_kneaddata_paired	Thermotogota	33086	P	35	0	35	0.00000
SRR7533633_1_kneaddata_paired	Bacteroidota	4587	P	6876866	34989	6911855	0.50903
SRR7533633_1_kneaddata_paired	Firmicutes_A	14608	P	5655455	27270	5682725	0.41851
SRR7533633_1_kneaddata_paired	Verrucomicrobiota	33333	P	439218	3729	442947	0.03262
SRR7533633_1_kneaddata_paired	Desulfobacterota_A	11509	P	143953	1073	145026	0.01068
SRR7533633_1_kneaddata_paired	Firmicutes	12188	P	140421	1666	142087	0.01046
SRR7533633_1_kneaddata_paired	Proteobacteria	22518	P	101970	145	102115	0.00752
SRR7533633_1_kneaddata_paired	Campylobacterota	8700	P	83964	26	83990	0.00619
SRR7533633_1_kneaddata_paired	Actinobacteriota	615	P	38302	137	38439	0.00283
SRR7533633_1_kneaddata_paired	Cyanobacteria	9876	P	15679	106	15785	0.00116
SRR7533633_1_kneaddata_paired	Deferribacterota	10822	P	11960	1	11961	0.00088
SRR7533633_1_kneaddata_paired	Spirochaetota	32587	P	544	1	545	0.00004
SRR7533633_1_kneaddata_paired	Firmicutes_C	17613	P	494	1	495	0.00004
SRR7533633_1_kneaddata_paired	Firmicutes_B	17289	P	328	11	339	0.00003
SRR7533633_1_kneaddata_paired	Firmicutes_I	18140	P	178	0	178	0.00001
SRR7533633_1_kneaddata_paired	Thermotogota	33086	P	56	0	56	0.00000
SRR7533633_1_kneaddata_paired	Elusimicrobiota	11888	P	17	0	17	0.00000
SRR7533634_1_kneaddata_paired	Bacteroidota	4587	P	7623342	42953	7666295	0.46592
SRR7533634_1_kneaddata_paired	Firmicutes_A	14608	P	7541041	31649	7572690	0.46023
SRR7533634_1_kneaddata_paired	Campylobacterota	8700	P	365277	43	365320	0.02220
SRR7533634_1_kneaddata_paired	Desulfobacterota_A	11509	P	222882	709	223591	0.01359
SRR7533634_1_kneaddata_paired	Firmicutes	12188	P	205249	1838	207087	0.01259
SRR7533634_1_kneaddata_paired	Actinobacteriota	615	P	113911	133	114044	0.00693
SRR7533634_1_kneaddata_paired	Firmicutes_C	17613	P	98816	143	98959	0.00601
SRR7533634_1_kneaddata_paired	Deferribacterota	10822	P	91895	231	92126	0.00560
SRR7533634_1_kneaddata_paired	Proteobacteria	22518	P	88836	85	88921	0.00540
SRR7533634_1_kneaddata_paired	Cyanobacteria	9876	P	22170	642	22812	0.00139
SRR7533634_1_kneaddata_paired	Verrucomicrobiota	33333	P	784	14	798	0.00005
SRR7533634_1_kneaddata_paired	Spirochaetota	32587	P	622	0	622	0.00004
SRR7533634_1_kneaddata_paired	Firmicutes_B	17289	P	337	8	345	0.00002
SRR7533634_1_kneaddata_paired	Firmicutes_I	18140	P	244	0	244	0.00001
SRR7533634_1_kneaddata_paired	Thermotogota	33086	P	144	0	144	0.00001
SRR7533634_1_kneaddata_paired	Elusimicrobiota	11888	P	46	0	46	0.00000
SRR7533635_1_kneaddata_paired	Firmicutes_A	14608	P	8773038	33953	8806991	0.59687
SRR7533635_1_kneaddata_paired	Bacteroidota	4587	P	5062875	25020	5087895	0.34482
SRR7533635_1_kneaddata_paired	Actinobacteriota	615	P	273207	339	273546	0.01854
SRR7533635_1_kneaddata_paired	Firmicutes	12188	P	165450	1593	167043	0.01132
SRR7533635_1_kneaddata_paired	Desulfobacterota_A	11509	P	162281	334	162615	0.01102
SRR7533635_1_kneaddata_paired	Campylobacterota	8700	P	106191	8	106199	0.00720
SRR7533635_1_kneaddata_paired	Firmicutes_C	17613	P	74233	95	74328	0.00504
SRR7533635_1_kneaddata_paired	Proteobacteria	22518	P	51086	38	51124	0.00346
SRR7533635_1_kneaddata_paired	Deferribacterota	10822	P	18278	39	18317	0.00124
SRR7533635_1_kneaddata_paired	Cyanobacteria	9876	P	5162	128	5290	0.00036
SRR7533635_1_kneaddata_paired	Verrucomicrobiota	33333	P	917	9	926	0.00006
SRR7533635_1_kneaddata_paired	Spirochaetota	32587	P	550	0	550	0.00004
SRR7533635_1_kneaddata_paired	Firmicutes_B	17289	P	207	4	211	0.00001
SRR7533635_1_kneaddata_paired	Firmicutes_I	18140	P	200	0	200	0.00001
SRR7533635_1_kneaddata_paired	Thermotogota	33086	P	117	0	117	0.00001
SRR7533635_1_kneaddata_paired	Elusimicrobiota	11888	P	23	0	23	0.00000
SRR7533636_1_kneaddata_paired	Bacteroidota	4587	P	8544541	36050	8580591	0.68522
SRR7533636_1_kneaddata_paired	Firmicutes_A	14608	P	3131649	16103	3147752	0.25137
SRR7533636_1_kneaddata_paired	Firmicutes	12188	P	467867	995	468862	0.03744
SRR7533636_1_kneaddata_paired	Actinobacteriota	615	P	169553	378	169931	0.01357
SRR7533636_1_kneaddata_paired	Proteobacteria	22518	P	75038	95	75133	0.00600
SRR7533636_1_kneaddata_paired	Campylobacterota	8700	P	37179	1	37180	0.00297
SRR7533636_1_kneaddata_paired	Desulfobacterota_A	11509	P	32718	256	32974	0.00263
SRR7533636_1_kneaddata_paired	Cyanobacteria	9876	P	4656	72	4728	0.00038
SRR7533636_1_kneaddata_paired	Deferribacterota	10822	P	1861	1	1862	0.00015
SRR7533636_1_kneaddata_paired	Verrucomicrobiota	33333	P	1824	19	1843	0.00015
SRR7533636_1_kneaddata_paired	Firmicutes_C	17613	P	979	1	980	0.00008
SRR7533636_1_kneaddata_paired	Firmicutes_B	17289	P	198	6	204	0.00002
SRR7533636_1_kneaddata_paired	Spirochaetota	32587	P	163	0	163	0.00001
SRR7533636_1_kneaddata_paired	Firmicutes_I	18140	P	148	0	148	0.00001
SRR7533636_1_kneaddata_paired	Thermotogota	33086	P	28	0	28	0.00000
SRR7533636_1_kneaddata_paired	Elusimicrobiota	11888	P	18	0	18	0.00000
SRR7533637_1_kneaddata_paired	Bacteroidota	4587	P	9183641	36589	9220230	0.55766
SRR7533637_1_kneaddata_paired	Firmicutes_A	14608	P	4616063	28483	4644546	0.28091
SRR7533637_1_kneaddata_paired	Firmicutes	12188	P	1977568	15215	1992783	0.12053
SRR7533637_1_kneaddata_paired	Proteobacteria	22518	P	345095	293	345388	0.02089
SRR7533637_1_kneaddata_paired	Actinobacteriota	615	P	197323	619	197942	0.01197
SRR7533637_1_kneaddata_paired	Desulfobacterota_A	11509	P	59315	179	59494	0.00360
SRR7533637_1_kneaddata_paired	Campylobacterota	8700	P	31437	20	31457	0.00190
SRR7533637_1_kneaddata_paired	Firmicutes_C	17613	P	30298	67	30365	0.00184
SRR7533637_1_kneaddata_paired	Cyanobacteria	9876	P	8254	154	8408	0.00051
SRR7533637_1_kneaddata_paired	Deferribacterota	10822	P	1480	0	1480	0.00009
SRR7533637_1_kneaddata_paired	Verrucomicrobiota	33333	P	763	16	779	0.00005
SRR7533637_1_kneaddata_paired	Spirochaetota	32587	P	373	0	373	0.00002
SRR7533637_1_kneaddata_paired	Firmicutes_B	17289	P	234	8	242	0.00001
SRR7533637_1_kneaddata_paired	Firmicutes_I	18140	P	199	0	199	0.00001
SRR7533637_1_kneaddata_paired	Thermotogota	33086	P	113	0	113	0.00001
SRR7533637_1_kneaddata_paired	Elusimicrobiota	11888	P	18	0	18	0.00000
SRR7533638_1_kneaddata_paired	Bacteroidota	4587	P	12562512	54293	12616805	0.59720
SRR7533638_1_kneaddata_paired	Firmicutes_A	14608	P	7026034	39772	7065806	0.33445
SRR7533638_1_kneaddata_paired	Firmicutes	12188	P	474839	3638	478477	0.02265
SRR7533638_1_kneaddata_paired	Desulfobacterota_A	11509	P	349549	1667	351216	0.01662
SRR7533638_1_kneaddata_paired	Campylobacterota	8700	P	283171	5	283176	0.01340
SRR7533638_1_kneaddata_paired	Proteobacteria	22518	P	178809	272	179081	0.00848
SRR7533638_1_kneaddata_paired	Actinobacteriota	615	P	83112	203	83315	0.00394
SRR7533638_1_kneaddata_paired	Deferribacterota	10822	P	55091	7	55098	0.00261
SRR7533638_1_kneaddata_paired	Cyanobacteria	9876	P	10181	144	10325	0.00049
SRR7533638_1_kneaddata_paired	Spirochaetota	32587	P	1329	1	1330	0.00006
SRR7533638_1_kneaddata_paired	Firmicutes_B	17289	P	610	24	634	0.00003
SRR7533638_1_kneaddata_paired	Verrucomicrobiota	33333	P	559	19	578	0.00003
SRR7533638_1_kneaddata_paired	Firmicutes_C	17613	P	270	0	270	0.00001
SRR7533638_1_kneaddata_paired	Firmicutes_I	18140	P	263	0	263	0.00001
SRR7533638_1_kneaddata_paired	Thermotogota	33086	P	46	0	46	0.00000
SRR7533638_1_kneaddata_paired	Elusimicrobiota	11888	P	23	0	23	0.00000
SRR7533639_1_kneaddata_paired	Bacteroidota	4587	P	14524645	70420	14595065	0.73380
SRR7533639_1_kneaddata_paired	Firmicutes_A	14608	P	4256186	27287	4283473	0.21536
SRR7533639_1_kneaddata_paired	Campylobacterota	8700	P	290781	71	290852	0.01462
SRR7533639_1_kneaddata_paired	Proteobacteria	22518	P	283255	348	283603	0.01426
SRR7533639_1_kneaddata_paired	Firmicutes	12188	P	200015	1444	201459	0.01013
SRR7533639_1_kneaddata_paired	Actinobacteriota	615	P	143516	688	144204	0.00725
SRR7533639_1_kneaddata_paired	Desulfobacterota_A	11509	P	66189	519	66708	0.00335
SRR7533639_1_kneaddata_paired	Cyanobacteria	9876	P	11535	420	11955	0.00060
SRR7533639_1_kneaddata_paired	Deferribacterota	10822	P	9876	2	9878	0.00050
SRR7533639_1_kneaddata_paired	Firmicutes_C	17613	P	705	1	706	0.00004
SRR7533639_1_kneaddata_paired	Verrucomicrobiota	33333	P	692	12	704	0.00004
SRR7533639_1_kneaddata_paired	Firmicutes_B	17289	P	334	12	346	0.00002
SRR7533639_1_kneaddata_paired	Spirochaetota	32587	P	327	0	327	0.00002
SRR7533639_1_kneaddata_paired	Thermotogota	33086	P	151	0	151	0.00001
SRR7533639_1_kneaddata_paired	Firmicutes_I	18140	P	119	0	119	0.00001
SRR7533639_1_kneaddata_paired	Elusimicrobiota	11888	P	18	0	18	0.00000
SRR7533640_1_kneaddata_paired	Firmicutes_A	14608	P	11946317	59881	12006198	0.48407
SRR7533640_1_kneaddata_paired	Bacteroidota	4587	P	11686952	46335	11733287	0.47307
SRR7533640_1_kneaddata_paired	Campylobacterota	8700	P	436673	32	436705	0.01761
SRR7533640_1_kneaddata_paired	Firmicutes	12188	P	190974	2495	193469	0.00780
SRR7533640_1_kneaddata_paired	Desulfobacterota_A	11509	P	146208	612	146820	0.00592
SRR7533640_1_kneaddata_paired	Firmicutes_C	17613	P	103269	173	103442	0.00417
SRR7533640_1_kneaddata_paired	Actinobacteriota	615	P	77622	220	77842	0.00314
SRR7533640_1_kneaddata_paired	Deferribacterota	10822	P	50465	6	50471	0.00203
SRR7533640_1_kneaddata_paired	Proteobacteria	22518	P	42315	69	42384	0.00171
SRR7533640_1_kneaddata_paired	Cyanobacteria	9876	P	6818	159	6977	0.00028
SRR7533640_1_kneaddata_paired	Spirochaetota	32587	P	2903	2	2905	0.00012
SRR7533640_1_kneaddata_paired	Verrucomicrobiota	33333	P	1034	28	1062	0.00004
SRR7533640_1_kneaddata_paired	Firmicutes_B	17289	P	530	15	545	0.00002
SRR7533640_1_kneaddata_paired	Firmicutes_I	18140	P	225	0	225	0.00001
SRR7533640_1_kneaddata_paired	Thermotogota	33086	P	175	0	175	0.00001
SRR7533640_1_kneaddata_paired	Elusimicrobiota	11888	P	36	0	36	0.00000
SRR7533641_1_kneaddata_paired	Firmicutes_A	14608	P	18732358	142055	18874413	0.49859
SRR7533641_1_kneaddata_paired	Bacteroidota	4587	P	15782693	141990	15924683	0.42067
SRR7533641_1_kneaddata_paired	Firmicutes	12188	P	2304190	17151	2321341	0.06132
SRR7533641_1_kneaddata_paired	Desulfobacterota_A	11509	P	195623	2214	197837	0.00523
SRR7533641_1_kneaddata_paired	Actinobacteriota	615	P	193246	760	194006	0.00512
SRR7533641_1_kneaddata_paired	Campylobacterota	8700	P	155300	3	155303	0.00410
SRR7533641_1_kneaddata_paired	Proteobacteria	22518	P	122222	264	122486	0.00324
SRR7533641_1_kneaddata_paired	Deferribacterota	10822	P	51476	8	51484	0.00136
SRR7533641_1_kneaddata_paired	Cyanobacteria	9876	P	9851	385	10236	0.00027
SRR7533641_1_kneaddata_paired	Spirochaetota	32587	P	1223	3	1226	0.00003
SRR7533641_1_kneaddata_paired	Firmicutes_B	17289	P	856	36	892	0.00002
SRR7533641_1_kneaddata_paired	Verrucomicrobiota	33333	P	755	21	776	0.00002
SRR7533641_1_kneaddata_paired	Firmicutes_I	18140	P	451	0	451	0.00001
SRR7533641_1_kneaddata_paired	Firmicutes_C	17613	P	406	1	407	0.00001
SRR7533641_1_kneaddata_paired	Thermotogota	33086	P	267	0	267	0.00001
SRR7533641_1_kneaddata_paired	Elusimicrobiota	11888	P	43	0	43	0.00000
SRR7533642_1_kneaddata_paired	Bacteroidota	4587	P	27111376	120525	27231901	0.52359
SRR7533642_1_kneaddata_paired	Firmicutes_A	14608	P	18856044	102949	18958993	0.36453
SRR7533642_1_kneaddata_paired	Firmicutes	12188	P	4621916	28037	4649953	0.08941
SRR7533642_1_kneaddata_paired	Actinobacteriota	615	P	338425	785	339210	0.00652
SRR7533642_1_kneaddata_paired	Desulfobacterota_A	11509	P	305266	1747	307013	0.00590
SRR7533642_1_kneaddata_paired	Campylobacterota	8700	P	279273	5	279278	0.00537
SRR7533642_1_kneaddata_paired	Proteobacteria	22518	P	160497	312	160809	0.00309
SRR7533642_1_kneaddata_paired	Deferribacterota	10822	P	47427	5	47432	0.00091
SRR7533642_1_kneaddata_paired	Cyanobacteria	9876	P	29394	481	29875	0.00057
SRR7533642_1_kneaddata_paired	Firmicutes_B	17289	P	1532	50	1582	0.00003
SRR7533642_1_kneaddata_paired	Verrucomicrobiota	33333	P	1531	45	1576	0.00003
SRR7533642_1_kneaddata_paired	Spirochaetota	32587	P	819	1	820	0.00002
SRR7533642_1_kneaddata_paired	Firmicutes_I	18140	P	735	0	735	0.00001
SRR7533642_1_kneaddata_paired	Firmicutes_C	17613	P	432	0	432	0.00001
SRR7533642_1_kneaddata_paired	Thermotogota	33086	P	137	0	137	0.00000
SRR7533642_1_kneaddata_paired	Elusimicrobiota	11888	P	63	0	63	0.00000
SRR7533643_1_kneaddata_paired	Bacteroidota	4587	P	18479448	94240	18573688	0.74371
SRR7533643_1_kneaddata_paired	Firmicutes_A	14608	P	3653754	21260	3675014	0.14715
SRR7533643_1_kneaddata_paired	Firmicutes	12188	P	2277106	25966	2303072	0.09222
SRR7533643_1_kneaddata_paired	Proteobacteria	22518	P	199930	319	200249	0.00802
SRR7533643_1_kneaddata_paired	Actinobacteriota	615	P	120725	313	121038	0.00485
SRR7533643_1_kneaddata_paired	Campylobacterota	8700	P	34633	2	34635	0.00139
SRR7533643_1_kneaddata_paired	Cyanobacteria	9876	P	29758	560	30318	0.00121
SRR7533643_1_kneaddata_paired	Desulfobacterota_A	11509	P	25386	179	25565	0.00102
SRR7533643_1_kneaddata_paired	Deferribacterota	10822	P	8526	1	8527	0.00034
SRR7533643_1_kneaddata_paired	Verrucomicrobiota	33333	P	670	10	680	0.00003
SRR7533643_1_kneaddata_paired	Spirochaetota	32587	P	567	1	568	0.00002
SRR7533643_1_kneaddata_paired	Firmicutes_B	17289	P	510	16	526	0.00002
SRR7533643_1_kneaddata_paired	Firmicutes_C	17613	P	191	0	191	0.00001
SRR7533643_1_kneaddata_paired	Firmicutes_I	18140	P	191	0	191	0.00001
SRR7533643_1_kneaddata_paired	Thermotogota	33086	P	128	0	128	0.00001
SRR7533643_1_kneaddata_paired	Elusimicrobiota	11888	P	38	0	38	0.00000
SRR7533644_1_kneaddata_paired	Bacteroidota	4587	P	8418075	25691	8443766	0.54658
SRR7533644_1_kneaddata_paired	Firmicutes_A	14608	P	6350939	36151	6387090	0.41345
SRR7533644_1_kneaddata_paired	Firmicutes	12188	P	237869	2356	240225	0.01555
SRR7533644_1_kneaddata_paired	Actinobacteriota	615	P	104438	290	104728	0.00678
SRR7533644_1_kneaddata_paired	Desulfobacterota_A	11509	P	95599	545	96144	0.00622
SRR7533644_1_kneaddata_paired	Proteobacteria	22518	P	88771	115	88886	0.00575
SRR7533644_1_kneaddata_paired	Campylobacterota	8700	P	71062	1	71063	0.00460
SRR7533644_1_kneaddata_paired	Deferribacterota	10822	P	9624	1	9625	0.00062
SRR7533644_1_kneaddata_paired	Cyanobacteria	9876	P	4340	42	4382	0.00028
SRR7533644_1_kneaddata_paired	Verrucomicrobiota	33333	P	1076	17	1093	0.00007
SRR7533644_1_kneaddata_paired	Firmicutes_B	17289	P	381	12	393	0.00003
SRR7533644_1_kneaddata_paired	Firmicutes_C	17613	P	378	0	378	0.00002
SRR7533644_1_kneaddata_paired	Spirochaetota	32587	P	240	0	240	0.00002
SRR7533644_1_kneaddata_paired	Firmicutes_I	18140	P	140	0	140	0.00001
SRR7533644_1_kneaddata_paired	Thermotogota	33086	P	88	0	88	0.00001
SRR7533644_1_kneaddata_paired	Elusimicrobiota	11888	P	15	0	15	0.00000
SRR7691143_1_kneaddata_paired	Bacteroidota	4587	P	2424433	12011	2436444	0.52217
SRR7691143_1_kneaddata_paired	Firmicutes_A	14608	P	1893361	9260	1902621	0.40776
SRR7691143_1_kneaddata_paired	Actinobacteriota	615	P	103745	67	103812	0.02225
SRR7691143_1_kneaddata_paired	Verrucomicrobiota	33333	P	91414	4345	95759	0.02052
SRR7691143_1_kneaddata_paired	Proteobacteria	22518	P	55986	81	56067	0.01202
SRR7691143_1_kneaddata_paired	Firmicutes	12188	P	36164	266	36430	0.00781
SRR7691143_1_kneaddata_paired	Desulfobacterota_A	11509	P	29269	89	29358	0.00629
SRR7691143_1_kneaddata_paired	Cyanobacteria	9876	P	4410	19	4429	0.00095
SRR7691143_1_kneaddata_paired	Deferribacterota	10822	P	797	2	799	0.00017
SRR7691143_1_kneaddata_paired	Firmicutes_B	17289	P	164	4	168	0.00004
SRR7691143_1_kneaddata_paired	Campylobacterota	8700	P	41	0	41	0.00001
SRR7691143_1_kneaddata_paired	Firmicutes_I	18140	P	39	0	39	0.00001
SRR7691143_1_kneaddata_paired	Spirochaetota	32587	P	21	0	21	0.00000
SRR7691143_1_kneaddata_paired	Firmicutes_C	17613	P	15	0	15	0.00000
SRR7691143_1_kneaddata_paired	Thermotogota	33086	P	3	0	3	0.00000
SRR7691143_1_kneaddata_paired	Elusimicrobiota	11888	P	1	0	1	0.00000
SRR7691144_1_kneaddata_paired	Bacteroidota	4587	P	2466172	12571	2478743	0.64313
SRR7691144_1_kneaddata_paired	Firmicutes_A	14608	P	1080570	6250	1086820	0.28198
SRR7691144_1_kneaddata_paired	Verrucomicrobiota	33333	P	92327	4518	96845	0.02513
SRR7691144_1_kneaddata_paired	Actinobacteriota	615	P	69512	50	69562	0.01805
SRR7691144_1_kneaddata_paired	Proteobacteria	22518	P	64202	87	64289	0.01668
SRR7691144_1_kneaddata_paired	Firmicutes	12188	P	35304	281	35585	0.00923
SRR7691144_1_kneaddata_paired	Desulfobacterota_A	11509	P	15143	54	15197	0.00394
SRR7691144_1_kneaddata_paired	Cyanobacteria	9876	P	5073	26	5099	0.00132
SRR7691144_1_kneaddata_paired	Deferribacterota	10822	P	1852	5	1857	0.00048
SRR7691144_1_kneaddata_paired	Firmicutes_B	17289	P	74	2	76	0.00002
SRR7691144_1_kneaddata_paired	Campylobacterota	8700	P	54	0	54	0.00001
SRR7691144_1_kneaddata_paired	Firmicutes_I	18140	P	39	0	39	0.00001
SRR7691144_1_kneaddata_paired	Spirochaetota	32587	P	25	0	25	0.00001
SRR7691144_1_kneaddata_paired	Firmicutes_C	17613	P	14	0	14	0.00000
SRR7691144_1_kneaddata_paired	Thermotogota	33086	P	4	0	4	0.00000
SRR7691144_1_kneaddata_paired	Elusimicrobiota	11888	P	3	0	3	0.00000
SRR7691145_1_kneaddata_paired	Bacteroidota	4587	P	3873455	15282	3888737	0.67367
SRR7691145_1_kneaddata_paired	Firmicutes_A	14608	P	1546641	10196	1556837	0.26970
SRR7691145_1_kneaddata_paired	Verrucomicrobiota	33333	P	141830	7699	149529	0.02590
SRR7691145_1_kneaddata_paired	Proteobacteria	22518	P	122796	543	123339	0.02137
SRR7691145_1_kneaddata_paired	Desulfobacterota_A	11509	P	21412	59	21471	0.00372
SRR7691145_1_kneaddata_paired	Firmicutes	12188	P	13100	179	13279	0.00230
SRR7691145_1_kneaddata_paired	Actinobacteriota	615	P	12388	16	12404	0.00215
SRR7691145_1_kneaddata_paired	Cyanobacteria	9876	P	6136	23	6159	0.00107
SRR7691145_1_kneaddata_paired	Deferribacterota	10822	P	357	1	358	0.00006
SRR7691145_1_kneaddata_paired	Firmicutes_B	17289	P	123	4	127	0.00002
SRR7691145_1_kneaddata_paired	Campylobacterota	8700	P	112	0	112	0.00002
SRR7691145_1_kneaddata_paired	Spirochaetota	32587	P	50	0	50	0.00001
SRR7691145_1_kneaddata_paired	Firmicutes_I	18140	P	38	0	38	0.00001
SRR7691145_1_kneaddata_paired	Firmicutes_C	17613	P	26	0	26	0.00000
SRR7691145_1_kneaddata_paired	Elusimicrobiota	11888	P	19	0	19	0.00000
SRR7691145_1_kneaddata_paired	Thermotogota	33086	P	7	0	7	0.00000
SRR7691146_1_kneaddata_paired	Firmicutes_A	14608	P	2082437	14716	2097153	0.50348
SRR7691146_1_kneaddata_paired	Bacteroidota	4587	P	1970828	11620	1982448	0.47594
SRR7691146_1_kneaddata_paired	Proteobacteria	22518	P	22802	89	22891	0.00550
SRR7691146_1_kneaddata_paired	Desulfobacterota_A	11509	P	20010	94	20104	0.00483
SRR7691146_1_kneaddata_paired	Cyanobacteria	9876	P	15663	126	15789	0.00379
SRR7691146_1_kneaddata_paired	Firmicutes	12188	P	14882	362	15244	0.00366
SRR7691146_1_kneaddata_paired	Verrucomicrobiota	33333	P	5980	394	6374	0.00153
SRR7691146_1_kneaddata_paired	Deferribacterota	10822	P	3361	14	3375	0.00081
SRR7691146_1_kneaddata_paired	Actinobacteriota	615	P	1525	4	1529	0.00037
SRR7691146_1_kneaddata_paired	Firmicutes_B	17289	P	225	9	234	0.00006
SRR7691146_1_kneaddata_paired	Campylobacterota	8700	P	59	0	59	0.00001
SRR7691146_1_kneaddata_paired	Spirochaetota	32587	P	49	0	49	0.00001
SRR7691146_1_kneaddata_paired	Firmicutes_I	18140	P	35	0	35	0.00001
SRR7691146_1_kneaddata_paired	Firmicutes_C	17613	P	29	0	29	0.00001
SRR7691146_1_kneaddata_paired	Thermotogota	33086	P	25	0	25	0.00001
SRR7691146_1_kneaddata_paired	Elusimicrobiota	11888	P	4	0	4	0.00000
SRR7691147_1_kneaddata_paired	Bacteroidota	4587	P	6835739	52377	6888116	0.82624
SRR7691147_1_kneaddata_paired	Firmicutes_A	14608	P	1147272	16955	1164227	0.13965
SRR7691147_1_kneaddata_paired	Proteobacteria	22518	P	151746	786	152532	0.01830
SRR7691147_1_kneaddata_paired	Cyanobacteria	9876	P	62573	426	62999	0.00756
SRR7691147_1_kneaddata_paired	Firmicutes	12188	P	36769	581	37350	0.00448
SRR7691147_1_kneaddata_paired	Verrucomicrobiota	33333	P	14015	1301	15316	0.00184
SRR7691147_1_kneaddata_paired	Actinobacteriota	615	P	6665	17	6682	0.00080
SRR7691147_1_kneaddata_paired	Deferribacterota	10822	P	5047	30	5077	0.00061
SRR7691147_1_kneaddata_paired	Desulfobacterota_A	11509	P	3887	58	3945	0.00047
SRR7691147_1_kneaddata_paired	Campylobacterota	8700	P	186	0	186	0.00002
SRR7691147_1_kneaddata_paired	Firmicutes_B	17289	P	171	10	181	0.00002
SRR7691147_1_kneaddata_paired	Spirochaetota	32587	P	61	0	61	0.00001
SRR7691147_1_kneaddata_paired	Firmicutes_I	18140	P	46	0	46	0.00001
SRR7691147_1_kneaddata_paired	Firmicutes_C	17613	P	20	0	20	0.00000
SRR7691147_1_kneaddata_paired	Thermotogota	33086	P	6	0	6	0.00000
SRR7691147_1_kneaddata_paired	Elusimicrobiota	11888	P	3	0	3	0.00000
SRR7691148_1_kneaddata_paired	Bacteroidota	4587	P	2440722	20889	2461611	0.60078
SRR7691148_1_kneaddata_paired	Firmicutes_A	14608	P	1379268	14111	1393379	0.34007
SRR7691148_1_kneaddata_paired	Verrucomicrobiota	33333	P	73662	6704	80366	0.01961
SRR7691148_1_kneaddata_paired	Firmicutes	12188	P	64627	931	65558	0.01600
SRR7691148_1_kneaddata_paired	Proteobacteria	22518	P	41549	255	41804	0.01020
SRR7691148_1_kneaddata_paired	Cyanobacteria	9876	P	36952	238	37190	0.00908
SRR7691148_1_kneaddata_paired	Desulfobacterota_A	11509	P	10574	62	10636	0.00260
SRR7691148_1_kneaddata_paired	Deferribacterota	10822	P	4462	26	4488	0.00110
SRR7691148_1_kneaddata_paired	Actinobacteriota	615	P	1925	5	1930	0.00047
SRR7691148_1_kneaddata_paired	Campylobacterota	8700	P	160	0	160	0.00004
SRR7691148_1_kneaddata_paired	Spirochaetota	32587	P	87	0	87	0.00002
SRR7691148_1_kneaddata_paired	Firmicutes_B	17289	P	84	4	88	0.00002
SRR7691148_1_kneaddata_paired	Firmicutes_I	18140	P	39	0	39	0.00001
SRR7691148_1_kneaddata_paired	Firmicutes_C	17613	P	13	0	13	0.00000
SRR7691148_1_kneaddata_paired	Thermotogota	33086	P	9	0	9	0.00000
SRR7691148_1_kneaddata_paired	Elusimicrobiota	11888	P	2	0	2	0.00000
SRR7691149_1_kneaddata_paired	Firmicutes_A	14608	P	3257703	12789	3270492	0.51446
SRR7691149_1_kneaddata_paired	Bacteroidota	4587	P	2400394	10300	2410694	0.37921
SRR7691149_1_kneaddata_paired	Firmicutes	12188	P	158065	1460	159525	0.02509
SRR7691149_1_kneaddata_paired	Proteobacteria	22518	P	150316	529	150845	0.02373
SRR7691149_1_kneaddata_paired	Deferribacterota	10822	P	131928	405	132333	0.02082
SRR7691149_1_kneaddata_paired	Verrucomicrobiota	33333	P	122603	5819	128422	0.02020
SRR7691149_1_kneaddata_paired	Desulfobacterota_A	11509	P	57192	148	57340	0.00902
SRR7691149_1_kneaddata_paired	Cyanobacteria	9876	P	28060	100	28160	0.00443
SRR7691149_1_kneaddata_paired	Actinobacteriota	615	P	18358	16	18374	0.00289
SRR7691149_1_kneaddata_paired	Firmicutes_B	17289	P	332	9	341	0.00005
SRR7691149_1_kneaddata_paired	Campylobacterota	8700	P	245	0	245	0.00004
SRR7691149_1_kneaddata_paired	Spirochaetota	32587	P	177	0	177	0.00003
SRR7691149_1_kneaddata_paired	Firmicutes_I	18140	P	75	0	75	0.00001
SRR7691149_1_kneaddata_paired	Firmicutes_C	17613	P	56	0	56	0.00001
SRR7691149_1_kneaddata_paired	Thermotogota	33086	P	9	0	9	0.00000
SRR7691149_1_kneaddata_paired	Elusimicrobiota	11888	P	7	0	7	0.00000
SRR7691150_1_kneaddata_paired	Bacteroidota	4587	P	4452978	27008	4479986	0.82098
SRR7691150_1_kneaddata_paired	Firmicutes_A	14608	P	732038	10053	742091	0.13599
SRR7691150_1_kneaddata_paired	Proteobacteria	22518	P	81902	280	82182	0.01506
SRR7691150_1_kneaddata_paired	Verrucomicrobiota	33333	P	48421	3968	52389	0.00960
SRR7691150_1_kneaddata_paired	Firmicutes	12188	P	41793	501	42294	0.00775
SRR7691150_1_kneaddata_paired	Cyanobacteria	9876	P	39413	243	39656	0.00727
SRR7691150_1_kneaddata_paired	Deferribacterota	10822	P	6705	35	6740	0.00124
SRR7691150_1_kneaddata_paired	Actinobacteriota	615	P	6336	13	6349	0.00116
SRR7691150_1_kneaddata_paired	Desulfobacterota_A	11509	P	4762	44	4806	0.00088
SRR7691150_1_kneaddata_paired	Campylobacterota	8700	P	128	0	128	0.00002
SRR7691150_1_kneaddata_paired	Firmicutes_B	17289	P	104	5	109	0.00002
SRR7691150_1_kneaddata_paired	Spirochaetota	32587	P	72	0	72	0.00001
SRR7691150_1_kneaddata_paired	Firmicutes_I	18140	P	28	0	28	0.00001
SRR7691150_1_kneaddata_paired	Firmicutes_C	17613	P	13	0	13	0.00000
SRR7691150_1_kneaddata_paired	Thermotogota	33086	P	10	0	10	0.00000
SRR7691150_1_kneaddata_paired	Elusimicrobiota	11888	P	7	0	7	0.00000
SRR7691151_1_kneaddata_paired	Firmicutes_A	14608	P	4321171	36891	4358062	0.48582
SRR7691151_1_kneaddata_paired	Bacteroidota	4587	P	4124889	28451	4153340	0.46300
SRR7691151_1_kneaddata_paired	Deferribacterota	10822	P	120758	608	121366	0.01353
SRR7691151_1_kneaddata_paired	Firmicutes	12188	P	88677	1471	90148	0.01005
SRR7691151_1_kneaddata_paired	Cyanobacteria	9876	P	83354	460	83814	0.00934
SRR7691151_1_kneaddata_paired	Proteobacteria	22518	P	81726	485	82211	0.00916
SRR7691151_1_kneaddata_paired	Desulfobacterota_A	11509	P	52195	224	52419	0.00584
SRR7691151_1_kneaddata_paired	Verrucomicrobiota	33333	P	22750	1775	24525	0.00273
SRR7691151_1_kneaddata_paired	Actinobacteriota	615	P	3612	9	3621	0.00040
SRR7691151_1_kneaddata_paired	Firmicutes_B	17289	P	432	21	453	0.00005
SRR7691151_1_kneaddata_paired	Spirochaetota	32587	P	215	0	215	0.00002
SRR7691151_1_kneaddata_paired	Campylobacterota	8700	P	214	0	214	0.00002
SRR7691151_1_kneaddata_paired	Firmicutes_I	18140	P	81	0	81	0.00001
SRR7691151_1_kneaddata_paired	Firmicutes_C	17613	P	52	0	52	0.00001
SRR7691151_1_kneaddata_paired	Elusimicrobiota	11888	P	3	0	3	0.00000
SRR7691151_1_kneaddata_paired	Thermotogota	33086	P	2	0	2	0.00000
SRR7691152_1_kneaddata_paired	Bacteroidota	4587	P	5721851	34284	5756135	0.79722
SRR7691152_1_kneaddata_paired	Firmicutes_A	14608	P	946191	10691	956882	0.13253
SRR7691152_1_kneaddata_paired	Proteobacteria	22518	P	178869	839	179708	0.02489
SRR7691152_1_kneaddata_paired	Verrucomicrobiota	33333	P	158199	12014	170213	0.02357
SRR7691152_1_kneaddata_paired	Firmicutes	12188	P	69699	744	70443	0.00976
SRR7691152_1_kneaddata_paired	Cyanobacteria	9876	P	68765	390	69155	0.00958
SRR7691152_1_kneaddata_paired	Deferribacterota	10822	P	6626	31	6657	0.00092
SRR7691152_1_kneaddata_paired	Actinobacteriota	615	P	6223	13	6236	0.00086
SRR7691152_1_kneaddata_paired	Desulfobacterota_A	11509	P	3940	46	3986	0.00055
SRR7691152_1_kneaddata_paired	Campylobacterota	8700	P	393	0	393	0.00005
SRR7691152_1_kneaddata_paired	Spirochaetota	32587	P	205	0	205	0.00003
SRR7691152_1_kneaddata_paired	Firmicutes_B	17289	P	128	6	134	0.00002
SRR7691152_1_kneaddata_paired	Firmicutes_I	18140	P	47	0	47	0.00001
SRR7691152_1_kneaddata_paired	Firmicutes_C	17613	P	30	0	30	0.00000
SRR7691152_1_kneaddata_paired	Thermotogota	33086	P	10	0	10	0.00000
SRR7691152_1_kneaddata_paired	Elusimicrobiota	11888	P	3	0	3	0.00000
SRR7691153_1_kneaddata_paired	Bacteroidota	4587	P	1909734	6502	1916236	0.46545
SRR7691153_1_kneaddata_paired	Firmicutes_A	14608	P	1816794	8188	1824982	0.44329
SRR7691153_1_kneaddata_paired	Verrucomicrobiota	33333	P	123961	5801	129762	0.03152
SRR7691153_1_kneaddata_paired	Firmicutes	12188	P	93453	815	94268	0.02290
SRR7691153_1_kneaddata_paired	Proteobacteria	22518	P	88168	263	88431	0.02148
SRR7691153_1_kneaddata_paired	Actinobacteriota	615	P	18363	14	18377	0.00446
SRR7691153_1_kneaddata_paired	Deferribacterota	10822	P	15963	48	16011	0.00389
SRR7691153_1_kneaddata_paired	Desulfobacterota_A	11509	P	13603	66	13669	0.00332
SRR7691153_1_kneaddata_paired	Cyanobacteria	9876	P	11764	49	11813	0.00287
SRR7691153_1_kneaddata_paired	Firmicutes_B	17289	P	3050	90	3140	0.00076
SRR7691153_1_kneaddata_paired	Campylobacterota	8700	P	117	0	117	0.00003
SRR7691153_1_kneaddata_paired	Spirochaetota	32587	P	50	0	50	0.00001
SRR7691153_1_kneaddata_paired	Firmicutes_I	18140	P	46	0	46	0.00001
SRR7691153_1_kneaddata_paired	Firmicutes_C	17613	P	26	0	26	0.00001
SRR7691153_1_kneaddata_paired	Thermotogota	33086	P	5	0	5	0.00000
SRR7691153_1_kneaddata_paired	Elusimicrobiota	11888	P	4	0	4	0.00000
SRR7691154_1_kneaddata_paired	Bacteroidota	4587	P	2732368	5368	2737736	0.62931
SRR7691154_1_kneaddata_paired	Firmicutes_A	14608	P	1059504	10149	1069653	0.24587
SRR7691154_1_kneaddata_paired	Verrucomicrobiota	33333	P	293076	8606	301682	0.06935
SRR7691154_1_kneaddata_paired	Proteobacteria	22518	P	92296	165	92461	0.02125
SRR7691154_1_kneaddata_paired	Actinobacteriota	615	P	39690	15	39705	0.00913
SRR7691154_1_kneaddata_paired	Desulfobacterota_A	11509	P	36409	55	36464	0.00838
SRR7691154_1_kneaddata_paired	Firmicutes	12188	P	34067	204	34271	0.00788
SRR7691154_1_kneaddata_paired	Deferribacterota	10822	P	25389	48	25437	0.00585
SRR7691154_1_kneaddata_paired	Cyanobacteria	9876	P	12571	27	12598	0.00290
SRR7691154_1_kneaddata_paired	Campylobacterota	8700	P	147	0	147	0.00003
SRR7691154_1_kneaddata_paired	Firmicutes_B	17289	P	111	2	113	0.00003
SRR7691154_1_kneaddata_paired	Spirochaetota	32587	P	79	0	79	0.00002
SRR7691154_1_kneaddata_paired	Firmicutes_I	18140	P	28	0	28	0.00001
SRR7691154_1_kneaddata_paired	Firmicutes_C	17613	P	16	0	16	0.00000
SRR7691154_1_kneaddata_paired	Thermotogota	33086	P	4	0	4	0.00000
SRR7691154_1_kneaddata_paired	Elusimicrobiota	11888	P	1	0	1	0.00000
SRR7691155_1_kneaddata_paired	Bacteroidota	4587	P	2040192	3996	2044188	0.47010
SRR7691155_1_kneaddata_paired	Firmicutes_A	14608	P	1791133	13621	1804754	0.41504
SRR7691155_1_kneaddata_paired	Verrucomicrobiota	33333	P	194993	5321	200314	0.04607
SRR7691155_1_kneaddata_paired	Firmicutes	12188	P	104277	578	104855	0.02411
SRR7691155_1_kneaddata_paired	Proteobacteria	22518	P	92611	141	92752	0.02133
SRR7691155_1_kneaddata_paired	Desulfobacterota_A	11509	P	46590	71	46661	0.01073
SRR7691155_1_kneaddata_paired	Cyanobacteria	9876	P	20892	41	20933	0.00481
SRR7691155_1_kneaddata_paired	Deferribacterota	10822	P	19445	34	19479	0.00448
SRR7691155_1_kneaddata_paired	Actinobacteriota	615	P	13963	6	13969	0.00321
SRR7691155_1_kneaddata_paired	Firmicutes_B	17289	P	194	3	197	0.00005
SRR7691155_1_kneaddata_paired	Campylobacterota	8700	P	114	0	114	0.00003
SRR7691155_1_kneaddata_paired	Spirochaetota	32587	P	76	0	76	0.00002
SRR7691155_1_kneaddata_paired	Firmicutes_I	18140	P	33	0	33	0.00001
SRR7691155_1_kneaddata_paired	Firmicutes_C	17613	P	32	0	32	0.00001
SRR7691155_1_kneaddata_paired	Thermotogota	33086	P	5	0	5	0.00000
SRR7691155_1_kneaddata_paired	Elusimicrobiota	11888	P	3	0	3	0.00000
SRR7691156_1_kneaddata_paired	Bacteroidota	4587	P	3279437	19095	3298532	0.76464
SRR7691156_1_kneaddata_paired	Firmicutes_A	14608	P	773781	5639	779420	0.18068
SRR7691156_1_kneaddata_paired	Verrucomicrobiota	33333	P	94832	5171	100003	0.02318
SRR7691156_1_kneaddata_paired	Proteobacteria	22518	P	80218	119	80337	0.01862
SRR7691156_1_kneaddata_paired	Actinobacteriota	615	P	21641	18	21659	0.00502
SRR7691156_1_kneaddata_paired	Firmicutes	12188	P	15539	172	15711	0.00364
SRR7691156_1_kneaddata_paired	Desulfobacterota_A	11509	P	14603	46	14649	0.00340
SRR7691156_1_kneaddata_paired	Cyanobacteria	9876	P	2978	14	2992	0.00069
SRR7691156_1_kneaddata_paired	Deferribacterota	10822	P	371	1	372	0.00009
SRR7691156_1_kneaddata_paired	Firmicutes_B	17289	P	59	2	61	0.00001
SRR7691156_1_kneaddata_paired	Campylobacterota	8700	P	33	0	33	0.00001
SRR7691156_1_kneaddata_paired	Firmicutes_I	18140	P	18	0	18	0.00000
SRR7691156_1_kneaddata_paired	Spirochaetota	32587	P	18	0	18	0.00000
SRR7691156_1_kneaddata_paired	Firmicutes_C	17613	P	11	0	11	0.00000
SRR7691156_1_kneaddata_paired	Thermotogota	33086	P	1	0	1	0.00000
SRR7691157_1_kneaddata_paired	Bacteroidota	4587	P	6720148	31740	6751888	0.74230
SRR7691157_1_kneaddata_paired	Firmicutes_A	14608	P	1783811	13960	1797771	0.19765
SRR7691157_1_kneaddata_paired	Proteobacteria	22518	P	237180	587	237767	0.02614
SRR7691157_1_kneaddata_paired	Verrucomicrobiota	33333	P	104475	6156	110631	0.01216
SRR7691157_1_kneaddata_paired	Actinobacteriota	615	P	75254	55	75309	0.00828
SRR7691157_1_kneaddata_paired	Firmicutes	12188	P	61464	656	62120	0.00683
SRR7691157_1_kneaddata_paired	Desulfobacterota_A	11509	P	35189	136	35325	0.00388
SRR7691157_1_kneaddata_paired	Cyanobacteria	9876	P	20463	108	20571	0.00226
SRR7691157_1_kneaddata_paired	Deferribacterota	10822	P	3869	14	3883	0.00043
SRR7691157_1_kneaddata_paired	Firmicutes_B	17289	P	205	7	212	0.00002
SRR7691157_1_kneaddata_paired	Campylobacterota	8700	P	198	0	198	0.00002
SRR7691157_1_kneaddata_paired	Spirochaetota	32587	P	78	0	78	0.00001
SRR7691157_1_kneaddata_paired	Firmicutes_I	18140	P	70	0	70	0.00001
SRR7691157_1_kneaddata_paired	Firmicutes_C	17613	P	28	0	28	0.00000
SRR7691157_1_kneaddata_paired	Thermotogota	33086	P	8	0	8	0.00000
SRR7691157_1_kneaddata_paired	Elusimicrobiota	11888	P	6	0	6	0.00000
SRR7691158_1_kneaddata_paired	Bacteroidota	4587	P	4368409	29275	4397684	0.77603
SRR7691158_1_kneaddata_paired	Firmicutes_A	14608	P	969268	8639	977907	0.17257
SRR7691158_1_kneaddata_paired	Proteobacteria	22518	P	112421	338	112759	0.01990
SRR7691158_1_kneaddata_paired	Verrucomicrobiota	33333	P	89923	5720	95643	0.01688
SRR7691158_1_kneaddata_paired	Actinobacteriota	615	P	35749	32	35781	0.00631
SRR7691158_1_kneaddata_paired	Firmicutes	12188	P	26058	315	26373	0.00465
SRR7691158_1_kneaddata_paired	Desulfobacterota_A	11509	P	14034	68	14102	0.00249
SRR7691158_1_kneaddata_paired	Cyanobacteria	9876	P	5755	30	5785	0.00102
SRR7691158_1_kneaddata_paired	Deferribacterota	10822	P	578	2	580	0.00010
SRR7691158_1_kneaddata_paired	Firmicutes_B	17289	P	102	4	106	0.00002
SRR7691158_1_kneaddata_paired	Campylobacterota	8700	P	85	0	85	0.00002
SRR7691158_1_kneaddata_paired	Firmicutes_I	18140	P	27	0	27	0.00000
SRR7691158_1_kneaddata_paired	Spirochaetota	32587	P	26	0	26	0.00000
SRR7691158_1_kneaddata_paired	Firmicutes_C	17613	P	17	0	17	0.00000
SRR7691158_1_kneaddata_paired	Thermotogota	33086	P	4	0	4	0.00000
SRR7691158_1_kneaddata_paired	Elusimicrobiota	11888	P	3	0	3	0.00000
SRR7691159_1_kneaddata_paired	Bacteroidota	4587	P	5341040	23296	5364336	0.79347
SRR7691159_1_kneaddata_paired	Firmicutes_A	14608	P	927711	7676	935387	0.13836
SRR7691159_1_kneaddata_paired	Proteobacteria	22518	P	217546	623	218169	0.03227
SRR7691159_1_kneaddata_paired	Verrucomicrobiota	33333	P	125118	6804	131922	0.01951
SRR7691159_1_kneaddata_paired	Actinobacteriota	615	P	42874	29	42903	0.00635
SRR7691159_1_kneaddata_paired	Desulfobacterota_A	11509	P	28988	91	29079	0.00430
SRR7691159_1_kneaddata_paired	Firmicutes	12188	P	21317	229	21546	0.00319
SRR7691159_1_kneaddata_paired	Cyanobacteria	9876	P	15648	71	15719	0.00233
SRR7691159_1_kneaddata_paired	Deferribacterota	10822	P	1160	4	1164	0.00017
SRR7691159_1_kneaddata_paired	Campylobacterota	8700	P	188	0	188	0.00003
SRR7691159_1_kneaddata_paired	Firmicutes_B	17289	P	66	2	68	0.00001
SRR7691159_1_kneaddata_paired	Spirochaetota	32587	P	40	0	40	0.00001
SRR7691159_1_kneaddata_paired	Firmicutes_I	18140	P	22	0	22	0.00000
SRR7691159_1_kneaddata_paired	Firmicutes_C	17613	P	15	0	15	0.00000
SRR7691159_1_kneaddata_paired	Thermotogota	33086	P	11	0	11	0.00000
SRR7691159_1_kneaddata_paired	Elusimicrobiota	11888	P	1	0	1	0.00000
SRR7691160_1_kneaddata_paired	Firmicutes_A	14608	P	2194212	8409	2202621	0.48847
SRR7691160_1_kneaddata_paired	Bacteroidota	4587	P	1734169	6002	1740171	0.38592
SRR7691160_1_kneaddata_paired	Firmicutes	12188	P	246157	2365	248522	0.05511
SRR7691160_1_kneaddata_paired	Proteobacteria	22518	P	182457	814	183271	0.04064
SRR7691160_1_kneaddata_paired	Desulfobacterota_A	11509	P	44826	117	44943	0.00997
SRR7691160_1_kneaddata_paired	Verrucomicrobiota	33333	P	39101	1982	41083	0.00911
SRR7691160_1_kneaddata_paired	Cyanobacteria	9876	P	28749	106	28855	0.00640
SRR7691160_1_kneaddata_paired	Actinobacteriota	615	P	15885	13	15898	0.00353
SRR7691160_1_kneaddata_paired	Deferribacterota	10822	P	3180	10	3190	0.00071
SRR7691160_1_kneaddata_paired	Campylobacterota	8700	P	292	0	292	0.00006
SRR7691160_1_kneaddata_paired	Firmicutes_B	17289	P	205	6	211	0.00005
SRR7691160_1_kneaddata_paired	Spirochaetota	32587	P	61	0	61	0.00001
SRR7691160_1_kneaddata_paired	Firmicutes_C	17613	P	25	0	25	0.00001
SRR7691160_1_kneaddata_paired	Firmicutes_I	18140	P	25	0	25	0.00001
SRR7691160_1_kneaddata_paired	Thermotogota	33086	P	10	0	10	0.00000
SRR7691160_1_kneaddata_paired	Elusimicrobiota	11888	P	5	0	5	0.00000
SRR7691161_1_kneaddata_paired	Bacteroidota	4587	P	3263011	11155	3274166	0.58572
SRR7691161_1_kneaddata_paired	Firmicutes_A	14608	P	1735981	10844	1746825	0.31249
SRR7691161_1_kneaddata_paired	Verrucomicrobiota	33333	P	219505	9943	229448	0.04105
SRR7691161_1_kneaddata_paired	Proteobacteria	22518	P	178653	527	179180	0.03205
SRR7691161_1_kneaddata_paired	Desulfobacterota_A	11509	P	51908	118	52026	0.00931
SRR7691161_1_kneaddata_paired	Firmicutes	12188	P	38148	361	38509	0.00689
SRR7691161_1_kneaddata_paired	Deferribacterota	10822	P	29397	85	29482	0.00527
SRR7691161_1_kneaddata_paired	Actinobacteriota	615	P	23416	16	23432	0.00419
SRR7691161_1_kneaddata_paired	Cyanobacteria	9876	P	16281	56	16337	0.00292
SRR7691161_1_kneaddata_paired	Campylobacterota	8700	P	206	0	206	0.00004
SRR7691161_1_kneaddata_paired	Firmicutes_B	17289	P	156	4	160	0.00003
SRR7691161_1_kneaddata_paired	Spirochaetota	32587	P	98	0	98	0.00002
SRR7691161_1_kneaddata_paired	Firmicutes_I	18140	P	47	0	47	0.00001
SRR7691161_1_kneaddata_paired	Firmicutes_C	17613	P	40	0	40	0.00001
SRR7691161_1_kneaddata_paired	Thermotogota	33086	P	6	0	6	0.00000
SRR7691161_1_kneaddata_paired	Elusimicrobiota	11888	P	3	0	3	0.00000
SRR7691162_1_kneaddata_paired	Bacteroidota	4587	P	4059671	18948	4078619	0.75294
SRR7691162_1_kneaddata_paired	Firmicutes_A	14608	P	1001558	7952	1009510	0.18636
SRR7691162_1_kneaddata_paired	Verrucomicrobiota	33333	P	142257	7969	150226	0.02773
SRR7691162_1_kneaddata_paired	Proteobacteria	22518	P	116482	212	116694	0.02154
SRR7691162_1_kneaddata_paired	Desulfobacterota_A	11509	P	21428	68	21496	0.00397
SRR7691162_1_kneaddata_paired	Firmicutes	12188	P	20712	233	20945	0.00387
SRR7691162_1_kneaddata_paired	Actinobacteriota	615	P	12002	16	12018	0.00222
SRR7691162_1_kneaddata_paired	Cyanobacteria	9876	P	6224	31	6255	0.00115
SRR7691162_1_kneaddata_paired	Deferribacterota	10822	P	993	3	996	0.00018
SRR7691162_1_kneaddata_paired	Campylobacterota	8700	P	63	0	63	0.00001
SRR7691162_1_kneaddata_paired	Firmicutes_B	17289	P	37	1	38	0.00001
SRR7691162_1_kneaddata_paired	Firmicutes_I	18140	P	31	0	31	0.00001
SRR7691162_1_kneaddata_paired	Spirochaetota	32587	P	23	0	23	0.00000
SRR7691162_1_kneaddata_paired	Firmicutes_C	17613	P	18	0	18	0.00000
SRR7691162_1_kneaddata_paired	Thermotogota	33086	P	8	0	8	0.00000
SRR7691162_1_kneaddata_paired	Elusimicrobiota	11888	P	1	0	1	0.00000
SRR7691163_1_kneaddata_paired	Bacteroidota	4587	P	6821656	32570	6854226	0.76286
SRR7691163_1_kneaddata_paired	Firmicutes_A	14608	P	1644946	13009	1657955	0.18453
SRR7691163_1_kneaddata_paired	Proteobacteria	22518	P	218845	501	219346	0.02441
SRR7691163_1_kneaddata_paired	Verrucomicrobiota	33333	P	101206	6031	107237	0.01194
SRR7691163_1_kneaddata_paired	Actinobacteriota	615	P	67650	52	67702	0.00754
SRR7691163_1_kneaddata_paired	Firmicutes	12188	P	34760	399	35159	0.00391
SRR7691163_1_kneaddata_paired	Desulfobacterota_A	11509	P	31581	112	31693	0.00353
SRR7691163_1_kneaddata_paired	Cyanobacteria	9876	P	10406	59	10465	0.00116
SRR7691163_1_kneaddata_paired	Deferribacterota	10822	P	761	2	763	0.00009
SRR7691163_1_kneaddata_paired	Campylobacterota	8700	P	158	0	158	0.00002
SRR7691163_1_kneaddata_paired	Firmicutes_B	17289	P	143	5	148	0.00002
SRR7691163_1_kneaddata_paired	Spirochaetota	32587	P	43	0	43	0.00000
SRR7691163_1_kneaddata_paired	Firmicutes_I	18140	P	37	0	37	0.00000
SRR7691163_1_kneaddata_paired	Firmicutes_C	17613	P	17	0	17	0.00000
SRR7691163_1_kneaddata_paired	Thermotogota	33086	P	4	0	4	0.00000
SRR7691163_1_kneaddata_paired	Elusimicrobiota	11888	P	2	0	2	0.00000
SRR7691164_1_kneaddata_paired	Bacteroidota	4587	P	4558434	37983	4596417	0.70312
SRR7691164_1_kneaddata_paired	Firmicutes_A	14608	P	1704325	20702	1725027	0.26388
SRR7691164_1_kneaddata_paired	Proteobacteria	22518	P	69234	478	69712	0.01066
SRR7691164_1_kneaddata_paired	Firmicutes	12188	P	59762	1202	60964	0.00933
SRR7691164_1_kneaddata_paired	Cyanobacteria	9876	P	58212	445	58657	0.00897
SRR7691164_1_kneaddata_paired	Desulfobacterota_A	11509	P	14806	102	14908	0.00228
SRR7691164_1_kneaddata_paired	Deferribacterota	10822	P	5284	34	5318	0.00081
SRR7691164_1_kneaddata_paired	Actinobacteriota	615	P	3610	11	3621	0.00055
SRR7691164_1_kneaddata_paired	Verrucomicrobiota	33333	P	1810	184	1994	0.00031
SRR7691164_1_kneaddata_paired	Campylobacterota	8700	P	239	0	239	0.00004
SRR7691164_1_kneaddata_paired	Firmicutes_B	17289	P	135	8	143	0.00002
SRR7691164_1_kneaddata_paired	Spirochaetota	32587	P	129	0	129	0.00002
SRR7691164_1_kneaddata_paired	Firmicutes_I	18140	P	47	0	47	0.00001
SRR7691164_1_kneaddata_paired	Firmicutes_C	17613	P	21	0	21	0.00000
SRR7691164_1_kneaddata_paired	Thermotogota	33086	P	10	0	10	0.00000
SRR7691164_1_kneaddata_paired	Elusimicrobiota	11888	P	2	0	2	0.00000
SRR7691165_1_kneaddata_paired	Bacteroidota	4587	P	4381270	18754	4400024	0.78993
SRR7691165_1_kneaddata_paired	Firmicutes_A	14608	P	827646	8037	835683	0.15003
SRR7691165_1_kneaddata_paired	Verrucomicrobiota	33333	P	168362	10578	178940	0.03212
SRR7691165_1_kneaddata_paired	Proteobacteria	22518	P	73476	226	73702	0.01323
SRR7691165_1_kneaddata_paired	Desulfobacterota_A	11509	P	58322	162	58484	0.01050
SRR7691165_1_kneaddata_paired	Actinobacteriota	615	P	13992	15	14007	0.00251
SRR7691165_1_kneaddata_paired	Firmicutes	12188	P	5750	108	5858	0.00105
SRR7691165_1_kneaddata_paired	Cyanobacteria	9876	P	1673	8	1681	0.00030
SRR7691165_1_kneaddata_paired	Deferribacterota	10822	P	1583	6	1589	0.00029
SRR7691165_1_kneaddata_paired	Campylobacterota	8700	P	54	0	54	0.00001
SRR7691165_1_kneaddata_paired	Firmicutes_B	17289	P	45	1	46	0.00001
SRR7691165_1_kneaddata_paired	Firmicutes_I	18140	P	26	0	26	0.00000
SRR7691165_1_kneaddata_paired	Spirochaetota	32587	P	25	0	25	0.00000
SRR7691165_1_kneaddata_paired	Firmicutes_C	17613	P	14	0	14	0.00000
SRR7691165_1_kneaddata_paired	Thermotogota	33086	P	3	0	3	0.00000
SRR7691165_1_kneaddata_paired	Elusimicrobiota	11888	P	2	0	2	0.00000
SRR7691166_1_kneaddata_paired	Bacteroidota	4587	P	4838507	19502	4858009	0.73160
SRR7691166_1_kneaddata_paired	Firmicutes_A	14608	P	1223905	10372	1234277	0.18588
SRR7691166_1_kneaddata_paired	Verrucomicrobiota	33333	P	276822	15203	292025	0.04398
SRR7691166_1_kneaddata_paired	Proteobacteria	22518	P	164491	475	164966	0.02484
SRR7691166_1_kneaddata_paired	Desulfobacterota_A	11509	P	51711	149	51860	0.00781
SRR7691166_1_kneaddata_paired	Actinobacteriota	615	P	19218	17	19235	0.00290
SRR7691166_1_kneaddata_paired	Firmicutes	12188	P	10650	174	10824	0.00163
SRR7691166_1_kneaddata_paired	Cyanobacteria	9876	P	5787	26	5813	0.00088
SRR7691166_1_kneaddata_paired	Deferribacterota	10822	P	2827	9	2836	0.00043
SRR7691166_1_kneaddata_paired	Campylobacterota	8700	P	136	0	136	0.00002
SRR7691166_1_kneaddata_paired	Firmicutes_B	17289	P	111	3	114	0.00002
SRR7691166_1_kneaddata_paired	Spirochaetota	32587	P	50	0	50	0.00001
SRR7691166_1_kneaddata_paired	Firmicutes_I	18140	P	37	0	37	0.00001
SRR7691166_1_kneaddata_paired	Firmicutes_C	17613	P	19	0	19	0.00000
SRR7691166_1_kneaddata_paired	Thermotogota	33086	P	4	0	4	0.00000
SRR7691166_1_kneaddata_paired	Elusimicrobiota	11888	P	2	0	2	0.00000
SRR7691167_1_kneaddata_paired	Bacteroidota	4587	P	2215017	7436	2222453	0.49060
SRR7691167_1_kneaddata_paired	Firmicutes_A	14608	P	1857368	10640	1868008	0.41236
SRR7691167_1_kneaddata_paired	Firmicutes	12188	P	152098	1502	153600	0.03391
SRR7691167_1_kneaddata_paired	Proteobacteria	22518	P	105496	390	105886	0.02337
SRR7691167_1_kneaddata_paired	Verrucomicrobiota	33333	P	83553	4381	87934	0.01941
SRR7691167_1_kneaddata_paired	Desulfobacterota_A	11509	P	41915	112	42027	0.00928
SRR7691167_1_kneaddata_paired	Actinobacteriota	615	P	29012	26	29038	0.00641
SRR7691167_1_kneaddata_paired	Cyanobacteria	9876	P	19557	98	19655	0.00434
SRR7691167_1_kneaddata_paired	Firmicutes_B	17289	P	651	21	672	0.00015
SRR7691167_1_kneaddata_paired	Deferribacterota	10822	P	503	1	504	0.00011
SRR7691167_1_kneaddata_paired	Campylobacterota	8700	P	176	0	176	0.00004
SRR7691167_1_kneaddata_paired	Spirochaetota	32587	P	45	0	45	0.00001
SRR7691167_1_kneaddata_paired	Firmicutes_C	17613	P	39	0	39	0.00001
SRR7691167_1_kneaddata_paired	Firmicutes_I	18140	P	26	0	26	0.00001
SRR7691167_1_kneaddata_paired	Thermotogota	33086	P	10	0	10	0.00000
SRR7691167_1_kneaddata_paired	Elusimicrobiota	11888	P	2	0	2	0.00000
SRR7691168_1_kneaddata_paired	Bacteroidota	4587	P	2017545	9023	2026568	0.48212
SRR7691168_1_kneaddata_paired	Firmicutes_A	14608	P	1922650	11030	1933680	0.46002
SRR7691168_1_kneaddata_paired	Firmicutes	12188	P	80162	1192	81354	0.01935
SRR7691168_1_kneaddata_paired	Verrucomicrobiota	33333	P	43477	3094	46571	0.01108
SRR7691168_1_kneaddata_paired	Proteobacteria	22518	P	40057	148	40205	0.00956
SRR7691168_1_kneaddata_paired	Desulfobacterota_A	11509	P	38649	144	38793	0.00923
SRR7691168_1_kneaddata_paired	Cyanobacteria	9876	P	22017	114	22131	0.00527
SRR7691168_1_kneaddata_paired	Actinobacteriota	615	P	13357	17	13374	0.00318
SRR7691168_1_kneaddata_paired	Deferribacterota	10822	P	391	1	392	0.00009
SRR7691168_1_kneaddata_paired	Firmicutes_B	17289	P	168	7	175	0.00004
SRR7691168_1_kneaddata_paired	Campylobacterota	8700	P	85	0	85	0.00002
SRR7691168_1_kneaddata_paired	Spirochaetota	32587	P	38	0	38	0.00001
SRR7691168_1_kneaddata_paired	Firmicutes_C	17613	P	33	0	33	0.00001
SRR7691168_1_kneaddata_paired	Firmicutes_I	18140	P	32	0	32	0.00001
SRR7691168_1_kneaddata_paired	Thermotogota	33086	P	4	0	4	0.00000
SRR7691168_1_kneaddata_paired	Elusimicrobiota	11888	P	3	0	3	0.00000
SRR7691169_1_kneaddata_paired	Bacteroidota	4587	P	2876819	10206	2887025	0.50878
SRR7691169_1_kneaddata_paired	Firmicutes_A	14608	P	2364905	9869	2374774	0.41851
SRR7691169_1_kneaddata_paired	Proteobacteria	22518	P	162446	467	162913	0.02871
SRR7691169_1_kneaddata_paired	Verrucomicrobiota	33333	P	153745	6568	160313	0.02825
SRR7691169_1_kneaddata_paired	Desulfobacterota_A	11509	P	44925	147	45072	0.00794
SRR7691169_1_kneaddata_paired	Actinobacteriota	615	P	16823	14	16837	0.00297
SRR7691169_1_kneaddata_paired	Firmicutes	12188	P	11699	133	11832	0.00209
SRR7691169_1_kneaddata_paired	Cyanobacteria	9876	P	10497	33	10530	0.00186
SRR7691169_1_kneaddata_paired	Deferribacterota	10822	P	2498	6	2504	0.00044
SRR7691169_1_kneaddata_paired	Firmicutes_B	17289	P	2087	56	2143	0.00038
SRR7691169_1_kneaddata_paired	Campylobacterota	8700	P	229	0	229	0.00004
SRR7691169_1_kneaddata_paired	Spirochaetota	32587	P	72	0	72	0.00001
SRR7691169_1_kneaddata_paired	Firmicutes_I	18140	P	68	0	68	0.00001
SRR7691169_1_kneaddata_paired	Firmicutes_C	17613	P	59	0	59	0.00001
SRR7691169_1_kneaddata_paired	Thermotogota	33086	P	7	0	7	0.00000
SRR7691169_1_kneaddata_paired	Elusimicrobiota	11888	P	1	0	1	0.00000
SRR7691170_1_kneaddata_paired	Bacteroidota	4587	P	2409434	8169	2417603	0.47904
SRR7691170_1_kneaddata_paired	Firmicutes_A	14608	P	2193583	9473	2203056	0.43653
SRR7691170_1_kneaddata_paired	Verrucomicrobiota	33333	P	159670	7219	166889	0.03307
SRR7691170_1_kneaddata_paired	Proteobacteria	22518	P	123416	379	123795	0.02453
SRR7691170_1_kneaddata_paired	Firmicutes	12188	P	73493	647	74140	0.01469
SRR7691170_1_kneaddata_paired	Actinobacteriota	615	P	18943	15	18958	0.00376
SRR7691170_1_kneaddata_paired	Desulfobacterota_A	11509	P	17309	79	17388	0.00345
SRR7691170_1_kneaddata_paired	Cyanobacteria	9876	P	12880	56	12936	0.00256
SRR7691170_1_kneaddata_paired	Deferribacterota	10822	P	6207	18	6225	0.00123
SRR7691170_1_kneaddata_paired	Firmicutes_B	17289	P	5279	150	5429	0.00108
SRR7691170_1_kneaddata_paired	Campylobacterota	8700	P	163	0	163	0.00003
SRR7691170_1_kneaddata_paired	Firmicutes_I	18140	P	52	0	52	0.00001
SRR7691170_1_kneaddata_paired	Spirochaetota	32587	P	48	0	48	0.00001
SRR7691170_1_kneaddata_paired	Firmicutes_C	17613	P	36	0	36	0.00001
SRR7691170_1_kneaddata_paired	Thermotogota	33086	P	9	0	9	0.00000
SRR7691170_1_kneaddata_paired	Elusimicrobiota	11888	P	6	0	6	0.00000
SRR7691171_1_kneaddata_paired	Bacteroidota	4587	P	2464336	7868	2472204	0.49557
SRR7691171_1_kneaddata_paired	Firmicutes_A	14608	P	2086018	8812	2094830	0.41993
SRR7691171_1_kneaddata_paired	Verrucomicrobiota	33333	P	196840	8254	205094	0.04111
SRR7691171_1_kneaddata_paired	Proteobacteria	22518	P	123685	324	124009	0.02486
SRR7691171_1_kneaddata_paired	Desulfobacterota_A	11509	P	42479	139	42618	0.00854
SRR7691171_1_kneaddata_paired	Actinobacteriota	615	P	18353	13	18366	0.00368
SRR7691171_1_kneaddata_paired	Cyanobacteria	9876	P	14151	43	14194	0.00285
SRR7691171_1_kneaddata_paired	Firmicutes	12188	P	12813	144	12957	0.00260
SRR7691171_1_kneaddata_paired	Firmicutes_B	17289	P	3436	91	3527	0.00071
SRR7691171_1_kneaddata_paired	Deferribacterota	10822	P	471	1	472	0.00009
SRR7691171_1_kneaddata_paired	Campylobacterota	8700	P	163	0	163	0.00003
SRR7691171_1_kneaddata_paired	Firmicutes_I	18140	P	51	0	51	0.00001
SRR7691171_1_kneaddata_paired	Spirochaetota	32587	P	41	0	41	0.00001
SRR7691171_1_kneaddata_paired	Firmicutes_C	17613	P	35	0	35	0.00001
SRR7691171_1_kneaddata_paired	Thermotogota	33086	P	8	0	8	0.00000
SRR7691171_1_kneaddata_paired	Elusimicrobiota	11888	P	2	0	2	0.00000
SRR7691172_1_kneaddata_paired	Firmicutes_A	14608	P	2107023	7852	2114875	0.48142
SRR7691172_1_kneaddata_paired	Bacteroidota	4587	P	1895173	6113	1901286	0.43280
SRR7691172_1_kneaddata_paired	Verrucomicrobiota	33333	P	153745	6569	160314	0.03649
SRR7691172_1_kneaddata_paired	Proteobacteria	22518	P	75193	204	75397	0.01716
SRR7691172_1_kneaddata_paired	Firmicutes	12188	P	70218	590	70808	0.01612
SRR7691172_1_kneaddata_paired	Cyanobacteria	9876	P	25389	78	25467	0.00580
SRR7691172_1_kneaddata_paired	Desulfobacterota_A	11509	P	22408	80	22488	0.00512
SRR7691172_1_kneaddata_paired	Actinobacteriota	615	P	14594	10	14604	0.00332
SRR7691172_1_kneaddata_paired	Firmicutes_B	17289	P	5484	148	5632	0.00128
SRR7691172_1_kneaddata_paired	Deferribacterota	10822	P	1812	4	1816	0.00041
SRR7691172_1_kneaddata_paired	Campylobacterota	8700	P	134	0	134	0.00003
SRR7691172_1_kneaddata_paired	Spirochaetota	32587	P	48	0	48	0.00001
SRR7691172_1_kneaddata_paired	Firmicutes_I	18140	P	39	0	39	0.00001
SRR7691172_1_kneaddata_paired	Firmicutes_C	17613	P	38	0	38	0.00001
SRR7691172_1_kneaddata_paired	Thermotogota	33086	P	10	0	10	0.00000
SRR7691172_1_kneaddata_paired	Elusimicrobiota	11888	P	9	0	9	0.00000
SRR7691173_1_kneaddata_paired	Firmicutes_A	14608	P	8022546	38450	8060996	0.65836
SRR7691173_1_kneaddata_paired	Bacteroidota	4587	P	2989578	15834	3005412	0.24546
SRR7691173_1_kneaddata_paired	Firmicutes	12188	P	473730	4500	478230	0.03906
SRR7691173_1_kneaddata_paired	Desulfobacterota_A	11509	P	199593	519	200112	0.01634
SRR7691173_1_kneaddata_paired	Deferribacterota	10822	P	148493	514	149007	0.01217
SRR7691173_1_kneaddata_paired	Proteobacteria	22518	P	135687	546	136233	0.01113
SRR7691173_1_kneaddata_paired	Verrucomicrobiota	33333	P	93373	4976	98349	0.00803
SRR7691173_1_kneaddata_paired	Cyanobacteria	9876	P	64700	263	64963	0.00531
SRR7691173_1_kneaddata_paired	Actinobacteriota	615	P	49266	77	49343	0.00403
SRR7691173_1_kneaddata_paired	Firmicutes_B	17289	P	600	20	620	0.00005
SRR7691173_1_kneaddata_paired	Spirochaetota	32587	P	248	0	248	0.00002
SRR7691173_1_kneaddata_paired	Campylobacterota	8700	P	247	0	247	0.00002
SRR7691173_1_kneaddata_paired	Firmicutes_I	18140	P	117	0	117	0.00001
SRR7691173_1_kneaddata_paired	Firmicutes_C	17613	P	86	0	86	0.00001
SRR7691173_1_kneaddata_paired	Thermotogota	33086	P	17	0	17	0.00000
SRR7691173_1_kneaddata_paired	Elusimicrobiota	11888	P	7	0	7	0.00000
SRR7691174_1_kneaddata_paired	Firmicutes_A	14608	P	3752772	13360	3766132	0.59842
SRR7691174_1_kneaddata_paired	Bacteroidota	4587	P	2066509	7206	2073715	0.32951
SRR7691174_1_kneaddata_paired	Desulfobacterota_A	11509	P	146247	294	146541	0.02328
SRR7691174_1_kneaddata_paired	Proteobacteria	22518	P	139648	469	140117	0.02226
SRR7691174_1_kneaddata_paired	Verrucomicrobiota	33333	P	99330	4146	103476	0.01644
SRR7691174_1_kneaddata_paired	Firmicutes	12188	P	23986	218	24204	0.00385
SRR7691174_1_kneaddata_paired	Actinobacteriota	615	P	19299	17	19316	0.00307
SRR7691174_1_kneaddata_paired	Cyanobacteria	9876	P	9763	31	9794	0.00156
SRR7691174_1_kneaddata_paired	Deferribacterota	10822	P	9388	25	9413	0.00150
SRR7691174_1_kneaddata_paired	Firmicutes_B	17289	P	225	5	230	0.00004
SRR7691174_1_kneaddata_paired	Campylobacterota	8700	P	174	0	174	0.00003
SRR7691174_1_kneaddata_paired	Spirochaetota	32587	P	134	0	134	0.00002
SRR7691174_1_kneaddata_paired	Firmicutes_I	18140	P	84	0	84	0.00001
SRR7691174_1_kneaddata_paired	Firmicutes_C	17613	P	56	0	56	0.00001
SRR7691174_1_kneaddata_paired	Thermotogota	33086	P	12	0	12	0.00000
SRR7691174_1_kneaddata_paired	Elusimicrobiota	11888	P	9	0	9	0.00000
SRR7761320_1_kneaddata_paired	Bacteroidota	4587	P	8364228	41644	8405872	0.45959
SRR7761320_1_kneaddata_paired	Firmicutes_A	14608	P	7999207	44375	8043582	0.43978
SRR7761320_1_kneaddata_paired	Desulfobacterota_A	11509	P	932497	2511	935008	0.05112
SRR7761320_1_kneaddata_paired	Firmicutes	12188	P	642599	27183	669782	0.03662
SRR7761320_1_kneaddata_paired	Proteobacteria	22518	P	145639	350	145989	0.00798
SRR7761320_1_kneaddata_paired	Actinobacteriota	615	P	62527	59	62586	0.00342
SRR7761320_1_kneaddata_paired	Verrucomicrobiota	33333	P	14805	403	15208	0.00083
SRR7761320_1_kneaddata_paired	Cyanobacteria	9876	P	9459	387	9846	0.00054
SRR7761320_1_kneaddata_paired	Spirochaetota	32587	P	1229	1	1230	0.00007
SRR7761320_1_kneaddata_paired	Firmicutes_B	17289	P	483	16	499	0.00003
SRR7761320_1_kneaddata_paired	Campylobacterota	8700	P	174	0	174	0.00001
SRR7761320_1_kneaddata_paired	Firmicutes_I	18140	P	103	0	103	0.00001
SRR7761320_1_kneaddata_paired	Firmicutes_C	17613	P	72	0	72	0.00000
SRR7761320_1_kneaddata_paired	Deferribacterota	10822	P	33	0	33	0.00000
SRR7761320_1_kneaddata_paired	Elusimicrobiota	11888	P	16	0	16	0.00000
SRR7761320_1_kneaddata_paired	Thermotogota	33086	P	12	0	12	0.00000
SRR7761321_1_kneaddata_paired	Firmicutes_A	14608	P	5683798	26127	5709925	0.61061
SRR7761321_1_kneaddata_paired	Bacteroidota	4587	P	3261801	27515	3289316	0.35175
SRR7761321_1_kneaddata_paired	Proteobacteria	22518	P	152606	427	153033	0.01637
SRR7761321_1_kneaddata_paired	Firmicutes	12188	P	101626	6043	107669	0.01151
SRR7761321_1_kneaddata_paired	Verrucomicrobiota	33333	P	85504	1515	87019	0.00931
SRR7761321_1_kneaddata_paired	Desulfobacterota_A	11509	P	1308	154	1462	0.00016
SRR7761321_1_kneaddata_paired	Cyanobacteria	9876	P	1217	26	1243	0.00013
SRR7761321_1_kneaddata_paired	Actinobacteriota	615	P	959	4	963	0.00010
SRR7761321_1_kneaddata_paired	Firmicutes_B	17289	P	140	5	145	0.00002
SRR7761321_1_kneaddata_paired	Firmicutes_C	17613	P	121	0	121	0.00001
SRR7761321_1_kneaddata_paired	Campylobacterota	8700	P	106	0	106	0.00001
SRR7761321_1_kneaddata_paired	Spirochaetota	32587	P	81	0	81	0.00001
SRR7761321_1_kneaddata_paired	Firmicutes_I	18140	P	51	0	51	0.00001
SRR7761321_1_kneaddata_paired	Deferribacterota	10822	P	26	0	26	0.00000
SRR7761321_1_kneaddata_paired	Elusimicrobiota	11888	P	4	0	4	0.00000
SRR7761321_1_kneaddata_paired	Thermotogota	33086	P	3	0	3	0.00000
SRR7761322_1_kneaddata_paired	Firmicutes_A	14608	P	4138188	19572	4157760	0.46779
SRR7761322_1_kneaddata_paired	Bacteroidota	4587	P	3472996	17288	3490284	0.39269
SRR7761322_1_kneaddata_paired	Desulfobacterota_A	11509	P	703787	1727	705514	0.07938
SRR7761322_1_kneaddata_paired	Firmicutes	12188	P	426044	16088	442132	0.04974
SRR7761322_1_kneaddata_paired	Actinobacteriota	615	P	45684	38	45722	0.00514
SRR7761322_1_kneaddata_paired	Proteobacteria	22518	P	42117	68	42185	0.00475
SRR7761322_1_kneaddata_paired	Verrucomicrobiota	33333	P	2355	111	2466	0.00028
SRR7761322_1_kneaddata_paired	Spirochaetota	32587	P	941	0	941	0.00011
SRR7761322_1_kneaddata_paired	Cyanobacteria	9876	P	673	11	684	0.00008
SRR7761322_1_kneaddata_paired	Firmicutes_B	17289	P	231	7	238	0.00003
SRR7761322_1_kneaddata_paired	Campylobacterota	8700	P	56	0	56	0.00001
SRR7761322_1_kneaddata_paired	Firmicutes_I	18140	P	50	0	50	0.00001
SRR7761322_1_kneaddata_paired	Firmicutes_C	17613	P	49	0	49	0.00001
SRR7761322_1_kneaddata_paired	Deferribacterota	10822	P	14	0	14	0.00000
SRR7761322_1_kneaddata_paired	Elusimicrobiota	11888	P	13	0	13	0.00000
SRR7761322_1_kneaddata_paired	Thermotogota	33086	P	7	0	7	0.00000
SRR7761323_1_kneaddata_paired	Firmicutes_A	14608	P	8372900	48534	8421434	0.70175
SRR7761323_1_kneaddata_paired	Bacteroidota	4587	P	2801516	19713	2821229	0.23509
SRR7761323_1_kneaddata_paired	Desulfobacterota_A	11509	P	657993	2309	660302	0.05502
SRR7761323_1_kneaddata_paired	Firmicutes	12188	P	56827	2195	59022	0.00492
SRR7761323_1_kneaddata_paired	Proteobacteria	22518	P	25477	81	25558	0.00213
SRR7761323_1_kneaddata_paired	Actinobacteriota	615	P	5564	10	5574	0.00046
SRR7761323_1_kneaddata_paired	Verrucomicrobiota	33333	P	3935	246	4181	0.00035
SRR7761323_1_kneaddata_paired	Cyanobacteria	9876	P	1224	40	1264	0.00011
SRR7761323_1_kneaddata_paired	Spirochaetota	32587	P	1191	1	1192	0.00010
SRR7761323_1_kneaddata_paired	Firmicutes_B	17289	P	622	25	647	0.00005
SRR7761323_1_kneaddata_paired	Campylobacterota	8700	P	92	0	92	0.00001
SRR7761323_1_kneaddata_paired	Firmicutes_C	17613	P	90	0	90	0.00001
SRR7761323_1_kneaddata_paired	Firmicutes_I	18140	P	68	0	68	0.00001
SRR7761323_1_kneaddata_paired	Deferribacterota	10822	P	18	0	18	0.00000
SRR7761323_1_kneaddata_paired	Thermotogota	33086	P	14	0	14	0.00000
SRR7761323_1_kneaddata_paired	Elusimicrobiota	11888	P	13	0	13	0.00000
SRR7761324_1_kneaddata_paired	Bacteroidota	4587	P	7725922	51956	7777878	0.48436
SRR7761324_1_kneaddata_paired	Firmicutes_A	14608	P	7158110	29579	7187689	0.44760
SRR7761324_1_kneaddata_paired	Verrucomicrobiota	33333	P	698043	9501	707544	0.04406
SRR7761324_1_kneaddata_paired	Proteobacteria	22518	P	171125	727	171852	0.01070
SRR7761324_1_kneaddata_paired	Firmicutes	12188	P	132988	1254	134242	0.00836
SRR7761324_1_kneaddata_paired	Cyanobacteria	9876	P	73896	1013	74909	0.00466
SRR7761324_1_kneaddata_paired	Desulfobacterota_A	11509	P	2127	233	2360	0.00015
SRR7761324_1_kneaddata_paired	Actinobacteriota	615	P	1006	2	1008	0.00006
SRR7761324_1_kneaddata_paired	Campylobacterota	8700	P	304	0	304	0.00002
SRR7761324_1_kneaddata_paired	Spirochaetota	32587	P	120	0	120	0.00001
SRR7761324_1_kneaddata_paired	Firmicutes_I	18140	P	89	0	89	0.00001
SRR7761324_1_kneaddata_paired	Firmicutes_B	17289	P	81	2	83	0.00001
SRR7761324_1_kneaddata_paired	Firmicutes_C	17613	P	81	0	81	0.00001
SRR7761324_1_kneaddata_paired	Deferribacterota	10822	P	21	0	21	0.00000
SRR7761324_1_kneaddata_paired	Elusimicrobiota	11888	P	10	0	10	0.00000
SRR7761324_1_kneaddata_paired	Thermotogota	33086	P	2	0	2	0.00000
SRR7761325_1_kneaddata_paired	Bacteroidota	4587	P	3916921	23071	3939992	0.54244
SRR7761325_1_kneaddata_paired	Firmicutes_A	14608	P	3214210	20119	3234329	0.44529
SRR7761325_1_kneaddata_paired	Proteobacteria	22518	P	45522	270	45792	0.00630
SRR7761325_1_kneaddata_paired	Firmicutes	12188	P	35643	1481	37124	0.00511
SRR7761325_1_kneaddata_paired	Actinobacteriota	615	P	3385	7	3392	0.00047
SRR7761325_1_kneaddata_paired	Desulfobacterota_A	11509	P	835	92	927	0.00013
SRR7761325_1_kneaddata_paired	Cyanobacteria	9876	P	807	23	830	0.00011
SRR7761325_1_kneaddata_paired	Verrucomicrobiota	33333	P	562	28	590	0.00008
SRR7761325_1_kneaddata_paired	Firmicutes_B	17289	P	136	4	140	0.00002
SRR7761325_1_kneaddata_paired	Spirochaetota	32587	P	130	0	130	0.00002
SRR7761325_1_kneaddata_paired	Campylobacterota	8700	P	59	0	59	0.00001
SRR7761325_1_kneaddata_paired	Firmicutes_C	17613	P	55	0	55	0.00001
SRR7761325_1_kneaddata_paired	Firmicutes_I	18140	P	54	0	54	0.00001
SRR7761325_1_kneaddata_paired	Deferribacterota	10822	P	15	0	15	0.00000
SRR7761325_1_kneaddata_paired	Elusimicrobiota	11888	P	3	0	3	0.00000
SRR7761325_1_kneaddata_paired	Thermotogota	33086	P	2	0	2	0.00000
SRR7761326_1_kneaddata_paired	Firmicutes_A	14608	P	10811436	47592	10859028	0.61488
SRR7761326_1_kneaddata_paired	Bacteroidota	4587	P	6572456	54158	6626614	0.37522
SRR7761326_1_kneaddata_paired	Firmicutes	12188	P	78773	7090	85863	0.00486
SRR7761326_1_kneaddata_paired	Proteobacteria	22518	P	64922	491	65413	0.00370
SRR7761326_1_kneaddata_paired	Actinobacteriota	615	P	9182	26	9208	0.00052
SRR7761326_1_kneaddata_paired	Verrucomicrobiota	33333	P	6502	316	6818	0.00039
SRR7761326_1_kneaddata_paired	Desulfobacterota_A	11509	P	4027	557	4584	0.00026
SRR7761326_1_kneaddata_paired	Cyanobacteria	9876	P	1721	54	1775	0.00010
SRR7761326_1_kneaddata_paired	Firmicutes_B	17289	P	347	16	363	0.00002
SRR7761326_1_kneaddata_paired	Firmicutes_C	17613	P	201	0	201	0.00001
SRR7761326_1_kneaddata_paired	Spirochaetota	32587	P	195	0	195	0.00001
SRR7761326_1_kneaddata_paired	Firmicutes_I	18140	P	152	0	152	0.00001
SRR7761326_1_kneaddata_paired	Campylobacterota	8700	P	111	0	111	0.00001
SRR7761326_1_kneaddata_paired	Deferribacterota	10822	P	40	0	40	0.00000
SRR7761326_1_kneaddata_paired	Thermotogota	33086	P	19	0	19	0.00000
SRR7761326_1_kneaddata_paired	Elusimicrobiota	11888	P	14	0	14	0.00000
SRR7761327_1_kneaddata_paired	Firmicutes_A	14608	P	10637122	63254	10700376	0.65931
SRR7761327_1_kneaddata_paired	Bacteroidota	4587	P	4720074	34998	4755072	0.29298
SRR7761327_1_kneaddata_paired	Desulfobacterota_A	11509	P	589961	2449	592410	0.03650
SRR7761327_1_kneaddata_paired	Proteobacteria	22518	P	81315	285	81600	0.00503
SRR7761327_1_kneaddata_paired	Firmicutes	12188	P	77174	4723	81897	0.00505
SRR7761327_1_kneaddata_paired	Actinobacteriota	615	P	7779	17	7796	0.00048
SRR7761327_1_kneaddata_paired	Verrucomicrobiota	33333	P	6836	389	7225	0.00045
SRR7761327_1_kneaddata_paired	Cyanobacteria	9876	P	1191	34	1225	0.00008
SRR7761327_1_kneaddata_paired	Spirochaetota	32587	P	959	1	960	0.00006
SRR7761327_1_kneaddata_paired	Firmicutes_B	17289	P	722	31	753	0.00005
SRR7761327_1_kneaddata_paired	Campylobacterota	8700	P	150	0	150	0.00001
SRR7761327_1_kneaddata_paired	Firmicutes_I	18140	P	125	0	125	0.00001
SRR7761327_1_kneaddata_paired	Firmicutes_C	17613	P	111	0	111	0.00001
SRR7761327_1_kneaddata_paired	Deferribacterota	10822	P	29	0	29	0.00000
SRR7761327_1_kneaddata_paired	Thermotogota	33086	P	25	0	25	0.00000
SRR7761327_1_kneaddata_paired	Elusimicrobiota	11888	P	21	0	21	0.00000
SRR7761328_1_kneaddata_paired	Firmicutes_A	14608	P	8816187	48578	8864765	0.53697
SRR7761328_1_kneaddata_paired	Bacteroidota	4587	P	5974853	36218	6011071	0.36411
SRR7761328_1_kneaddata_paired	Desulfobacterota_A	11509	P	878284	2713	880997	0.05336
SRR7761328_1_kneaddata_paired	Firmicutes	12188	P	592993	24808	617801	0.03742
SRR7761328_1_kneaddata_paired	Proteobacteria	22518	P	65679	180	65859	0.00399
SRR7761328_1_kneaddata_paired	Actinobacteriota	615	P	58163	60	58223	0.00353
SRR7761328_1_kneaddata_paired	Verrucomicrobiota	33333	P	5182	317	5499	0.00033
SRR7761328_1_kneaddata_paired	Cyanobacteria	9876	P	2573	98	2671	0.00016
SRR7761328_1_kneaddata_paired	Spirochaetota	32587	P	987	0	987	0.00006
SRR7761328_1_kneaddata_paired	Firmicutes_B	17289	P	651	24	675	0.00004
SRR7761328_1_kneaddata_paired	Campylobacterota	8700	P	125	0	125	0.00001
SRR7761328_1_kneaddata_paired	Firmicutes_I	18140	P	86	0	86	0.00001
SRR7761328_1_kneaddata_paired	Firmicutes_C	17613	P	79	0	79	0.00000
SRR7761328_1_kneaddata_paired	Deferribacterota	10822	P	35	0	35	0.00000
SRR7761328_1_kneaddata_paired	Thermotogota	33086	P	20	0	20	0.00000
SRR7761328_1_kneaddata_paired	Elusimicrobiota	11888	P	15	0	15	0.00000
SRR7761329_1_kneaddata_paired	Firmicutes_A	14608	P	7337853	42951	7380804	0.61648
SRR7761329_1_kneaddata_paired	Bacteroidota	4587	P	4097148	27306	4124454	0.34450
SRR7761329_1_kneaddata_paired	Desulfobacterota_A	11509	P	285629	611	286240	0.02391
SRR7761329_1_kneaddata_paired	Firmicutes	12188	P	67221	3048	70269	0.00587
SRR7761329_1_kneaddata_paired	Verrucomicrobiota	33333	P	55583	861	56444	0.00471
SRR7761329_1_kneaddata_paired	Proteobacteria	22518	P	42278	49	42327	0.00354
SRR7761329_1_kneaddata_paired	Actinobacteriota	615	P	7704	12	7716	0.00064
SRR7761329_1_kneaddata_paired	Deferribacterota	10822	P	2181	6	2187	0.00018
SRR7761329_1_kneaddata_paired	Cyanobacteria	9876	P	878	17	895	0.00007
SRR7761329_1_kneaddata_paired	Firmicutes_B	17289	P	577	16	593	0.00005
SRR7761329_1_kneaddata_paired	Firmicutes_I	18140	P	129	0	129	0.00001
SRR7761329_1_kneaddata_paired	Campylobacterota	8700	P	128	0	128	0.00001
SRR7761329_1_kneaddata_paired	Spirochaetota	32587	P	121	0	121	0.00001
SRR7761329_1_kneaddata_paired	Firmicutes_C	17613	P	115	0	115	0.00001
SRR7761329_1_kneaddata_paired	Elusimicrobiota	11888	P	9	0	9	0.00000
SRR7761329_1_kneaddata_paired	Thermotogota	33086	P	3	0	3	0.00000
SRR7761330_1_kneaddata_paired	Firmicutes_A	14608	P	9302463	32932	9335395	0.58813
SRR7761330_1_kneaddata_paired	Bacteroidota	4587	P	6209461	65423	6274884	0.39532
SRR7761330_1_kneaddata_paired	Firmicutes	12188	P	105916	6521	112437	0.00708
SRR7761330_1_kneaddata_paired	Proteobacteria	22518	P	87083	184	87267	0.00550
SRR7761330_1_kneaddata_paired	Verrucomicrobiota	33333	P	47049	1093	48142	0.00303
SRR7761330_1_kneaddata_paired	Cyanobacteria	9876	P	6720	97	6817	0.00043
SRR7761330_1_kneaddata_paired	Actinobacteriota	615	P	3875	13	3888	0.00024
SRR7761330_1_kneaddata_paired	Desulfobacterota_A	11509	P	2893	455	3348	0.00021
SRR7761330_1_kneaddata_paired	Firmicutes_B	17289	P	310	13	323	0.00002
SRR7761330_1_kneaddata_paired	Firmicutes_I	18140	P	143	0	143	0.00001
SRR7761330_1_kneaddata_paired	Spirochaetota	32587	P	123	0	123	0.00001
SRR7761330_1_kneaddata_paired	Campylobacterota	8700	P	118	0	118	0.00001
SRR7761330_1_kneaddata_paired	Firmicutes_C	17613	P	101	0	101	0.00001
SRR7761330_1_kneaddata_paired	Deferribacterota	10822	P	63	0	63	0.00000
SRR7761330_1_kneaddata_paired	Thermotogota	33086	P	19	0	19	0.00000
SRR7761330_1_kneaddata_paired	Elusimicrobiota	11888	P	9	0	9	0.00000
SRR7761331_1_kneaddata_paired	Firmicutes_A	14608	P	7929308	33585	7962893	0.65791
SRR7761331_1_kneaddata_paired	Bacteroidota	4587	P	3938225	38848	3977073	0.32860
SRR7761331_1_kneaddata_paired	Proteobacteria	22518	P	56314	148	56462	0.00467
SRR7761331_1_kneaddata_paired	Firmicutes	12188	P	51511	1685	53196	0.00440
SRR7761331_1_kneaddata_paired	Verrucomicrobiota	33333	P	46804	844	47648	0.00394
SRR7761331_1_kneaddata_paired	Cyanobacteria	9876	P	1976	35	2011	0.00017
SRR7761331_1_kneaddata_paired	Desulfobacterota_A	11509	P	1711	190	1901	0.00016
SRR7761331_1_kneaddata_paired	Actinobacteriota	615	P	1290	5	1295	0.00011
SRR7761331_1_kneaddata_paired	Firmicutes_B	17289	P	274	10	284	0.00002
SRR7761331_1_kneaddata_paired	Firmicutes_C	17613	P	181	0	181	0.00001
SRR7761331_1_kneaddata_paired	Spirochaetota	32587	P	106	0	106	0.00001
SRR7761331_1_kneaddata_paired	Campylobacterota	8700	P	86	0	86	0.00001
SRR7761331_1_kneaddata_paired	Firmicutes_I	18140	P	85	0	85	0.00001
SRR7761331_1_kneaddata_paired	Deferribacterota	10822	P	29	0	29	0.00000
SRR7761331_1_kneaddata_paired	Thermotogota	33086	P	5	0	5	0.00000
SRR7761331_1_kneaddata_paired	Elusimicrobiota	11888	P	4	0	4	0.00000
SRR7761332_1_kneaddata_paired	Bacteroidota	4587	P	6229858	47572	6277430	0.54127
SRR7761332_1_kneaddata_paired	Firmicutes_A	14608	P	4594502	16351	4610853	0.39757
SRR7761332_1_kneaddata_paired	Verrucomicrobiota	33333	P	445540	6272	451812	0.03896
SRR7761332_1_kneaddata_paired	Proteobacteria	22518	P	177672	352	178024	0.01535
SRR7761332_1_kneaddata_paired	Firmicutes	12188	P	69379	2479	71858	0.00620
SRR7761332_1_kneaddata_paired	Cyanobacteria	9876	P	4571	73	4644	0.00040
SRR7761332_1_kneaddata_paired	Desulfobacterota_A	11509	P	1189	133	1322	0.00011
SRR7761332_1_kneaddata_paired	Actinobacteriota	615	P	968	4	972	0.00008
SRR7761332_1_kneaddata_paired	Campylobacterota	8700	P	273	0	273	0.00002
SRR7761332_1_kneaddata_paired	Firmicutes_B	17289	P	144	4	148	0.00001
SRR7761332_1_kneaddata_paired	Spirochaetota	32587	P	104	0	104	0.00001
SRR7761332_1_kneaddata_paired	Firmicutes_C	17613	P	88	0	88	0.00001
SRR7761332_1_kneaddata_paired	Firmicutes_I	18140	P	52	0	52	0.00000
SRR7761332_1_kneaddata_paired	Deferribacterota	10822	P	36	0	36	0.00000
SRR7761332_1_kneaddata_paired	Thermotogota	33086	P	6	0	6	0.00000
SRR7761332_1_kneaddata_paired	Elusimicrobiota	11888	P	1	0	1	0.00000
SRR7761333_1_kneaddata_paired	Bacteroidota	4587	P	6666183	28365	6694548	0.47590
SRR7761333_1_kneaddata_paired	Firmicutes_A	14608	P	6160611	36990	6197601	0.44057
SRR7761333_1_kneaddata_paired	Desulfobacterota_A	11509	P	666986	1233	668219	0.04750
SRR7761333_1_kneaddata_paired	Firmicutes	12188	P	192108	9040	201148	0.01430
SRR7761333_1_kneaddata_paired	Verrucomicrobiota	33333	P	150906	1793	152699	0.01086
SRR7761333_1_kneaddata_paired	Proteobacteria	22518	P	102855	172	103027	0.00732
SRR7761333_1_kneaddata_paired	Actinobacteriota	615	P	35340	32	35372	0.00251
SRR7761333_1_kneaddata_paired	Cyanobacteria	9876	P	12921	233	13154	0.00094
SRR7761333_1_kneaddata_paired	Firmicutes_B	17289	P	789	21	810	0.00006
SRR7761333_1_kneaddata_paired	Campylobacterota	8700	P	171	0	171	0.00001
SRR7761333_1_kneaddata_paired	Spirochaetota	32587	P	140	0	140	0.00001
SRR7761333_1_kneaddata_paired	Firmicutes_C	17613	P	134	0	134	0.00001
SRR7761333_1_kneaddata_paired	Firmicutes_I	18140	P	77	0	77	0.00001
SRR7761333_1_kneaddata_paired	Deferribacterota	10822	P	52	0	52	0.00000
SRR7761333_1_kneaddata_paired	Elusimicrobiota	11888	P	15	0	15	0.00000
SRR7761333_1_kneaddata_paired	Thermotogota	33086	P	3	0	3	0.00000
SRR7761334_1_kneaddata_paired	Firmicutes_A	14608	P	2720373	10685	2731058	0.46520
SRR7761334_1_kneaddata_paired	Bacteroidota	4587	P	2671788	21736	2693524	0.45881
SRR7761334_1_kneaddata_paired	Desulfobacterota_A	11509	P	311056	592	311648	0.05309
SRR7761334_1_kneaddata_paired	Firmicutes	12188	P	46888	1237	48125	0.00820
SRR7761334_1_kneaddata_paired	Proteobacteria	22518	P	40660	141	40801	0.00695
SRR7761334_1_kneaddata_paired	Cyanobacteria	9876	P	24955	321	25276	0.00431
SRR7761334_1_kneaddata_paired	Verrucomicrobiota	33333	P	18115	260	18375	0.00313
SRR7761334_1_kneaddata_paired	Actinobacteriota	615	P	1531	3	1534	0.00026
SRR7761334_1_kneaddata_paired	Campylobacterota	8700	P	82	0	82	0.00001
SRR7761334_1_kneaddata_paired	Firmicutes_B	17289	P	78	2	80	0.00001
SRR7761334_1_kneaddata_paired	Spirochaetota	32587	P	57	0	57	0.00001
SRR7761334_1_kneaddata_paired	Firmicutes_C	17613	P	49	0	49	0.00001
SRR7761334_1_kneaddata_paired	Firmicutes_I	18140	P	31	0	31	0.00001
SRR7761334_1_kneaddata_paired	Deferribacterota	10822	P	15	0	15	0.00000
SRR7761334_1_kneaddata_paired	Elusimicrobiota	11888	P	5	0	5	0.00000
SRR7761334_1_kneaddata_paired	Thermotogota	33086	P	2	0	2	0.00000
SRR7761335_1_kneaddata_paired	Bacteroidota	4587	P	6282865	32703	6315568	0.51367
SRR7761335_1_kneaddata_paired	Firmicutes_A	14608	P	5645618	39385	5685003	0.46239
SRR7761335_1_kneaddata_paired	Proteobacteria	22518	P	191098	1516	192614	0.01567
SRR7761335_1_kneaddata_paired	Firmicutes	12188	P	59909	3796	63705	0.00518
SRR7761335_1_kneaddata_paired	Verrucomicrobiota	33333	P	22139	348	22487	0.00183
SRR7761335_1_kneaddata_paired	Actinobacteriota	615	P	6894	11	6905	0.00056
SRR7761335_1_kneaddata_paired	Cyanobacteria	9876	P	5660	224	5884	0.00048
SRR7761335_1_kneaddata_paired	Desulfobacterota_A	11509	P	1657	174	1831	0.00015
SRR7761335_1_kneaddata_paired	Firmicutes_B	17289	P	309	10	319	0.00003
SRR7761335_1_kneaddata_paired	Spirochaetota	32587	P	196	0	196	0.00002
SRR7761335_1_kneaddata_paired	Campylobacterota	8700	P	176	0	176	0.00001
SRR7761335_1_kneaddata_paired	Firmicutes_C	17613	P	102	0	102	0.00001
SRR7761335_1_kneaddata_paired	Firmicutes_I	18140	P	80	0	80	0.00001
SRR7761335_1_kneaddata_paired	Deferribacterota	10822	P	35	0	35	0.00000
SRR7761335_1_kneaddata_paired	Elusimicrobiota	11888	P	11	0	11	0.00000
SRR7761335_1_kneaddata_paired	Thermotogota	33086	P	10	0	10	0.00000
SRR7762551_1_kneaddata_paired	Firmicutes_A	14608	P	7337912	42951	7380863	0.61649
SRR7762551_1_kneaddata_paired	Bacteroidota	4587	P	4097105	27305	4124410	0.34449
SRR7762551_1_kneaddata_paired	Desulfobacterota_A	11509	P	285624	610	286234	0.02391
SRR7762551_1_kneaddata_paired	Firmicutes	12188	P	67217	3048	70265	0.00587
SRR7762551_1_kneaddata_paired	Verrucomicrobiota	33333	P	55583	861	56444	0.00471
SRR7762551_1_kneaddata_paired	Proteobacteria	22518	P	42278	49	42327	0.00354
SRR7762551_1_kneaddata_paired	Actinobacteriota	615	P	7703	12	7715	0.00064
SRR7762551_1_kneaddata_paired	Deferribacterota	10822	P	2181	6	2187	0.00018
SRR7762551_1_kneaddata_paired	Cyanobacteria	9876	P	877	17	894	0.00007
SRR7762551_1_kneaddata_paired	Firmicutes_B	17289	P	577	16	593	0.00005
SRR7762551_1_kneaddata_paired	Firmicutes_I	18140	P	129	0	129	0.00001
SRR7762551_1_kneaddata_paired	Campylobacterota	8700	P	128	0	128	0.00001
SRR7762551_1_kneaddata_paired	Spirochaetota	32587	P	121	0	121	0.00001
SRR7762551_1_kneaddata_paired	Firmicutes_C	17613	P	115	0	115	0.00001
SRR7762551_1_kneaddata_paired	Elusimicrobiota	11888	P	9	0	9	0.00000
SRR7762551_1_kneaddata_paired	Thermotogota	33086	P	3	0	3	0.00000
SRR7762552_1_kneaddata_paired	Firmicutes_A	14608	P	10811416	47593	10859009	0.61488
SRR7762552_1_kneaddata_paired	Bacteroidota	4587	P	6572413	54158	6626571	0.37522
SRR7762552_1_kneaddata_paired	Firmicutes	12188	P	78773	7090	85863	0.00486
SRR7762552_1_kneaddata_paired	Proteobacteria	22518	P	64925	491	65416	0.00370
SRR7762552_1_kneaddata_paired	Actinobacteriota	615	P	9181	26	9207	0.00052
SRR7762552_1_kneaddata_paired	Verrucomicrobiota	33333	P	6503	316	6819	0.00039
SRR7762552_1_kneaddata_paired	Desulfobacterota_A	11509	P	4027	557	4584	0.00026
SRR7762552_1_kneaddata_paired	Cyanobacteria	9876	P	1722	54	1776	0.00010
SRR7762552_1_kneaddata_paired	Firmicutes_B	17289	P	347	16	363	0.00002
SRR7762552_1_kneaddata_paired	Firmicutes_C	17613	P	201	0	201	0.00001
SRR7762552_1_kneaddata_paired	Spirochaetota	32587	P	195	0	195	0.00001
SRR7762552_1_kneaddata_paired	Firmicutes_I	18140	P	152	0	152	0.00001
SRR7762552_1_kneaddata_paired	Campylobacterota	8700	P	111	0	111	0.00001
SRR7762552_1_kneaddata_paired	Deferribacterota	10822	P	40	0	40	0.00000
SRR7762552_1_kneaddata_paired	Thermotogota	33086	P	19	0	19	0.00000
SRR7762552_1_kneaddata_paired	Elusimicrobiota	11888	P	14	0	14	0.00000
SRR7762553_1_kneaddata_paired	Firmicutes_A	14608	P	7929332	33584	7962916	0.65791
SRR7762553_1_kneaddata_paired	Bacteroidota	4587	P	3938284	38848	3977132	0.32860
SRR7762553_1_kneaddata_paired	Proteobacteria	22518	P	56317	148	56465	0.00467
SRR7762553_1_kneaddata_paired	Firmicutes	12188	P	51512	1685	53197	0.00440
SRR7762553_1_kneaddata_paired	Verrucomicrobiota	33333	P	46804	843	47647	0.00394
SRR7762553_1_kneaddata_paired	Cyanobacteria	9876	P	1973	35	2008	0.00017
SRR7762553_1_kneaddata_paired	Desulfobacterota_A	11509	P	1711	190	1901	0.00016
SRR7762553_1_kneaddata_paired	Actinobacteriota	615	P	1290	5	1295	0.00011
SRR7762553_1_kneaddata_paired	Firmicutes_B	17289	P	274	10	284	0.00002
SRR7762553_1_kneaddata_paired	Firmicutes_C	17613	P	181	0	181	0.00001
SRR7762553_1_kneaddata_paired	Spirochaetota	32587	P	106	0	106	0.00001
SRR7762553_1_kneaddata_paired	Campylobacterota	8700	P	86	0	86	0.00001
SRR7762553_1_kneaddata_paired	Firmicutes_I	18140	P	85	0	85	0.00001
SRR7762553_1_kneaddata_paired	Deferribacterota	10822	P	29	0	29	0.00000
SRR7762553_1_kneaddata_paired	Thermotogota	33086	P	5	0	5	0.00000
SRR7762553_1_kneaddata_paired	Elusimicrobiota	11888	P	4	0	4	0.00000
SRR7762554_1_kneaddata_paired	Bacteroidota	4587	P	3916865	23067	3939932	0.54244
SRR7762554_1_kneaddata_paired	Firmicutes_A	14608	P	3214176	20116	3234292	0.44529
SRR7762554_1_kneaddata_paired	Proteobacteria	22518	P	45525	270	45795	0.00630
SRR7762554_1_kneaddata_paired	Firmicutes	12188	P	35649	1481	37130	0.00511
SRR7762554_1_kneaddata_paired	Actinobacteriota	615	P	3385	7	3392	0.00047
SRR7762554_1_kneaddata_paired	Desulfobacterota_A	11509	P	835	92	927	0.00013
SRR7762554_1_kneaddata_paired	Cyanobacteria	9876	P	809	23	832	0.00011
SRR7762554_1_kneaddata_paired	Verrucomicrobiota	33333	P	562	28	590	0.00008
SRR7762554_1_kneaddata_paired	Firmicutes_B	17289	P	136	4	140	0.00002
SRR7762554_1_kneaddata_paired	Spirochaetota	32587	P	130	0	130	0.00002
SRR7762554_1_kneaddata_paired	Campylobacterota	8700	P	59	0	59	0.00001
SRR7762554_1_kneaddata_paired	Firmicutes_C	17613	P	55	0	55	0.00001
SRR7762554_1_kneaddata_paired	Firmicutes_I	18140	P	54	0	54	0.00001
SRR7762554_1_kneaddata_paired	Deferribacterota	10822	P	15	0	15	0.00000
SRR7762554_1_kneaddata_paired	Elusimicrobiota	11888	P	3	0	3	0.00000
SRR7762554_1_kneaddata_paired	Thermotogota	33086	P	2	0	2	0.00000
SRR7762555_1_kneaddata_paired	Firmicutes_A	14608	P	10637192	63253	10700445	0.65931
SRR7762555_1_kneaddata_paired	Bacteroidota	4587	P	4720054	34997	4755051	0.29298
SRR7762555_1_kneaddata_paired	Desulfobacterota_A	11509	P	589941	2450	592391	0.03650
SRR7762555_1_kneaddata_paired	Proteobacteria	22518	P	81312	285	81597	0.00503
SRR7762555_1_kneaddata_paired	Firmicutes	12188	P	77173	4722	81895	0.00505
SRR7762555_1_kneaddata_paired	Actinobacteriota	615	P	7778	17	7795	0.00048
SRR7762555_1_kneaddata_paired	Verrucomicrobiota	33333	P	6835	388	7223	0.00045
SRR7762555_1_kneaddata_paired	Cyanobacteria	9876	P	1192	34	1226	0.00008
SRR7762555_1_kneaddata_paired	Spirochaetota	32587	P	959	1	960	0.00006
SRR7762555_1_kneaddata_paired	Firmicutes_B	17289	P	722	31	753	0.00005
SRR7762555_1_kneaddata_paired	Campylobacterota	8700	P	150	0	150	0.00001
SRR7762555_1_kneaddata_paired	Firmicutes_I	18140	P	125	0	125	0.00001
SRR7762555_1_kneaddata_paired	Firmicutes_C	17613	P	111	0	111	0.00001
SRR7762555_1_kneaddata_paired	Deferribacterota	10822	P	29	0	29	0.00000
SRR7762555_1_kneaddata_paired	Thermotogota	33086	P	25	0	25	0.00000
SRR7762555_1_kneaddata_paired	Elusimicrobiota	11888	P	21	0	21	0.00000
SRR7762556_1_kneaddata_paired	Firmicutes_A	14608	P	9302425	32934	9335359	0.58813
SRR7762556_1_kneaddata_paired	Bacteroidota	4587	P	6209471	65424	6274895	0.39532
SRR7762556_1_kneaddata_paired	Firmicutes	12188	P	105916	6522	112438	0.00708
SRR7762556_1_kneaddata_paired	Proteobacteria	22518	P	87078	184	87262	0.00550
SRR7762556_1_kneaddata_paired	Verrucomicrobiota	33333	P	47047	1093	48140	0.00303
SRR7762556_1_kneaddata_paired	Cyanobacteria	9876	P	6721	97	6818	0.00043
SRR7762556_1_kneaddata_paired	Actinobacteriota	615	P	3875	13	3888	0.00024
SRR7762556_1_kneaddata_paired	Desulfobacterota_A	11509	P	2893	455	3348	0.00021
SRR7762556_1_kneaddata_paired	Firmicutes_B	17289	P	310	13	323	0.00002
SRR7762556_1_kneaddata_paired	Firmicutes_I	18140	P	143	0	143	0.00001
SRR7762556_1_kneaddata_paired	Spirochaetota	32587	P	123	0	123	0.00001
SRR7762556_1_kneaddata_paired	Campylobacterota	8700	P	118	0	118	0.00001
SRR7762556_1_kneaddata_paired	Firmicutes_C	17613	P	101	0	101	0.00001
SRR7762556_1_kneaddata_paired	Deferribacterota	10822	P	63	0	63	0.00000
SRR7762556_1_kneaddata_paired	Thermotogota	33086	P	19	0	19	0.00000
SRR7762556_1_kneaddata_paired	Elusimicrobiota	11888	P	9	0	9	0.00000
SRR7762557_1_kneaddata_paired	Bacteroidota	4587	P	6229861	47572	6277433	0.54127
SRR7762557_1_kneaddata_paired	Firmicutes_A	14608	P	4594521	16351	4610872	0.39757
SRR7762557_1_kneaddata_paired	Verrucomicrobiota	33333	P	445533	6272	451805	0.03896
SRR7762557_1_kneaddata_paired	Proteobacteria	22518	P	177673	352	178025	0.01535
SRR7762557_1_kneaddata_paired	Firmicutes	12188	P	69376	2479	71855	0.00620
SRR7762557_1_kneaddata_paired	Cyanobacteria	9876	P	4573	73	4646	0.00040
SRR7762557_1_kneaddata_paired	Desulfobacterota_A	11509	P	1189	133	1322	0.00011
SRR7762557_1_kneaddata_paired	Actinobacteriota	615	P	968	4	972	0.00008
SRR7762557_1_kneaddata_paired	Campylobacterota	8700	P	273	0	273	0.00002
SRR7762557_1_kneaddata_paired	Firmicutes_B	17289	P	144	4	148	0.00001
SRR7762557_1_kneaddata_paired	Spirochaetota	32587	P	104	0	104	0.00001
SRR7762557_1_kneaddata_paired	Firmicutes_C	17613	P	88	0	88	0.00001
SRR7762557_1_kneaddata_paired	Firmicutes_I	18140	P	52	0	52	0.00000
SRR7762557_1_kneaddata_paired	Deferribacterota	10822	P	36	0	36	0.00000
SRR7762557_1_kneaddata_paired	Thermotogota	33086	P	6	0	6	0.00000
SRR7762557_1_kneaddata_paired	Elusimicrobiota	11888	P	1	0	1	0.00000
SRR7762558_1_kneaddata_paired	Bacteroidota	4587	P	8364216	41641	8405857	0.45959
SRR7762558_1_kneaddata_paired	Firmicutes_A	14608	P	7999214	44372	8043586	0.43978
SRR7762558_1_kneaddata_paired	Desulfobacterota_A	11509	P	932484	2511	934995	0.05112
SRR7762558_1_kneaddata_paired	Firmicutes	12188	P	642598	27182	669780	0.03662
SRR7762558_1_kneaddata_paired	Proteobacteria	22518	P	145644	350	145994	0.00798
SRR7762558_1_kneaddata_paired	Actinobacteriota	615	P	62528	59	62587	0.00342
SRR7762558_1_kneaddata_paired	Verrucomicrobiota	33333	P	14806	403	15209	0.00083
SRR7762558_1_kneaddata_paired	Cyanobacteria	9876	P	9458	387	9845	0.00054
SRR7762558_1_kneaddata_paired	Spirochaetota	32587	P	1229	1	1230	0.00007
SRR7762558_1_kneaddata_paired	Firmicutes_B	17289	P	483	16	499	0.00003
SRR7762558_1_kneaddata_paired	Campylobacterota	8700	P	174	0	174	0.00001
SRR7762558_1_kneaddata_paired	Firmicutes_I	18140	P	103	0	103	0.00001
SRR7762558_1_kneaddata_paired	Firmicutes_C	17613	P	72	0	72	0.00000
SRR7762558_1_kneaddata_paired	Deferribacterota	10822	P	33	0	33	0.00000
SRR7762558_1_kneaddata_paired	Elusimicrobiota	11888	P	16	0	16	0.00000
SRR7762558_1_kneaddata_paired	Thermotogota	33086	P	12	0	12	0.00000
SRR7762559_1_kneaddata_paired	Bacteroidota	4587	P	6666162	28365	6694527	0.47590
SRR7762559_1_kneaddata_paired	Firmicutes_A	14608	P	6160583	36989	6197572	0.44057
SRR7762559_1_kneaddata_paired	Desulfobacterota_A	11509	P	666992	1233	668225	0.04750
SRR7762559_1_kneaddata_paired	Firmicutes	12188	P	192105	9040	201145	0.01430
SRR7762559_1_kneaddata_paired	Verrucomicrobiota	33333	P	150914	1793	152707	0.01086
SRR7762559_1_kneaddata_paired	Proteobacteria	22518	P	102855	172	103027	0.00732
SRR7762559_1_kneaddata_paired	Actinobacteriota	615	P	35339	32	35371	0.00251
SRR7762559_1_kneaddata_paired	Cyanobacteria	9876	P	12917	233	13150	0.00093
SRR7762559_1_kneaddata_paired	Firmicutes_B	17289	P	790	21	811	0.00006
SRR7762559_1_kneaddata_paired	Campylobacterota	8700	P	171	0	171	0.00001
SRR7762559_1_kneaddata_paired	Spirochaetota	32587	P	140	0	140	0.00001
SRR7762559_1_kneaddata_paired	Firmicutes_C	17613	P	134	0	134	0.00001
SRR7762559_1_kneaddata_paired	Firmicutes_I	18140	P	77	0	77	0.00001
SRR7762559_1_kneaddata_paired	Deferribacterota	10822	P	52	0	52	0.00000
SRR7762559_1_kneaddata_paired	Elusimicrobiota	11888	P	15	0	15	0.00000
SRR7762559_1_kneaddata_paired	Thermotogota	33086	P	3	0	3	0.00000
SRR7762560_1_kneaddata_paired	Firmicutes_A	14608	P	8372858	48534	8421392	0.70174
SRR7762560_1_kneaddata_paired	Bacteroidota	4587	P	2801522	19713	2821235	0.23509
SRR7762560_1_kneaddata_paired	Desulfobacterota_A	11509	P	658001	2309	660310	0.05502
SRR7762560_1_kneaddata_paired	Firmicutes	12188	P	56829	2195	59024	0.00492
SRR7762560_1_kneaddata_paired	Proteobacteria	22518	P	25478	81	25559	0.00213
SRR7762560_1_kneaddata_paired	Actinobacteriota	615	P	5564	10	5574	0.00046
SRR7762560_1_kneaddata_paired	Verrucomicrobiota	33333	P	3936	246	4182	0.00035
SRR7762560_1_kneaddata_paired	Cyanobacteria	9876	P	1224	40	1264	0.00011
SRR7762560_1_kneaddata_paired	Spirochaetota	32587	P	1192	1	1193	0.00010
SRR7762560_1_kneaddata_paired	Firmicutes_B	17289	P	622	25	647	0.00005
SRR7762560_1_kneaddata_paired	Campylobacterota	8700	P	92	0	92	0.00001
SRR7762560_1_kneaddata_paired	Firmicutes_C	17613	P	90	0	90	0.00001
SRR7762560_1_kneaddata_paired	Firmicutes_I	18140	P	68	0	68	0.00001
SRR7762560_1_kneaddata_paired	Deferribacterota	10822	P	18	0	18	0.00000
SRR7762560_1_kneaddata_paired	Thermotogota	33086	P	14	0	14	0.00000
SRR7762560_1_kneaddata_paired	Elusimicrobiota	11888	P	13	0	13	0.00000
SRR7762561_1_kneaddata_paired	Firmicutes_A	14608	P	4138158	19573	4157731	0.46779
SRR7762561_1_kneaddata_paired	Bacteroidota	4587	P	3472990	17289	3490279	0.39269
SRR7762561_1_kneaddata_paired	Desulfobacterota_A	11509	P	703781	1727	705508	0.07938
SRR7762561_1_kneaddata_paired	Firmicutes	12188	P	426041	16090	442131	0.04974
SRR7762561_1_kneaddata_paired	Actinobacteriota	615	P	45686	38	45724	0.00514
SRR7762561_1_kneaddata_paired	Proteobacteria	22518	P	42117	68	42185	0.00475
SRR7762561_1_kneaddata_paired	Verrucomicrobiota	33333	P	2355	111	2466	0.00028
SRR7762561_1_kneaddata_paired	Spirochaetota	32587	P	941	0	941	0.00011
SRR7762561_1_kneaddata_paired	Cyanobacteria	9876	P	672	11	683	0.00008
SRR7762561_1_kneaddata_paired	Firmicutes_B	17289	P	231	7	238	0.00003
SRR7762561_1_kneaddata_paired	Campylobacterota	8700	P	56	0	56	0.00001
SRR7762561_1_kneaddata_paired	Firmicutes_I	18140	P	50	0	50	0.00001
SRR7762561_1_kneaddata_paired	Firmicutes_C	17613	P	49	0	49	0.00001
SRR7762561_1_kneaddata_paired	Deferribacterota	10822	P	14	0	14	0.00000
SRR7762561_1_kneaddata_paired	Elusimicrobiota	11888	P	13	0	13	0.00000
SRR7762561_1_kneaddata_paired	Thermotogota	33086	P	7	0	7	0.00000
SRR7762562_1_kneaddata_paired	Firmicutes_A	14608	P	8816279	48579	8864858	0.53697
SRR7762562_1_kneaddata_paired	Bacteroidota	4587	P	5974897	36217	6011114	0.36411
SRR7762562_1_kneaddata_paired	Desulfobacterota_A	11509	P	878275	2713	880988	0.05336
SRR7762562_1_kneaddata_paired	Firmicutes	12188	P	592999	24808	617807	0.03742
SRR7762562_1_kneaddata_paired	Proteobacteria	22518	P	65676	180	65856	0.00399
SRR7762562_1_kneaddata_paired	Actinobacteriota	615	P	58161	60	58221	0.00353
SRR7762562_1_kneaddata_paired	Verrucomicrobiota	33333	P	5182	317	5499	0.00033
SRR7762562_1_kneaddata_paired	Cyanobacteria	9876	P	2572	98	2670	0.00016
SRR7762562_1_kneaddata_paired	Spirochaetota	32587	P	987	0	987	0.00006
SRR7762562_1_kneaddata_paired	Firmicutes_B	17289	P	651	24	675	0.00004
SRR7762562_1_kneaddata_paired	Campylobacterota	8700	P	125	0	125	0.00001
SRR7762562_1_kneaddata_paired	Firmicutes_I	18140	P	86	0	86	0.00001
SRR7762562_1_kneaddata_paired	Firmicutes_C	17613	P	79	0	79	0.00000
SRR7762562_1_kneaddata_paired	Deferribacterota	10822	P	35	0	35	0.00000
SRR7762562_1_kneaddata_paired	Thermotogota	33086	P	20	0	20	0.00000
SRR7762562_1_kneaddata_paired	Elusimicrobiota	11888	P	15	0	15	0.00000
SRR7762563_1_kneaddata_paired	Firmicutes_A	14608	P	2720425	10684	2731109	0.46520
SRR7762563_1_kneaddata_paired	Bacteroidota	4587	P	2671863	21733	2693596	0.45881
SRR7762563_1_kneaddata_paired	Desulfobacterota_A	11509	P	311054	592	311646	0.05308
SRR7762563_1_kneaddata_paired	Firmicutes	12188	P	46887	1236	48123	0.00820
SRR7762563_1_kneaddata_paired	Proteobacteria	22518	P	40665	141	40806	0.00695
SRR7762563_1_kneaddata_paired	Cyanobacteria	9876	P	24961	321	25282	0.00431
SRR7762563_1_kneaddata_paired	Verrucomicrobiota	33333	P	18114	260	18374	0.00313
SRR7762563_1_kneaddata_paired	Actinobacteriota	615	P	1531	3	1534	0.00026
SRR7762563_1_kneaddata_paired	Campylobacterota	8700	P	82	0	82	0.00001
SRR7762563_1_kneaddata_paired	Firmicutes_B	17289	P	78	2	80	0.00001
SRR7762563_1_kneaddata_paired	Spirochaetota	32587	P	57	0	57	0.00001
SRR7762563_1_kneaddata_paired	Firmicutes_C	17613	P	49	0	49	0.00001
SRR7762563_1_kneaddata_paired	Firmicutes_I	18140	P	31	0	31	0.00001
SRR7762563_1_kneaddata_paired	Deferribacterota	10822	P	15	0	15	0.00000
SRR7762563_1_kneaddata_paired	Elusimicrobiota	11888	P	5	0	5	0.00000
SRR7762563_1_kneaddata_paired	Thermotogota	33086	P	2	0	2	0.00000
SRR7762564_1_kneaddata_paired	Bacteroidota	4587	P	7725913	51965	7777878	0.48435
SRR7762564_1_kneaddata_paired	Firmicutes_A	14608	P	7158145	29584	7187729	0.44760
SRR7762564_1_kneaddata_paired	Verrucomicrobiota	33333	P	698036	9502	707538	0.04406
SRR7762564_1_kneaddata_paired	Proteobacteria	22518	P	171119	727	171846	0.01070
SRR7762564_1_kneaddata_paired	Firmicutes	12188	P	132990	1254	134244	0.00836
SRR7762564_1_kneaddata_paired	Cyanobacteria	9876	P	73890	1014	74904	0.00466
SRR7762564_1_kneaddata_paired	Desulfobacterota_A	11509	P	2126	233	2359	0.00015
SRR7762564_1_kneaddata_paired	Actinobacteriota	615	P	1006	2	1008	0.00006
SRR7762564_1_kneaddata_paired	Campylobacterota	8700	P	304	0	304	0.00002
SRR7762564_1_kneaddata_paired	Spirochaetota	32587	P	121	0	121	0.00001
SRR7762564_1_kneaddata_paired	Firmicutes_I	18140	P	89	0	89	0.00001
SRR7762564_1_kneaddata_paired	Firmicutes_B	17289	P	81	2	83	0.00001
SRR7762564_1_kneaddata_paired	Firmicutes_C	17613	P	81	0	81	0.00001
SRR7762564_1_kneaddata_paired	Deferribacterota	10822	P	21	0	21	0.00000
SRR7762564_1_kneaddata_paired	Elusimicrobiota	11888	P	10	0	10	0.00000
SRR7762564_1_kneaddata_paired	Thermotogota	33086	P	2	0	2	0.00000
SRR7762565_1_kneaddata_paired	Bacteroidota	4587	P	6282900	32705	6315605	0.51367
SRR7762565_1_kneaddata_paired	Firmicutes_A	14608	P	5645609	39387	5684996	0.46238
SRR7762565_1_kneaddata_paired	Proteobacteria	22518	P	191092	1516	192608	0.01567
SRR7762565_1_kneaddata_paired	Firmicutes	12188	P	59912	3797	63709	0.00518
SRR7762565_1_kneaddata_paired	Verrucomicrobiota	33333	P	22139	348	22487	0.00183
SRR7762565_1_kneaddata_paired	Actinobacteriota	615	P	6893	11	6904	0.00056
SRR7762565_1_kneaddata_paired	Cyanobacteria	9876	P	5657	224	5881	0.00048
SRR7762565_1_kneaddata_paired	Desulfobacterota_A	11509	P	1657	174	1831	0.00015
SRR7762565_1_kneaddata_paired	Firmicutes_B	17289	P	309	10	319	0.00003
SRR7762565_1_kneaddata_paired	Spirochaetota	32587	P	196	0	196	0.00002
SRR7762565_1_kneaddata_paired	Campylobacterota	8700	P	176	0	176	0.00001
SRR7762565_1_kneaddata_paired	Firmicutes_C	17613	P	102	0	102	0.00001
SRR7762565_1_kneaddata_paired	Firmicutes_I	18140	P	80	0	80	0.00001
SRR7762565_1_kneaddata_paired	Deferribacterota	10822	P	35	0	35	0.00000
SRR7762565_1_kneaddata_paired	Elusimicrobiota	11888	P	11	0	11	0.00000
SRR7762565_1_kneaddata_paired	Thermotogota	33086	P	10	0	10	0.00000
SRR7762566_1_kneaddata_paired	Firmicutes_A	14608	P	5683862	26127	5709989	0.61062
SRR7762566_1_kneaddata_paired	Bacteroidota	4587	P	3261782	27514	3289296	0.35175
SRR7762566_1_kneaddata_paired	Proteobacteria	22518	P	152601	427	153028	0.01636
SRR7762566_1_kneaddata_paired	Firmicutes	12188	P	101623	6043	107666	0.01151
SRR7762566_1_kneaddata_paired	Verrucomicrobiota	33333	P	85499	1514	87013	0.00931
SRR7762566_1_kneaddata_paired	Desulfobacterota_A	11509	P	1308	154	1462	0.00016
SRR7762566_1_kneaddata_paired	Cyanobacteria	9876	P	1216	26	1242	0.00013
SRR7762566_1_kneaddata_paired	Actinobacteriota	615	P	959	4	963	0.00010
SRR7762566_1_kneaddata_paired	Firmicutes_B	17289	P	140	5	145	0.00002
SRR7762566_1_kneaddata_paired	Firmicutes_C	17613	P	121	0	121	0.00001
SRR7762566_1_kneaddata_paired	Campylobacterota	8700	P	106	0	106	0.00001
SRR7762566_1_kneaddata_paired	Spirochaetota	32587	P	81	0	81	0.00001
SRR7762566_1_kneaddata_paired	Firmicutes_I	18140	P	51	0	51	0.00001
SRR7762566_1_kneaddata_paired	Deferribacterota	10822	P	26	0	26	0.00000
SRR7762566_1_kneaddata_paired	Elusimicrobiota	11888	P	4	0	4	0.00000
SRR7762566_1_kneaddata_paired	Thermotogota	33086	P	3	0	3	0.00000
SRR7981748_1_kneaddata_paired	Bacteroidota	4587	P	6671198	31550	6702748	0.52108
SRR7981748_1_kneaddata_paired	Firmicutes_A	14608	P	5947087	27741	5974828	0.46449
SRR7981748_1_kneaddata_paired	Firmicutes	12188	P	106870	805	107675	0.00837
SRR7981748_1_kneaddata_paired	Desulfobacterota_A	11509	P	20351	122	20473	0.00159
SRR7981748_1_kneaddata_paired	Actinobacteriota	615	P	16049	46	16095	0.00125
SRR7981748_1_kneaddata_paired	Deferribacterota	10822	P	13953	39	13992	0.00109
SRR7981748_1_kneaddata_paired	Proteobacteria	22518	P	13186	56	13242	0.00103
SRR7981748_1_kneaddata_paired	Cyanobacteria	9876	P	11846	78	11924	0.00093
SRR7981748_1_kneaddata_paired	Verrucomicrobiota	33333	P	970	40	1010	0.00008
SRR7981748_1_kneaddata_paired	Firmicutes_B	17289	P	433	12	445	0.00003
SRR7981748_1_kneaddata_paired	Campylobacterota	8700	P	231	0	231	0.00002
SRR7981748_1_kneaddata_paired	Spirochaetota	32587	P	230	0	230	0.00002
SRR7981748_1_kneaddata_paired	Firmicutes_I	18140	P	108	0	108	0.00001
SRR7981748_1_kneaddata_paired	Firmicutes_C	17613	P	107	0	107	0.00001
SRR7981748_1_kneaddata_paired	Elusimicrobiota	11888	P	73	0	73	0.00001
SRR7981748_1_kneaddata_paired	Thermotogota	33086	P	9	0	9	0.00000
SRR7981749_1_kneaddata_paired	Bacteroidota	4587	P	11981127	61948	12043075	0.84744
SRR7981749_1_kneaddata_paired	Firmicutes_A	14608	P	1830799	20778	1851577	0.13029
SRR7981749_1_kneaddata_paired	Firmicutes	12188	P	118368	1091	119459	0.00841
SRR7981749_1_kneaddata_paired	Deferribacterota	10822	P	71380	230	71610	0.00504
SRR7981749_1_kneaddata_paired	Actinobacteriota	615	P	41697	267	41964	0.00295
SRR7981749_1_kneaddata_paired	Proteobacteria	22518	P	32641	39	32680	0.00230
SRR7981749_1_kneaddata_paired	Desulfobacterota_A	11509	P	30648	47	30695	0.00216
SRR7981749_1_kneaddata_paired	Cyanobacteria	9876	P	18491	109	18600	0.00131
SRR7981749_1_kneaddata_paired	Verrucomicrobiota	33333	P	434	19	453	0.00003
SRR7981749_1_kneaddata_paired	Spirochaetota	32587	P	280	0	280	0.00002
SRR7981749_1_kneaddata_paired	Campylobacterota	8700	P	233	0	233	0.00002
SRR7981749_1_kneaddata_paired	Firmicutes_B	17289	P	164	5	169	0.00001
SRR7981749_1_kneaddata_paired	Firmicutes_I	18140	P	104	0	104	0.00001
SRR7981749_1_kneaddata_paired	Elusimicrobiota	11888	P	99	0	99	0.00001
SRR7981749_1_kneaddata_paired	Firmicutes_C	17613	P	38	0	38	0.00000
SRR7981749_1_kneaddata_paired	Thermotogota	33086	P	9	0	9	0.00000
SRR7981750_1_kneaddata_paired	Bacteroidota	4587	P	10841337	30947	10872284	0.79401
SRR7981750_1_kneaddata_paired	Firmicutes_A	14608	P	1669172	16156	1685328	0.12308
SRR7981750_1_kneaddata_paired	Verrucomicrobiota	33333	P	689963	40460	730423	0.05334
SRR7981750_1_kneaddata_paired	Firmicutes	12188	P	309239	2877	312116	0.02279
SRR7981750_1_kneaddata_paired	Desulfobacterota_A	11509	P	35887	52	35939	0.00262
SRR7981750_1_kneaddata_paired	Proteobacteria	22518	P	31377	116	31493	0.00230
SRR7981750_1_kneaddata_paired	Actinobacteriota	615	P	20924	330	21254	0.00155
SRR7981750_1_kneaddata_paired	Cyanobacteria	9876	P	1737	31	1768	0.00013
SRR7981750_1_kneaddata_paired	Firmicutes_B	17289	P	960	35	995	0.00007
SRR7981750_1_kneaddata_paired	Campylobacterota	8700	P	461	0	461	0.00003
SRR7981750_1_kneaddata_paired	Spirochaetota	32587	P	281	0	281	0.00002
SRR7981750_1_kneaddata_paired	Deferribacterota	10822	P	271	0	271	0.00002
SRR7981750_1_kneaddata_paired	Firmicutes_I	18140	P	112	0	112	0.00001
SRR7981750_1_kneaddata_paired	Elusimicrobiota	11888	P	68	0	68	0.00000
SRR7981750_1_kneaddata_paired	Firmicutes_C	17613	P	58	0	58	0.00000
SRR7981750_1_kneaddata_paired	Thermotogota	33086	P	55	0	55	0.00000
SRR7981751_1_kneaddata_paired	Bacteroidota	4587	P	12394134	69345	12463479	0.79131
SRR7981751_1_kneaddata_paired	Firmicutes_A	14608	P	2914673	25622	2940295	0.18668
SRR7981751_1_kneaddata_paired	Firmicutes	12188	P	177476	1321	178797	0.01135
SRR7981751_1_kneaddata_paired	Actinobacteriota	615	P	81192	958	82150	0.00522
SRR7981751_1_kneaddata_paired	Desulfobacterota_A	11509	P	30737	80	30817	0.00196
SRR7981751_1_kneaddata_paired	Proteobacteria	22518	P	23627	43	23670	0.00150
SRR7981751_1_kneaddata_paired	Deferribacterota	10822	P	16247	52	16299	0.00103
SRR7981751_1_kneaddata_paired	Cyanobacteria	9876	P	12983	99	13082	0.00083
SRR7981751_1_kneaddata_paired	Verrucomicrobiota	33333	P	461	19	480	0.00003
SRR7981751_1_kneaddata_paired	Spirochaetota	32587	P	417	0	417	0.00003
SRR7981751_1_kneaddata_paired	Campylobacterota	8700	P	296	0	296	0.00002
SRR7981751_1_kneaddata_paired	Firmicutes_B	17289	P	230	7	237	0.00002
SRR7981751_1_kneaddata_paired	Elusimicrobiota	11888	P	144	0	144	0.00001
SRR7981751_1_kneaddata_paired	Firmicutes_C	17613	P	84	0	84	0.00001
SRR7981751_1_kneaddata_paired	Firmicutes_I	18140	P	76	0	76	0.00000
SRR7981751_1_kneaddata_paired	Thermotogota	33086	P	10	0	10	0.00000
SRR7981752_1_kneaddata_paired	Firmicutes_A	14608	P	8605062	39087	8644149	0.50240
SRR7981752_1_kneaddata_paired	Bacteroidota	4587	P	7015656	37966	7053622	0.40996
SRR7981752_1_kneaddata_paired	Firmicutes	12188	P	566616	8428	575044	0.03342
SRR7981752_1_kneaddata_paired	Deferribacterota	10822	P	552321	1678	553999	0.03220
SRR7981752_1_kneaddata_paired	Desulfobacterota_A	11509	P	207405	278	207683	0.01207
SRR7981752_1_kneaddata_paired	Actinobacteriota	615	P	138911	888	139799	0.00813
SRR7981752_1_kneaddata_paired	Cyanobacteria	9876	P	16483	197	16680	0.00097
SRR7981752_1_kneaddata_paired	Proteobacteria	22518	P	10871	36	10907	0.00063
SRR7981752_1_kneaddata_paired	Verrucomicrobiota	33333	P	1434	62	1496	0.00009
SRR7981752_1_kneaddata_paired	Spirochaetota	32587	P	806	1	807	0.00005
SRR7981752_1_kneaddata_paired	Campylobacterota	8700	P	601	0	601	0.00003
SRR7981752_1_kneaddata_paired	Firmicutes_B	17289	P	547	16	563	0.00003
SRR7981752_1_kneaddata_paired	Firmicutes_I	18140	P	223	0	223	0.00001
SRR7981752_1_kneaddata_paired	Firmicutes_C	17613	P	116	0	116	0.00001
SRR7981752_1_kneaddata_paired	Elusimicrobiota	11888	P	90	0	90	0.00001
SRR7981752_1_kneaddata_paired	Thermotogota	33086	P	21	0	21	0.00000
SRR7981753_1_kneaddata_paired	Bacteroidota	4587	P	12286397	58737	12345134	0.80090
SRR7981753_1_kneaddata_paired	Firmicutes_A	14608	P	2868055	22079	2890134	0.18750
SRR7981753_1_kneaddata_paired	Firmicutes	12188	P	89600	1053	90653	0.00588
SRR7981753_1_kneaddata_paired	Proteobacteria	22518	P	24247	32	24279	0.00158
SRR7981753_1_kneaddata_paired	Desulfobacterota_A	11509	P	20576	55	20631	0.00134
SRR7981753_1_kneaddata_paired	Actinobacteriota	615	P	18338	62	18400	0.00119
SRR7981753_1_kneaddata_paired	Cyanobacteria	9876	P	16423	174	16597	0.00108
SRR7981753_1_kneaddata_paired	Deferribacterota	10822	P	6937	21	6958	0.00045
SRR7981753_1_kneaddata_paired	Verrucomicrobiota	33333	P	504	22	526	0.00003
SRR7981753_1_kneaddata_paired	Firmicutes_B	17289	P	179	5	184	0.00001
SRR7981753_1_kneaddata_paired	Campylobacterota	8700	P	171	0	171	0.00001
SRR7981753_1_kneaddata_paired	Spirochaetota	32587	P	137	0	137	0.00001
SRR7981753_1_kneaddata_paired	Elusimicrobiota	11888	P	119	0	119	0.00001
SRR7981753_1_kneaddata_paired	Firmicutes_I	18140	P	97	0	97	0.00001
SRR7981753_1_kneaddata_paired	Firmicutes_C	17613	P	45	0	45	0.00000
SRR7981753_1_kneaddata_paired	Thermotogota	33086	P	14	0	14	0.00000
SRR7981754_1_kneaddata_paired	Bacteroidota	4587	P	10519265	29614	10548879	0.65299
SRR7981754_1_kneaddata_paired	Firmicutes_A	14608	P	4389221	27215	4416436	0.27338
SRR7981754_1_kneaddata_paired	Verrucomicrobiota	33333	P	752105	42542	794647	0.04919
SRR7981754_1_kneaddata_paired	Firmicutes	12188	P	251958	2358	254316	0.01574
SRR7981754_1_kneaddata_paired	Desulfobacterota_A	11509	P	68544	114	68658	0.00425
SRR7981754_1_kneaddata_paired	Actinobacteriota	615	P	40753	770	41523	0.00257
SRR7981754_1_kneaddata_paired	Proteobacteria	22518	P	26608	107	26715	0.00165
SRR7981754_1_kneaddata_paired	Firmicutes_B	17289	P	1484	52	1536	0.00010
SRR7981754_1_kneaddata_paired	Cyanobacteria	9876	P	867	14	881	0.00005
SRR7981754_1_kneaddata_paired	Campylobacterota	8700	P	336	0	336	0.00002
SRR7981754_1_kneaddata_paired	Spirochaetota	32587	P	258	0	258	0.00002
SRR7981754_1_kneaddata_paired	Firmicutes_I	18140	P	148	0	148	0.00001
SRR7981754_1_kneaddata_paired	Deferribacterota	10822	P	134	0	134	0.00001
SRR7981754_1_kneaddata_paired	Thermotogota	33086	P	85	0	85	0.00001
SRR7981754_1_kneaddata_paired	Elusimicrobiota	11888	P	62	0	62	0.00000
SRR7981754_1_kneaddata_paired	Firmicutes_C	17613	P	46	0	46	0.00000
SRR7981755_1_kneaddata_paired	Bacteroidota	4587	P	8753597	21585	8775182	0.50219
SRR7981755_1_kneaddata_paired	Firmicutes_A	14608	P	5293501	26006	5319507	0.30443
SRR7981755_1_kneaddata_paired	Firmicutes	12188	P	1519113	6887	1526000	0.08733
SRR7981755_1_kneaddata_paired	Verrucomicrobiota	33333	P	954480	48832	1003312	0.05742
SRR7981755_1_kneaddata_paired	Desulfobacterota_A	11509	P	547494	407	547901	0.03136
SRR7981755_1_kneaddata_paired	Actinobacteriota	615	P	280836	4286	285122	0.01632
SRR7981755_1_kneaddata_paired	Proteobacteria	22518	P	10545	78	10623	0.00061
SRR7981755_1_kneaddata_paired	Firmicutes_B	17289	P	2348	75	2423	0.00014
SRR7981755_1_kneaddata_paired	Cyanobacteria	9876	P	1134	20	1154	0.00007
SRR7981755_1_kneaddata_paired	Spirochaetota	32587	P	922	0	922	0.00005
SRR7981755_1_kneaddata_paired	Campylobacterota	8700	P	902	0	902	0.00005
SRR7981755_1_kneaddata_paired	Deferribacterota	10822	P	306	0	306	0.00002
SRR7981755_1_kneaddata_paired	Firmicutes_I	18140	P	211	0	211	0.00001
SRR7981755_1_kneaddata_paired	Firmicutes_C	17613	P	106	0	106	0.00001
SRR7981755_1_kneaddata_paired	Elusimicrobiota	11888	P	82	0	82	0.00000
SRR7981755_1_kneaddata_paired	Thermotogota	33086	P	51	0	51	0.00000
SRR7981756_1_kneaddata_paired	Bacteroidota	4587	P	10297296	29915	10327211	0.72195
SRR7981756_1_kneaddata_paired	Firmicutes_A	14608	P	2695431	22355	2717786	0.18999
SRR7981756_1_kneaddata_paired	Verrucomicrobiota	33333	P	683916	42109	726025	0.05075
SRR7981756_1_kneaddata_paired	Firmicutes	12188	P	402199	3593	405792	0.02837
SRR7981756_1_kneaddata_paired	Desulfobacterota_A	11509	P	46564	86	46650	0.00326
SRR7981756_1_kneaddata_paired	Actinobacteriota	615	P	45066	815	45881	0.00321
SRR7981756_1_kneaddata_paired	Proteobacteria	22518	P	30554	123	30677	0.00214
SRR7981756_1_kneaddata_paired	Cyanobacteria	9876	P	2304	45	2349	0.00016
SRR7981756_1_kneaddata_paired	Firmicutes_B	17289	P	787	30	817	0.00006
SRR7981756_1_kneaddata_paired	Campylobacterota	8700	P	496	0	496	0.00003
SRR7981756_1_kneaddata_paired	Spirochaetota	32587	P	300	0	300	0.00002
SRR7981756_1_kneaddata_paired	Deferribacterota	10822	P	276	0	276	0.00002
SRR7981756_1_kneaddata_paired	Firmicutes_I	18140	P	138	0	138	0.00001
SRR7981756_1_kneaddata_paired	Firmicutes_C	17613	P	83	0	83	0.00001
SRR7981756_1_kneaddata_paired	Elusimicrobiota	11888	P	62	0	62	0.00000
SRR7981756_1_kneaddata_paired	Thermotogota	33086	P	39	0	39	0.00000
SRR7981757_1_kneaddata_paired	Bacteroidota	4587	P	8905447	26202	8931649	0.55830
SRR7981757_1_kneaddata_paired	Firmicutes_A	14608	P	5935084	33949	5969033	0.37311
SRR7981757_1_kneaddata_paired	Verrucomicrobiota	33333	P	562360	32658	595018	0.03719
SRR7981757_1_kneaddata_paired	Firmicutes	12188	P	283292	2958	286250	0.01789
SRR7981757_1_kneaddata_paired	Desulfobacterota_A	11509	P	155091	274	155365	0.00971
SRR7981757_1_kneaddata_paired	Actinobacteriota	615	P	34516	778	35294	0.00221
SRR7981757_1_kneaddata_paired	Proteobacteria	22518	P	20148	93	20241	0.00127
SRR7981757_1_kneaddata_paired	Firmicutes_B	17289	P	3004	109	3113	0.00019
SRR7981757_1_kneaddata_paired	Cyanobacteria	9876	P	791	12	803	0.00005
SRR7981757_1_kneaddata_paired	Spirochaetota	32587	P	321	0	321	0.00002
SRR7981757_1_kneaddata_paired	Campylobacterota	8700	P	292	0	292	0.00002
SRR7981757_1_kneaddata_paired	Firmicutes_I	18140	P	275	0	275	0.00002
SRR7981757_1_kneaddata_paired	Deferribacterota	10822	P	171	0	171	0.00001
SRR7981757_1_kneaddata_paired	Firmicutes_C	17613	P	77	0	77	0.00000
SRR7981757_1_kneaddata_paired	Thermotogota	33086	P	71	0	71	0.00000
SRR7981757_1_kneaddata_paired	Elusimicrobiota	11888	P	56	0	56	0.00000
SRR8244674_1_kneaddata_paired	Bacteroidota	4587	P	25122914	163313	25286227	0.69806
SRR8244674_1_kneaddata_paired	Firmicutes_A	14608	P	7944752	63785	8008537	0.22109
SRR8244674_1_kneaddata_paired	Verrucomicrobiota	33333	P	1416711	102391	1519102	0.04194
SRR8244674_1_kneaddata_paired	Firmicutes	12188	P	547994	5808	553802	0.01529
SRR8244674_1_kneaddata_paired	Deferribacterota	10822	P	497933	2333	500266	0.01381
SRR8244674_1_kneaddata_paired	Proteobacteria	22518	P	175084	556	175640	0.00485
SRR8244674_1_kneaddata_paired	Desulfobacterota_A	11509	P	125220	456	125676	0.00347
SRR8244674_1_kneaddata_paired	Actinobacteriota	615	P	39247	252	39499	0.00109
SRR8244674_1_kneaddata_paired	Cyanobacteria	9876	P	9015	219	9234	0.00025
SRR8244674_1_kneaddata_paired	Spirochaetota	32587	P	1918	5	1923	0.00005
SRR8244674_1_kneaddata_paired	Firmicutes_B	17289	P	1572	72	1644	0.00005
SRR8244674_1_kneaddata_paired	Campylobacterota	8700	P	1310	0	1310	0.00004
SRR8244674_1_kneaddata_paired	Firmicutes_I	18140	P	215	0	215	0.00001
SRR8244674_1_kneaddata_paired	Firmicutes_C	17613	P	201	0	201	0.00001
SRR8244674_1_kneaddata_paired	Thermotogota	33086	P	38	0	38	0.00000
SRR8244674_1_kneaddata_paired	Elusimicrobiota	11888	P	19	0	19	0.00000
SRR8244675_1_kneaddata_paired	Firmicutes_A	14608	P	9001533	55312	9056845	0.53791
SRR8244675_1_kneaddata_paired	Bacteroidota	4587	P	6850471	48496	6898967	0.40975
SRR8244675_1_kneaddata_paired	Firmicutes	12188	P	330572	3948	334520	0.01987
SRR8244675_1_kneaddata_paired	Verrucomicrobiota	33333	P	266922	19225	286147	0.01700
SRR8244675_1_kneaddata_paired	Actinobacteriota	615	P	87330	473	87803	0.00521
SRR8244675_1_kneaddata_paired	Desulfobacterota_A	11509	P	60872	344	61216	0.00364
SRR8244675_1_kneaddata_paired	Deferribacterota	10822	P	52680	245	52925	0.00314
SRR8244675_1_kneaddata_paired	Proteobacteria	22518	P	38356	122	38478	0.00229
SRR8244675_1_kneaddata_paired	Cyanobacteria	9876	P	17391	163	17554	0.00104
SRR8244675_1_kneaddata_paired	Firmicutes_B	17289	P	950	43	993	0.00006
SRR8244675_1_kneaddata_paired	Spirochaetota	32587	P	840	1	841	0.00005
SRR8244675_1_kneaddata_paired	Campylobacterota	8700	P	402	0	402	0.00002
SRR8244675_1_kneaddata_paired	Firmicutes_C	17613	P	144	0	144	0.00001
SRR8244675_1_kneaddata_paired	Firmicutes_I	18140	P	139	0	139	0.00001
SRR8244675_1_kneaddata_paired	Thermotogota	33086	P	38	0	38	0.00000
SRR8244675_1_kneaddata_paired	Elusimicrobiota	11888	P	18	0	18	0.00000
SRR8244676_1_kneaddata_paired	Bacteroidota	4587	P	7877203	59420	7936623	0.93398
SRR8244676_1_kneaddata_paired	Firmicutes_A	14608	P	342064	7449	349513	0.04113
SRR8244676_1_kneaddata_paired	Firmicutes	12188	P	127310	1301	128611	0.01513
SRR8244676_1_kneaddata_paired	Actinobacteriota	615	P	54696	149	54845	0.00645
SRR8244676_1_kneaddata_paired	Verrucomicrobiota	33333	P	13349	823	14172	0.00167
SRR8244676_1_kneaddata_paired	Proteobacteria	22518	P	9720	33	9753	0.00115
SRR8244676_1_kneaddata_paired	Deferribacterota	10822	P	1380	5	1385	0.00016
SRR8244676_1_kneaddata_paired	Desulfobacterota_A	11509	P	1150	19	1169	0.00014
SRR8244676_1_kneaddata_paired	Cyanobacteria	9876	P	891	22	913	0.00011
SRR8244676_1_kneaddata_paired	Campylobacterota	8700	P	443	0	443	0.00005
SRR8244676_1_kneaddata_paired	Spirochaetota	32587	P	127	0	127	0.00001
SRR8244676_1_kneaddata_paired	Firmicutes_I	18140	P	81	0	81	0.00001
SRR8244676_1_kneaddata_paired	Firmicutes_B	17289	P	27	1	28	0.00000
SRR8244676_1_kneaddata_paired	Firmicutes_C	17613	P	8	0	8	0.00000
SRR8244676_1_kneaddata_paired	Thermotogota	33086	P	2	0	2	0.00000
SRR8244677_1_kneaddata_paired	Firmicutes_A	14608	P	9920934	45289	9966223	0.51870
SRR8244677_1_kneaddata_paired	Bacteroidota	4587	P	8173059	55197	8228256	0.42825
SRR8244677_1_kneaddata_paired	Firmicutes	12188	P	509718	4551	514269	0.02677
SRR8244677_1_kneaddata_paired	Verrucomicrobiota	33333	P	152367	8396	160763	0.00837
SRR8244677_1_kneaddata_paired	Actinobacteriota	615	P	150964	431	151395	0.00788
SRR8244677_1_kneaddata_paired	Deferribacterota	10822	P	69797	249	70046	0.00365
SRR8244677_1_kneaddata_paired	Desulfobacterota_A	11509	P	59169	264	59433	0.00309
SRR8244677_1_kneaddata_paired	Proteobacteria	22518	P	34584	82	34666	0.00180
SRR8244677_1_kneaddata_paired	Cyanobacteria	9876	P	26051	152	26203	0.00136
SRR8244677_1_kneaddata_paired	Firmicutes_B	17289	P	1092	38	1130	0.00006
SRR8244677_1_kneaddata_paired	Spirochaetota	32587	P	759	1	760	0.00004
SRR8244677_1_kneaddata_paired	Campylobacterota	8700	P	410	0	410	0.00002
SRR8244677_1_kneaddata_paired	Firmicutes_C	17613	P	139	0	139	0.00001
SRR8244677_1_kneaddata_paired	Firmicutes_I	18140	P	135	0	135	0.00001
SRR8244677_1_kneaddata_paired	Thermotogota	33086	P	23	0	23	0.00000
SRR8244677_1_kneaddata_paired	Elusimicrobiota	11888	P	16	0	16	0.00000
SRR8244678_1_kneaddata_paired	Bacteroidota	4587	P	23148600	119397	23267997	0.77514
SRR8244678_1_kneaddata_paired	Firmicutes_A	14608	P	4381563	30344	4411907	0.14698
SRR8244678_1_kneaddata_paired	Verrucomicrobiota	33333	P	1319859	73821	1393680	0.04643
SRR8244678_1_kneaddata_paired	Firmicutes	12188	P	389964	3591	393555	0.01311
SRR8244678_1_kneaddata_paired	Proteobacteria	22518	P	265097	912	266009	0.00886
SRR8244678_1_kneaddata_paired	Deferribacterota	10822	P	118067	427	118494	0.00395
SRR8244678_1_kneaddata_paired	Actinobacteriota	615	P	79496	200	79696	0.00265
SRR8244678_1_kneaddata_paired	Desulfobacterota_A	11509	P	78433	209	78642	0.00262
SRR8244678_1_kneaddata_paired	Cyanobacteria	9876	P	4488	81	4569	0.00015
SRR8244678_1_kneaddata_paired	Campylobacterota	8700	P	1127	0	1127	0.00004
SRR8244678_1_kneaddata_paired	Spirochaetota	32587	P	1076	1	1077	0.00004
SRR8244678_1_kneaddata_paired	Firmicutes_B	17289	P	555	19	574	0.00002
SRR8244678_1_kneaddata_paired	Firmicutes_I	18140	P	184	0	184	0.00001
SRR8244678_1_kneaddata_paired	Firmicutes_C	17613	P	145	0	145	0.00000
SRR8244678_1_kneaddata_paired	Thermotogota	33086	P	28	0	28	0.00000
SRR8244678_1_kneaddata_paired	Elusimicrobiota	11888	P	13	0	13	0.00000
SRR8244679_1_kneaddata_paired	Firmicutes_A	14608	P	2193702	11362	2205064	0.45561
SRR8244679_1_kneaddata_paired	Bacteroidota	4587	P	2123428	11094	2134522	0.44103
SRR8244679_1_kneaddata_paired	Verrucomicrobiota	33333	P	190128	11959	202087	0.04175
SRR8244679_1_kneaddata_paired	Firmicutes	12188	P	178657	1670	180327	0.03726
SRR8244679_1_kneaddata_paired	Actinobacteriota	615	P	60358	169	60527	0.01251
SRR8244679_1_kneaddata_paired	Proteobacteria	22518	P	24697	100	24797	0.00512
SRR8244679_1_kneaddata_paired	Desulfobacterota_A	11509	P	14755	58	14813	0.00306
SRR8244679_1_kneaddata_paired	Deferribacterota	10822	P	9607	38	9645	0.00199
SRR8244679_1_kneaddata_paired	Cyanobacteria	9876	P	7094	68	7162	0.00148
SRR8244679_1_kneaddata_paired	Spirochaetota	32587	P	323	0	323	0.00007
SRR8244679_1_kneaddata_paired	Campylobacterota	8700	P	283	0	283	0.00006
SRR8244679_1_kneaddata_paired	Firmicutes_B	17289	P	171	6	177	0.00004
SRR8244679_1_kneaddata_paired	Firmicutes_I	18140	P	49	0	49	0.00001
SRR8244679_1_kneaddata_paired	Firmicutes_C	17613	P	45	0	45	0.00001
SRR8244679_1_kneaddata_paired	Thermotogota	33086	P	7	0	7	0.00000
SRR8244679_1_kneaddata_paired	Elusimicrobiota	11888	P	6	0	6	0.00000
SRR8244680_1_kneaddata_paired	Bacteroidota	4587	P	10438204	43054	10481258	0.81231
SRR8244680_1_kneaddata_paired	Firmicutes_A	14608	P	1094526	12325	1106851	0.08578
SRR8244680_1_kneaddata_paired	Verrucomicrobiota	33333	P	861778	51131	912909	0.07075
SRR8244680_1_kneaddata_paired	Firmicutes	12188	P	232550	1913	234463	0.01817
SRR8244680_1_kneaddata_paired	Proteobacteria	22518	P	126469	491	126960	0.00984
SRR8244680_1_kneaddata_paired	Actinobacteriota	615	P	24506	47	24553	0.00190
SRR8244680_1_kneaddata_paired	Desulfobacterota_A	11509	P	7729	27	7756	0.00060
SRR8244680_1_kneaddata_paired	Deferribacterota	10822	P	4697	17	4714	0.00037
SRR8244680_1_kneaddata_paired	Cyanobacteria	9876	P	2438	71	2509	0.00019
SRR8244680_1_kneaddata_paired	Campylobacterota	8700	P	380	0	380	0.00003
SRR8244680_1_kneaddata_paired	Spirochaetota	32587	P	344	0	344	0.00003
SRR8244680_1_kneaddata_paired	Firmicutes_B	17289	P	160	6	166	0.00001
SRR8244680_1_kneaddata_paired	Firmicutes_I	18140	P	71	0	71	0.00001
SRR8244680_1_kneaddata_paired	Firmicutes_C	17613	P	59	0	59	0.00000
SRR8244680_1_kneaddata_paired	Thermotogota	33086	P	14	0	14	0.00000
SRR8244680_1_kneaddata_paired	Elusimicrobiota	11888	P	5	0	5	0.00000
SRR8244681_1_kneaddata_paired	Bacteroidota	4587	P	9811069	33785	9844854	0.67067
SRR8244681_1_kneaddata_paired	Firmicutes_A	14608	P	3145863	17870	3163733	0.21553
SRR8244681_1_kneaddata_paired	Verrucomicrobiota	33333	P	1124393	57492	1181885	0.08051
SRR8244681_1_kneaddata_paired	Firmicutes	12188	P	364199	2689	366888	0.02499
SRR8244681_1_kneaddata_paired	Actinobacteriota	615	P	53423	83	53506	0.00365
SRR8244681_1_kneaddata_paired	Proteobacteria	22518	P	41017	158	41175	0.00281
SRR8244681_1_kneaddata_paired	Deferribacterota	10822	P	16422	53	16475	0.00112
SRR8244681_1_kneaddata_paired	Cyanobacteria	9876	P	4309	83	4392	0.00030
SRR8244681_1_kneaddata_paired	Desulfobacterota_A	11509	P	4134	30	4164	0.00028
SRR8244681_1_kneaddata_paired	Campylobacterota	8700	P	736	0	736	0.00005
SRR8244681_1_kneaddata_paired	Spirochaetota	32587	P	633	1	634	0.00004
SRR8244681_1_kneaddata_paired	Firmicutes_B	17289	P	363	11	374	0.00003
SRR8244681_1_kneaddata_paired	Firmicutes_I	18140	P	152	0	152	0.00001
SRR8244681_1_kneaddata_paired	Firmicutes_C	17613	P	121	0	121	0.00001
SRR8244681_1_kneaddata_paired	Elusimicrobiota	11888	P	11	0	11	0.00000
SRR8244681_1_kneaddata_paired	Thermotogota	33086	P	11	0	11	0.00000
SRR8244682_1_kneaddata_paired	Firmicutes_A	14608	P	2571423	15222	2586645	0.50968
SRR8244682_1_kneaddata_paired	Bacteroidota	4587	P	2283588	14336	2297924	0.45279
SRR8244682_1_kneaddata_paired	Firmicutes	12188	P	100047	1369	101416	0.01998
SRR8244682_1_kneaddata_paired	Actinobacteriota	615	P	26802	95	26897	0.00530
SRR8244682_1_kneaddata_paired	Desulfobacterota_A	11509	P	20877	95	20972	0.00413
SRR8244682_1_kneaddata_paired	Proteobacteria	22518	P	17922	79	18001	0.00355
SRR8244682_1_kneaddata_paired	Cyanobacteria	9876	P	12567	108	12675	0.00250
SRR8244682_1_kneaddata_paired	Verrucomicrobiota	33333	P	6639	472	7111	0.00140
SRR8244682_1_kneaddata_paired	Deferribacterota	10822	P	2448	10	2458	0.00048
SRR8244682_1_kneaddata_paired	Campylobacterota	8700	P	307	0	307	0.00006
SRR8244682_1_kneaddata_paired	Spirochaetota	32587	P	302	0	302	0.00006
SRR8244682_1_kneaddata_paired	Firmicutes_B	17289	P	244	11	255	0.00005
SRR8244682_1_kneaddata_paired	Firmicutes_I	18140	P	62	0	62	0.00001
SRR8244682_1_kneaddata_paired	Firmicutes_C	17613	P	32	0	32	0.00001
SRR8244682_1_kneaddata_paired	Thermotogota	33086	P	11	0	11	0.00000
SRR8244682_1_kneaddata_paired	Elusimicrobiota	11888	P	5	0	5	0.00000
SRR8244683_1_kneaddata_paired	Bacteroidota	4587	P	1353360	12229	1365589	0.88040
SRR8244683_1_kneaddata_paired	Firmicutes_A	14608	P	134018	2461	136479	0.08799
SRR8244683_1_kneaddata_paired	Firmicutes	12188	P	32692	428	33120	0.02135
SRR8244683_1_kneaddata_paired	Actinobacteriota	615	P	6964	10	6974	0.00450
SRR8244683_1_kneaddata_paired	Proteobacteria	22518	P	4715	13	4728	0.00305
SRR8244683_1_kneaddata_paired	Verrucomicrobiota	33333	P	2028	190	2218	0.00143
SRR8244683_1_kneaddata_paired	Desulfobacterota_A	11509	P	782	4	786	0.00051
SRR8244683_1_kneaddata_paired	Deferribacterota	10822	P	625	3	628	0.00041
SRR8244683_1_kneaddata_paired	Cyanobacteria	9876	P	442	8	450	0.00029
SRR8244683_1_kneaddata_paired	Spirochaetota	32587	P	58	0	58	0.00004
SRR8244683_1_kneaddata_paired	Campylobacterota	8700	P	38	0	38	0.00002
SRR8244683_1_kneaddata_paired	Firmicutes_B	17289	P	19	1	20	0.00001
SRR8244683_1_kneaddata_paired	Firmicutes_I	18140	P	3	0	3	0.00000
SRR8244683_1_kneaddata_paired	Firmicutes_C	17613	P	2	0	2	0.00000
SRR8244683_1_kneaddata_paired	Thermotogota	33086	P	2	0	2	0.00000
SRR8244683_1_kneaddata_paired	Elusimicrobiota	11888	P	1	0	1	0.00000
SRR8244684_1_kneaddata_paired	Firmicutes_A	14608	P	4090468	18356	4108824	0.60746
SRR8244684_1_kneaddata_paired	Bacteroidota	4587	P	2416714	16253	2432967	0.35969
SRR8244684_1_kneaddata_paired	Deferribacterota	10822	P	138105	519	138624	0.02049
SRR8244684_1_kneaddata_paired	Firmicutes	12188	P	56653	947	57600	0.00852
SRR8244684_1_kneaddata_paired	Proteobacteria	22518	P	9306	18	9324	0.00138
SRR8244684_1_kneaddata_paired	Desulfobacterota_A	11509	P	7137	60	7197	0.00106
SRR8244684_1_kneaddata_paired	Actinobacteriota	615	P	6788	20	6808	0.00101
SRR8244684_1_kneaddata_paired	Cyanobacteria	9876	P	1119	10	1129	0.00017
SRR8244684_1_kneaddata_paired	Verrucomicrobiota	33333	P	764	41	805	0.00012
SRR8244684_1_kneaddata_paired	Firmicutes_B	17289	P	280	10	290	0.00004
SRR8244684_1_kneaddata_paired	Spirochaetota	32587	P	185	0	185	0.00003
SRR8244684_1_kneaddata_paired	Campylobacterota	8700	P	88	0	88	0.00001
SRR8244684_1_kneaddata_paired	Firmicutes_C	17613	P	66	0	66	0.00001
SRR8244684_1_kneaddata_paired	Firmicutes_I	18140	P	56	0	56	0.00001
SRR8244684_1_kneaddata_paired	Thermotogota	33086	P	11	0	11	0.00000
SRR8244684_1_kneaddata_paired	Elusimicrobiota	11888	P	3	0	3	0.00000
SRR8244685_1_kneaddata_paired	Bacteroidota	4587	P	20380471	190628	20571099	0.82006
SRR8244685_1_kneaddata_paired	Firmicutes_A	14608	P	3439698	52655	3492353	0.13922
SRR8244685_1_kneaddata_paired	Firmicutes	12188	P	734223	10633	744856	0.02969
SRR8244685_1_kneaddata_paired	Actinobacteriota	615	P	102181	339	102520	0.00409
SRR8244685_1_kneaddata_paired	Proteobacteria	22518	P	77486	293	77779	0.00310
SRR8244685_1_kneaddata_paired	Verrucomicrobiota	33333	P	45470	4856	50326	0.00201
SRR8244685_1_kneaddata_paired	Deferribacterota	10822	P	17567	120	17687	0.00071
SRR8244685_1_kneaddata_paired	Desulfobacterota_A	11509	P	15652	145	15797	0.00063
SRR8244685_1_kneaddata_paired	Cyanobacteria	9876	P	9349	192	9541	0.00038
SRR8244685_1_kneaddata_paired	Spirochaetota	32587	P	1303	4	1307	0.00005
SRR8244685_1_kneaddata_paired	Campylobacterota	8700	P	770	0	770	0.00003
SRR8244685_1_kneaddata_paired	Firmicutes_B	17289	P	540	36	576	0.00002
SRR8244685_1_kneaddata_paired	Firmicutes_I	18140	P	193	0	193	0.00001
SRR8244685_1_kneaddata_paired	Firmicutes_C	17613	P	65	0	65	0.00000
SRR8244685_1_kneaddata_paired	Thermotogota	33086	P	46	0	46	0.00000
SRR8244685_1_kneaddata_paired	Elusimicrobiota	11888	P	11	0	11	0.00000
SRR8244686_1_kneaddata_paired	Bacteroidota	4587	P	4232577	34651	4267228	0.48799
SRR8244686_1_kneaddata_paired	Firmicutes_A	14608	P	3867368	27612	3894980	0.44542
SRR8244686_1_kneaddata_paired	Desulfobacterota_A	11509	P	216769	823	217592	0.02488
SRR8244686_1_kneaddata_paired	Firmicutes	12188	P	142534	2060	144594	0.01654
SRR8244686_1_kneaddata_paired	Actinobacteriota	615	P	80499	236	80735	0.00923
SRR8244686_1_kneaddata_paired	Proteobacteria	22518	P	72064	179	72243	0.00826
SRR8244686_1_kneaddata_paired	Deferribacterota	10822	P	35230	194	35424	0.00405
SRR8244686_1_kneaddata_paired	Verrucomicrobiota	33333	P	21535	1829	23364	0.00267
SRR8244686_1_kneaddata_paired	Cyanobacteria	9876	P	6487	112	6599	0.00075
SRR8244686_1_kneaddata_paired	Spirochaetota	32587	P	863	1	864	0.00010
SRR8244686_1_kneaddata_paired	Firmicutes_B	17289	P	441	23	464	0.00005
SRR8244686_1_kneaddata_paired	Campylobacterota	8700	P	183	0	183	0.00002
SRR8244686_1_kneaddata_paired	Firmicutes_C	17613	P	94	0	94	0.00001
SRR8244686_1_kneaddata_paired	Firmicutes_I	18140	P	83	0	83	0.00001
SRR8244686_1_kneaddata_paired	Thermotogota	33086	P	8	0	8	0.00000
SRR8244686_1_kneaddata_paired	Elusimicrobiota	11888	P	7	0	7	0.00000
SRR8244687_1_kneaddata_paired	Bacteroidota	4587	P	2103221	30255	2133476	0.64894
SRR8244687_1_kneaddata_paired	Firmicutes_A	14608	P	825853	13924	839777	0.25544
SRR8244687_1_kneaddata_paired	Firmicutes	12188	P	177969	4276	182245	0.05543
SRR8244687_1_kneaddata_paired	Actinobacteriota	615	P	93379	396	93775	0.02852
SRR8244687_1_kneaddata_paired	Deferribacterota	10822	P	11142	117	11259	0.00342
SRR8244687_1_kneaddata_paired	Verrucomicrobiota	33333	P	10839	1771	12610	0.00384
SRR8244687_1_kneaddata_paired	Desulfobacterota_A	11509	P	7604	73	7677	0.00234
SRR8244687_1_kneaddata_paired	Proteobacteria	22518	P	4005	37	4042	0.00123
SRR8244687_1_kneaddata_paired	Cyanobacteria	9876	P	2007	45	2052	0.00062
SRR8244687_1_kneaddata_paired	Spirochaetota	32587	P	358	1	359	0.00011
SRR8244687_1_kneaddata_paired	Campylobacterota	8700	P	152	0	152	0.00005
SRR8244687_1_kneaddata_paired	Firmicutes_B	17289	P	122	12	134	0.00004
SRR8244687_1_kneaddata_paired	Firmicutes_I	18140	P	42	0	42	0.00001
SRR8244687_1_kneaddata_paired	Firmicutes_C	17613	P	22	0	22	0.00001
SRR8244687_1_kneaddata_paired	Elusimicrobiota	11888	P	2	0	2	0.00000
SRR8244687_1_kneaddata_paired	Thermotogota	33086	P	1	0	1	0.00000
SRR8244688_1_kneaddata_paired	Firmicutes_A	14608	P	2501992	13932	2515924	0.45444
SRR8244688_1_kneaddata_paired	Bacteroidota	4587	P	2318607	15001	2333608	0.42151
SRR8244688_1_kneaddata_paired	Proteobacteria	22518	P	331067	644	331711	0.05992
SRR8244688_1_kneaddata_paired	Firmicutes	12188	P	129404	1540	130944	0.02365
SRR8244688_1_kneaddata_paired	Desulfobacterota_A	11509	P	80810	264	81074	0.01464
SRR8244688_1_kneaddata_paired	Actinobacteriota	615	P	61436	155	61591	0.01112
SRR8244688_1_kneaddata_paired	Deferribacterota	10822	P	47453	209	47662	0.00861
SRR8244688_1_kneaddata_paired	Verrucomicrobiota	33333	P	23132	1577	24709	0.00446
SRR8244688_1_kneaddata_paired	Cyanobacteria	9876	P	8014	87	8101	0.00146
SRR8244688_1_kneaddata_paired	Spirochaetota	32587	P	379	0	379	0.00007
SRR8244688_1_kneaddata_paired	Firmicutes_B	17289	P	370	16	386	0.00007
SRR8244688_1_kneaddata_paired	Campylobacterota	8700	P	94	0	94	0.00002
SRR8244688_1_kneaddata_paired	Firmicutes_C	17613	P	65	0	65	0.00001
SRR8244688_1_kneaddata_paired	Firmicutes_I	18140	P	42	0	42	0.00001
SRR8244688_1_kneaddata_paired	Elusimicrobiota	11888	P	7	0	7	0.00000
SRR8244688_1_kneaddata_paired	Thermotogota	33086	P	3	0	3	0.00000
SRR8244689_1_kneaddata_paired	Firmicutes_A	14608	P	15307835	78649	15386484	0.68364
SRR8244689_1_kneaddata_paired	Bacteroidota	4587	P	6106227	38051	6144278	0.27300
SRR8244689_1_kneaddata_paired	Firmicutes	12188	P	334426	5074	339500	0.01508
SRR8244689_1_kneaddata_paired	Actinobacteriota	615	P	214663	921	215584	0.00958
SRR8244689_1_kneaddata_paired	Proteobacteria	22518	P	203815	379	204194	0.00907
SRR8244689_1_kneaddata_paired	Desulfobacterota_A	11509	P	170660	681	171341	0.00761
SRR8244689_1_kneaddata_paired	Deferribacterota	10822	P	15231	65	15296	0.00068
SRR8244689_1_kneaddata_paired	Verrucomicrobiota	33333	P	14691	959	15650	0.00070
SRR8244689_1_kneaddata_paired	Cyanobacteria	9876	P	11104	93	11197	0.00050
SRR8244689_1_kneaddata_paired	Firmicutes_B	17289	P	1396	59	1455	0.00006
SRR8244689_1_kneaddata_paired	Spirochaetota	32587	P	982	1	983	0.00004
SRR8244689_1_kneaddata_paired	Campylobacterota	8700	P	319	0	319	0.00001
SRR8244689_1_kneaddata_paired	Firmicutes_C	17613	P	217	0	217	0.00001
SRR8244689_1_kneaddata_paired	Firmicutes_I	18140	P	204	0	204	0.00001
SRR8244689_1_kneaddata_paired	Thermotogota	33086	P	38	0	38	0.00000
SRR8244689_1_kneaddata_paired	Elusimicrobiota	11888	P	30	0	30	0.00000
SRR8244690_1_kneaddata_paired	Firmicutes_A	14608	P	8949246	59594	9008840	0.48585
SRR8244690_1_kneaddata_paired	Bacteroidota	4587	P	8523970	61748	8585718	0.46303
SRR8244690_1_kneaddata_paired	Firmicutes	12188	P	590798	7872	598670	0.03229
SRR8244690_1_kneaddata_paired	Actinobacteriota	615	P	123938	437	124375	0.00671
SRR8244690_1_kneaddata_paired	Desulfobacterota_A	11509	P	91009	453	91462	0.00493
SRR8244690_1_kneaddata_paired	Proteobacteria	22518	P	70781	132	70913	0.00382
SRR8244690_1_kneaddata_paired	Verrucomicrobiota	33333	P	21776	1711	23487	0.00127
SRR8244690_1_kneaddata_paired	Cyanobacteria	9876	P	21463	170	21633	0.00117
SRR8244690_1_kneaddata_paired	Deferribacterota	10822	P	14628	74	14702	0.00079
SRR8244690_1_kneaddata_paired	Firmicutes_B	17289	P	1029	51	1080	0.00006
SRR8244690_1_kneaddata_paired	Spirochaetota	32587	P	656	1	657	0.00004
SRR8244690_1_kneaddata_paired	Campylobacterota	8700	P	453	0	453	0.00002
SRR8244690_1_kneaddata_paired	Firmicutes_I	18140	P	133	0	133	0.00001
SRR8244690_1_kneaddata_paired	Firmicutes_C	17613	P	117	0	117	0.00001
SRR8244690_1_kneaddata_paired	Thermotogota	33086	P	37	0	37	0.00000
SRR8244690_1_kneaddata_paired	Elusimicrobiota	11888	P	16	0	16	0.00000
SRR8244691_1_kneaddata_paired	Bacteroidota	4587	P	3931503	31481	3962984	0.39927
SRR8244691_1_kneaddata_paired	Proteobacteria	22518	P	3180614	5901	3186515	0.32104
SRR8244691_1_kneaddata_paired	Firmicutes_A	14608	P	2190048	12624	2202672	0.22192
SRR8244691_1_kneaddata_paired	Firmicutes	12188	P	292114	2361	294475	0.02967
SRR8244691_1_kneaddata_paired	Deferribacterota	10822	P	110443	482	110925	0.01118
SRR8244691_1_kneaddata_paired	Actinobacteriota	615	P	74100	275	74375	0.00749
SRR8244691_1_kneaddata_paired	Desulfobacterota_A	11509	P	47508	180	47688	0.00480
SRR8244691_1_kneaddata_paired	Verrucomicrobiota	33333	P	39650	2666	42316	0.00426
SRR8244691_1_kneaddata_paired	Cyanobacteria	9876	P	2844	26	2870	0.00029
SRR8244691_1_kneaddata_paired	Spirochaetota	32587	P	292	0	292	0.00003
SRR8244691_1_kneaddata_paired	Firmicutes_B	17289	P	181	7	188	0.00002
SRR8244691_1_kneaddata_paired	Campylobacterota	8700	P	153	0	153	0.00002
SRR8244691_1_kneaddata_paired	Firmicutes_C	17613	P	44	0	44	0.00000
SRR8244691_1_kneaddata_paired	Firmicutes_I	18140	P	44	0	44	0.00000
SRR8244691_1_kneaddata_paired	Thermotogota	33086	P	6	0	6	0.00000
SRR8244691_1_kneaddata_paired	Elusimicrobiota	11888	P	1	0	1	0.00000
SRR8244692_1_kneaddata_paired	Bacteroidota	4587	P	504867	4284	509151	0.51773
SRR8244692_1_kneaddata_paired	Firmicutes_A	14608	P	441120	3154	444274	0.45176
SRR8244692_1_kneaddata_paired	Deferribacterota	10822	P	12984	76	13060	0.01328
SRR8244692_1_kneaddata_paired	Firmicutes	12188	P	11372	232	11604	0.01180
SRR8244692_1_kneaddata_paired	Desulfobacterota_A	11509	P	1722	12	1734	0.00176
SRR8244692_1_kneaddata_paired	Proteobacteria	22518	P	1465	4	1469	0.00149
SRR8244692_1_kneaddata_paired	Actinobacteriota	615	P	1043	4	1047	0.00107
SRR8244692_1_kneaddata_paired	Verrucomicrobiota	33333	P	718	65	783	0.00080
SRR8244692_1_kneaddata_paired	Cyanobacteria	9876	P	191	2	193	0.00020
SRR8244692_1_kneaddata_paired	Spirochaetota	32587	P	38	0	38	0.00004
SRR8244692_1_kneaddata_paired	Firmicutes_B	17289	P	37	2	39	0.00004
SRR8244692_1_kneaddata_paired	Campylobacterota	8700	P	22	0	22	0.00002
SRR8244692_1_kneaddata_paired	Firmicutes_C	17613	P	8	0	8	0.00001
SRR8244692_1_kneaddata_paired	Firmicutes_I	18140	P	3	0	3	0.00000
SRR8244693_1_kneaddata_paired	Firmicutes_A	14608	P	924204	3895	928099	0.70370
SRR8244693_1_kneaddata_paired	Bacteroidota	4587	P	338308	1676	339984	0.25778
SRR8244693_1_kneaddata_paired	Firmicutes	12188	P	29920	211	30131	0.02285
SRR8244693_1_kneaddata_paired	Proteobacteria	22518	P	9714	8	9722	0.00737
SRR8244693_1_kneaddata_paired	Desulfobacterota_A	11509	P	3282	13	3295	0.00250
SRR8244693_1_kneaddata_paired	Cyanobacteria	9876	P	3165	12	3177	0.00241
SRR8244693_1_kneaddata_paired	Actinobacteriota	615	P	2316	4	2320	0.00176
SRR8244693_1_kneaddata_paired	Deferribacterota	10822	P	1958	5	1963	0.00149
SRR8244693_1_kneaddata_paired	Verrucomicrobiota	33333	P	63	2	65	0.00005
SRR8244693_1_kneaddata_paired	Firmicutes_B	17289	P	53	1	54	0.00004
SRR8244693_1_kneaddata_paired	Spirochaetota	32587	P	20	0	20	0.00002
SRR8244693_1_kneaddata_paired	Campylobacterota	8700	P	19	0	19	0.00001
SRR8244693_1_kneaddata_paired	Firmicutes_C	17613	P	14	0	14	0.00001
SRR8244693_1_kneaddata_paired	Firmicutes_I	18140	P	7	0	7	0.00001
SRR8244693_1_kneaddata_paired	Elusimicrobiota	11888	P	3	0	3	0.00000
SRR8244693_1_kneaddata_paired	Thermotogota	33086	P	3	0	3	0.00000
SRR8244694_1_kneaddata_paired	Bacteroidota	4587	P	5957775	45108	6002883	0.80871
SRR8244694_1_kneaddata_paired	Firmicutes_A	14608	P	1262574	12891	1275465	0.17183
SRR8244694_1_kneaddata_paired	Firmicutes	12188	P	72197	755	72952	0.00983
SRR8244694_1_kneaddata_paired	Proteobacteria	22518	P	33587	93	33680	0.00454
SRR8244694_1_kneaddata_paired	Deferribacterota	10822	P	16818	65	16883	0.00227
SRR8244694_1_kneaddata_paired	Actinobacteriota	615	P	9520	22	9542	0.00129
SRR8244694_1_kneaddata_paired	Desulfobacterota_A	11509	P	4763	38	4801	0.00065
SRR8244694_1_kneaddata_paired	Verrucomicrobiota	33333	P	3815	228	4043	0.00054
SRR8244694_1_kneaddata_paired	Cyanobacteria	9876	P	2008	23	2031	0.00027
SRR8244694_1_kneaddata_paired	Spirochaetota	32587	P	171	0	171	0.00002
SRR8244694_1_kneaddata_paired	Campylobacterota	8700	P	156	0	156	0.00002
SRR8244694_1_kneaddata_paired	Firmicutes_B	17289	P	95	3	98	0.00001
SRR8244694_1_kneaddata_paired	Firmicutes_I	18140	P	31	0	31	0.00000
SRR8244694_1_kneaddata_paired	Firmicutes_C	17613	P	21	0	21	0.00000
SRR8244694_1_kneaddata_paired	Elusimicrobiota	11888	P	5	0	5	0.00000
SRR8244694_1_kneaddata_paired	Thermotogota	33086	P	4	0	4	0.00000
SRR8244695_1_kneaddata_paired	Firmicutes_A	14608	P	737357	5337	742694	0.54827
SRR8244695_1_kneaddata_paired	Bacteroidota	4587	P	534252	3691	537943	0.39712
SRR8244695_1_kneaddata_paired	Firmicutes	12188	P	45813	874	46687	0.03447
SRR8244695_1_kneaddata_paired	Actinobacteriota	615	P	17276	45	17321	0.01279
SRR8244695_1_kneaddata_paired	Verrucomicrobiota	33333	P	5048	564	5612	0.00414
SRR8244695_1_kneaddata_paired	Proteobacteria	22518	P	1391	14	1405	0.00104
SRR8244695_1_kneaddata_paired	Deferribacterota	10822	P	1219	8	1227	0.00091
SRR8244695_1_kneaddata_paired	Desulfobacterota_A	11509	P	1165	22	1187	0.00088
SRR8244695_1_kneaddata_paired	Cyanobacteria	9876	P	395	8	403	0.00030
SRR8244695_1_kneaddata_paired	Spirochaetota	32587	P	47	0	47	0.00003
SRR8244695_1_kneaddata_paired	Firmicutes_B	17289	P	35	2	37	0.00003
SRR8244695_1_kneaddata_paired	Campylobacterota	8700	P	32	0	32	0.00002
SRR8244695_1_kneaddata_paired	Firmicutes_C	17613	P	10	0	10	0.00001
SRR8244695_1_kneaddata_paired	Firmicutes_I	18140	P	7	0	7	0.00001
SRR8244695_1_kneaddata_paired	Elusimicrobiota	11888	P	2	0	2	0.00000
SRR8244696_1_kneaddata_paired	Firmicutes_A	14608	P	4913302	16614	4929916	0.77797
SRR8244696_1_kneaddata_paired	Proteobacteria	22518	P	1029089	1881	1030970	0.16269
SRR8244696_1_kneaddata_paired	Deferribacterota	10822	P	110220	471	110691	0.01747
SRR8244696_1_kneaddata_paired	Firmicutes	12188	P	102716	1764	104480	0.01649
SRR8244696_1_kneaddata_paired	Bacteroidota	4587	P	97442	414	97856	0.01544
SRR8244696_1_kneaddata_paired	Actinobacteriota	615	P	46170	85	46255	0.00730
SRR8244696_1_kneaddata_paired	Verrucomicrobiota	33333	P	10695	705	11400	0.00180
SRR8244696_1_kneaddata_paired	Desulfobacterota_A	11509	P	4117	97	4214	0.00067
SRR8244696_1_kneaddata_paired	Cyanobacteria	9876	P	712	6	718	0.00011
SRR8244696_1_kneaddata_paired	Firmicutes_B	17289	P	148	6	154	0.00002
SRR8244696_1_kneaddata_paired	Spirochaetota	32587	P	117	0	117	0.00002
SRR8244696_1_kneaddata_paired	Campylobacterota	8700	P	106	0	106	0.00002
SRR8244696_1_kneaddata_paired	Firmicutes_C	17613	P	27	0	27	0.00000
SRR8244696_1_kneaddata_paired	Firmicutes_I	18140	P	17	0	17	0.00000
SRR8244696_1_kneaddata_paired	Thermotogota	33086	P	5	0	5	0.00000
SRR8244696_1_kneaddata_paired	Elusimicrobiota	11888	P	1	0	1	0.00000
SRR8244697_1_kneaddata_paired	Firmicutes_A	14608	P	286674	1212	287886	0.55237
SRR8244697_1_kneaddata_paired	Bacteroidota	4587	P	196593	825	197418	0.37879
SRR8244697_1_kneaddata_paired	Verrucomicrobiota	33333	P	12574	714	13288	0.02550
SRR8244697_1_kneaddata_paired	Firmicutes	12188	P	12488	116	12604	0.02418
SRR8244697_1_kneaddata_paired	Proteobacteria	22518	P	3663	14	3677	0.00706
SRR8244697_1_kneaddata_paired	Actinobacteriota	615	P	3080	5	3085	0.00592
SRR8244697_1_kneaddata_paired	Desulfobacterota_A	11509	P	1733	6	1739	0.00334
SRR8244697_1_kneaddata_paired	Deferribacterota	10822	P	887	3	890	0.00171
SRR8244697_1_kneaddata_paired	Cyanobacteria	9876	P	537	11	548	0.00105
SRR8244697_1_kneaddata_paired	Campylobacterota	8700	P	19	0	19	0.00004
SRR8244697_1_kneaddata_paired	Spirochaetota	32587	P	11	0	11	0.00002
SRR8244697_1_kneaddata_paired	Firmicutes_B	17289	P	9	0	9	0.00002
SRR8244697_1_kneaddata_paired	Firmicutes_C	17613	P	4	0	4	0.00001
SRR8244697_1_kneaddata_paired	Firmicutes_I	18140	P	2	0	2	0.00000
SRR8244697_1_kneaddata_paired	Thermotogota	33086	P	1	0	1	0.00000
SRR8244698_1_kneaddata_paired	Firmicutes_A	14608	P	4548573	21875	4570448	0.55617
SRR8244698_1_kneaddata_paired	Bacteroidota	4587	P	3409847	20540	3430387	0.41743
SRR8244698_1_kneaddata_paired	Firmicutes	12188	P	91535	903	92438	0.01125
SRR8244698_1_kneaddata_paired	Proteobacteria	22518	P	42330	54	42384	0.00516
SRR8244698_1_kneaddata_paired	Actinobacteriota	615	P	31733	65	31798	0.00387
SRR8244698_1_kneaddata_paired	Cyanobacteria	9876	P	26908	131	27039	0.00329
SRR8244698_1_kneaddata_paired	Desulfobacterota_A	11509	P	15016	80	15096	0.00184
SRR8244698_1_kneaddata_paired	Deferribacterota	10822	P	7252	21	7273	0.00089
SRR8244698_1_kneaddata_paired	Verrucomicrobiota	33333	P	305	10	315	0.00004
SRR8244698_1_kneaddata_paired	Firmicutes_B	17289	P	228	6	234	0.00003
SRR8244698_1_kneaddata_paired	Spirochaetota	32587	P	139	0	139	0.00002
SRR8244698_1_kneaddata_paired	Campylobacterota	8700	P	102	0	102	0.00001
SRR8244698_1_kneaddata_paired	Firmicutes_C	17613	P	75	0	75	0.00001
SRR8244698_1_kneaddata_paired	Firmicutes_I	18140	P	40	0	40	0.00000
SRR8244698_1_kneaddata_paired	Thermotogota	33086	P	12	0	12	0.00000
SRR8244698_1_kneaddata_paired	Elusimicrobiota	11888	P	6	0	6	0.00000
SRR8244699_1_kneaddata_paired	Firmicutes_A	14608	P	10704142	48553	10752695	0.52009
SRR8244699_1_kneaddata_paired	Bacteroidota	4587	P	8790925	49132	8840057	0.42758
SRR8244699_1_kneaddata_paired	Firmicutes	12188	P	493389	4618	498007	0.02409
SRR8244699_1_kneaddata_paired	Verrucomicrobiota	33333	P	251457	15309	266766	0.01290
SRR8244699_1_kneaddata_paired	Proteobacteria	22518	P	80221	294	80515	0.00389
SRR8244699_1_kneaddata_paired	Actinobacteriota	615	P	76622	142	76764	0.00371
SRR8244699_1_kneaddata_paired	Desulfobacterota_A	11509	P	71618	382	72000	0.00348
SRR8244699_1_kneaddata_paired	Deferribacterota	10822	P	57304	224	57528	0.00278
SRR8244699_1_kneaddata_paired	Cyanobacteria	9876	P	27933	399	28332	0.00137
SRR8244699_1_kneaddata_paired	Spirochaetota	32587	P	763	1	764	0.00004
SRR8244699_1_kneaddata_paired	Campylobacterota	8700	P	520	0	520	0.00003
SRR8244699_1_kneaddata_paired	Firmicutes_B	17289	P	511	19	530	0.00003
SRR8244699_1_kneaddata_paired	Firmicutes_I	18140	P	175	0	175	0.00001
SRR8244699_1_kneaddata_paired	Firmicutes_C	17613	P	153	0	153	0.00001
SRR8244699_1_kneaddata_paired	Thermotogota	33086	P	21	0	21	0.00000
SRR8244699_1_kneaddata_paired	Elusimicrobiota	11888	P	7	0	7	0.00000
SRR8244700_1_kneaddata_paired	Bacteroidota	4587	P	1183131	3990	1187121	0.84910
SRR8244700_1_kneaddata_paired	Verrucomicrobiota	33333	P	127386	6561	133947	0.09581
SRR8244700_1_kneaddata_paired	Firmicutes_A	14608	P	49182	788	49970	0.03574
SRR8244700_1_kneaddata_paired	Firmicutes	12188	P	12879	85	12964	0.00927
SRR8244700_1_kneaddata_paired	Actinobacteriota	615	P	7154	6	7160	0.00512
SRR8244700_1_kneaddata_paired	Proteobacteria	22518	P	6327	18	6345	0.00454
SRR8244700_1_kneaddata_paired	Cyanobacteria	9876	P	181	3	184	0.00013
SRR8244700_1_kneaddata_paired	Desulfobacterota_A	11509	P	156	1	157	0.00011
SRR8244700_1_kneaddata_paired	Deferribacterota	10822	P	137	0	137	0.00010
SRR8244700_1_kneaddata_paired	Spirochaetota	32587	P	39	0	39	0.00003
SRR8244700_1_kneaddata_paired	Campylobacterota	8700	P	34	0	34	0.00002
SRR8244700_1_kneaddata_paired	Firmicutes_B	17289	P	13	0	13	0.00001
SRR8244700_1_kneaddata_paired	Firmicutes_C	17613	P	10	0	10	0.00001
SRR8244700_1_kneaddata_paired	Firmicutes_I	18140	P	8	0	8	0.00001
SRR8244700_1_kneaddata_paired	Elusimicrobiota	11888	P	1	0	1	0.00000
SRR8244700_1_kneaddata_paired	Thermotogota	33086	P	1	0	1	0.00000
SRR8244701_1_kneaddata_paired	Bacteroidota	4587	P	24064	165	24229	0.47653
SRR8244701_1_kneaddata_paired	Firmicutes_A	14608	P	24034	164	24198	0.47593
SRR8244701_1_kneaddata_paired	Firmicutes	12188	P	1494	22	1516	0.02982
SRR8244701_1_kneaddata_paired	Cyanobacteria	9876	P	213	1	214	0.00422
SRR8244701_1_kneaddata_paired	Actinobacteriota	615	P	158	0	158	0.00311
SRR8244701_1_kneaddata_paired	Desulfobacterota_A	11509	P	152	0	152	0.00301
SRR8244701_1_kneaddata_paired	Proteobacteria	22518	P	143	0	143	0.00283
SRR8244701_1_kneaddata_paired	Verrucomicrobiota	33333	P	139	11	150	0.00297
SRR8244701_1_kneaddata_paired	Deferribacterota	10822	P	73	0	73	0.00144
SRR8244701_1_kneaddata_paired	Firmicutes_B	17289	P	5	0	5	0.00010
SRR8244701_1_kneaddata_paired	Spirochaetota	32587	P	2	0	2	0.00004
SRR8244702_1_kneaddata_paired	Bacteroidota	4587	P	1348711	5653	1354364	0.84088
SRR8244702_1_kneaddata_paired	Verrucomicrobiota	33333	P	108508	7129	115637	0.07180
SRR8244702_1_kneaddata_paired	Firmicutes_A	14608	P	64878	1198	66076	0.04102
SRR8244702_1_kneaddata_paired	Firmicutes	12188	P	50956	481	51437	0.03194
SRR8244702_1_kneaddata_paired	Actinobacteriota	615	P	13028	23	13051	0.00810
SRR8244702_1_kneaddata_paired	Proteobacteria	22518	P	8847	34	8881	0.00551
SRR8244702_1_kneaddata_paired	Cyanobacteria	9876	P	694	10	704	0.00044
SRR8244702_1_kneaddata_paired	Deferribacterota	10822	P	212	0	212	0.00013
SRR8244702_1_kneaddata_paired	Desulfobacterota_A	11509	P	114	0	114	0.00007
SRR8244702_1_kneaddata_paired	Spirochaetota	32587	P	78	0	78	0.00005
SRR8244702_1_kneaddata_paired	Campylobacterota	8700	P	59	0	59	0.00004
SRR8244702_1_kneaddata_paired	Firmicutes_B	17289	P	13	0	13	0.00001
SRR8244702_1_kneaddata_paired	Firmicutes_C	17613	P	9	0	9	0.00001
SRR8244702_1_kneaddata_paired	Firmicutes_I	18140	P	7	0	7	0.00000
SRR8244703_1_kneaddata_paired	Firmicutes_A	14608	P	5423056	26177	5449233	0.59527
SRR8244703_1_kneaddata_paired	Bacteroidota	4587	P	3249430	17614	3267044	0.35689
SRR8244703_1_kneaddata_paired	Firmicutes	12188	P	208807	2375	211182	0.02307
SRR8244703_1_kneaddata_paired	Cyanobacteria	9876	P	57012	371	57383	0.00627
SRR8244703_1_kneaddata_paired	Verrucomicrobiota	33333	P	54532	3410	57942	0.00633
SRR8244703_1_kneaddata_paired	Actinobacteriota	615	P	39933	71	40004	0.00437
SRR8244703_1_kneaddata_paired	Desulfobacterota_A	11509	P	29750	127	29877	0.00326
SRR8244703_1_kneaddata_paired	Deferribacterota	10822	P	21058	84	21142	0.00231
SRR8244703_1_kneaddata_paired	Proteobacteria	22518	P	18149	55	18204	0.00199
SRR8244703_1_kneaddata_paired	Firmicutes_B	17289	P	695	27	722	0.00008
SRR8244703_1_kneaddata_paired	Spirochaetota	32587	P	606	1	607	0.00007
SRR8244703_1_kneaddata_paired	Campylobacterota	8700	P	548	0	548	0.00006
SRR8244703_1_kneaddata_paired	Firmicutes_I	18140	P	133	0	133	0.00001
SRR8244703_1_kneaddata_paired	Firmicutes_C	17613	P	110	0	110	0.00001
SRR8244703_1_kneaddata_paired	Thermotogota	33086	P	15	0	15	0.00000
SRR8244703_1_kneaddata_paired	Elusimicrobiota	11888	P	9	0	9	0.00000
SRR8244704_1_kneaddata_paired	Bacteroidota	4587	P	1693714	10072	1703786	0.89703
SRR8244704_1_kneaddata_paired	Firmicutes_A	14608	P	72806	1776	74582	0.03927
SRR8244704_1_kneaddata_paired	Verrucomicrobiota	33333	P	57173	4460	61633	0.03245
SRR8244704_1_kneaddata_paired	Firmicutes	12188	P	30073	331	30404	0.01601
SRR8244704_1_kneaddata_paired	Proteobacteria	22518	P	21331	103	21434	0.01128
SRR8244704_1_kneaddata_paired	Actinobacteriota	615	P	6165	13	6178	0.00325
SRR8244704_1_kneaddata_paired	Deferribacterota	10822	P	507	2	509	0.00027
SRR8244704_1_kneaddata_paired	Cyanobacteria	9876	P	424	11	435	0.00023
SRR8244704_1_kneaddata_paired	Desulfobacterota_A	11509	P	241	2	243	0.00013
SRR8244704_1_kneaddata_paired	Campylobacterota	8700	P	68	0	68	0.00004
SRR8244704_1_kneaddata_paired	Spirochaetota	32587	P	57	0	57	0.00003
SRR8244704_1_kneaddata_paired	Firmicutes_B	17289	P	15	0	15	0.00001
SRR8244704_1_kneaddata_paired	Firmicutes_C	17613	P	7	0	7	0.00000
SRR8244704_1_kneaddata_paired	Firmicutes_I	18140	P	5	0	5	0.00000
SRR8244704_1_kneaddata_paired	Elusimicrobiota	11888	P	2	0	2	0.00000
SRR8244704_1_kneaddata_paired	Thermotogota	33086	P	2	0	2	0.00000
SRR8244705_1_kneaddata_paired	Bacteroidota	4587	P	17013089	74687	17087776	0.70926
SRR8244705_1_kneaddata_paired	Firmicutes_A	14608	P	4589178	33868	4623046	0.19189
SRR8244705_1_kneaddata_paired	Verrucomicrobiota	33333	P	1725084	106143	1831227	0.07601
SRR8244705_1_kneaddata_paired	Firmicutes	12188	P	290382	2286	292668	0.01215
SRR8244705_1_kneaddata_paired	Deferribacterota	10822	P	134823	536	135359	0.00562
SRR8244705_1_kneaddata_paired	Proteobacteria	22518	P	66333	178	66511	0.00276
SRR8244705_1_kneaddata_paired	Actinobacteriota	615	P	27498	93	27591	0.00115
SRR8244705_1_kneaddata_paired	Desulfobacterota_A	11509	P	18465	77	18542	0.00077
SRR8244705_1_kneaddata_paired	Cyanobacteria	9876	P	6687	90	6777	0.00028
SRR8244705_1_kneaddata_paired	Spirochaetota	32587	P	946	2	948	0.00004
SRR8244705_1_kneaddata_paired	Campylobacterota	8700	P	818	0	818	0.00003
SRR8244705_1_kneaddata_paired	Firmicutes_B	17289	P	575	22	597	0.00002
SRR8244705_1_kneaddata_paired	Firmicutes_C	17613	P	185	0	185	0.00001
SRR8244705_1_kneaddata_paired	Firmicutes_I	18140	P	141	0	141	0.00001
SRR8244705_1_kneaddata_paired	Thermotogota	33086	P	35	0	35	0.00000
SRR8244705_1_kneaddata_paired	Elusimicrobiota	11888	P	7	0	7	0.00000
SRR8244706_1_kneaddata_paired	Bacteroidota	4587	P	8516443	37203	8553646	0.73541
SRR8244706_1_kneaddata_paired	Firmicutes_A	14608	P	1787561	11586	1799147	0.15468
SRR8244706_1_kneaddata_paired	Verrucomicrobiota	33333	P	1035785	53790	1089575	0.09368
SRR8244706_1_kneaddata_paired	Firmicutes	12188	P	122037	768	122805	0.01056
SRR8244706_1_kneaddata_paired	Proteobacteria	22518	P	31912	87	31999	0.00275
SRR8244706_1_kneaddata_paired	Deferribacterota	10822	P	13165	43	13208	0.00114
SRR8244706_1_kneaddata_paired	Actinobacteriota	615	P	8792	21	8813	0.00076
SRR8244706_1_kneaddata_paired	Desulfobacterota_A	11509	P	7284	24	7308	0.00063
SRR8244706_1_kneaddata_paired	Cyanobacteria	9876	P	3334	37	3371	0.00029
SRR8244706_1_kneaddata_paired	Spirochaetota	32587	P	408	0	408	0.00004
SRR8244706_1_kneaddata_paired	Campylobacterota	8700	P	369	0	369	0.00003
SRR8244706_1_kneaddata_paired	Firmicutes_B	17289	P	278	9	287	0.00002
SRR8244706_1_kneaddata_paired	Firmicutes_C	17613	P	68	0	68	0.00001
SRR8244706_1_kneaddata_paired	Firmicutes_I	18140	P	53	0	53	0.00000
SRR8244706_1_kneaddata_paired	Thermotogota	33086	P	15	0	15	0.00000
SRR8244706_1_kneaddata_paired	Elusimicrobiota	11888	P	12	0	12	0.00000
SRR8244707_1_kneaddata_paired	Bacteroidota	4587	P	4971325	35244	5006569	0.83038
SRR8244707_1_kneaddata_paired	Firmicutes_A	14608	P	904627	9053	913680	0.15154
SRR8244707_1_kneaddata_paired	Firmicutes	12188	P	52568	503	53071	0.00880
SRR8244707_1_kneaddata_paired	Proteobacteria	22518	P	26639	67	26706	0.00443
SRR8244707_1_kneaddata_paired	Deferribacterota	10822	P	13279	47	13326	0.00221
SRR8244707_1_kneaddata_paired	Actinobacteriota	615	P	7501	17	7518	0.00125
SRR8244707_1_kneaddata_paired	Desulfobacterota_A	11509	P	3819	26	3845	0.00064
SRR8244707_1_kneaddata_paired	Verrucomicrobiota	33333	P	2976	164	3140	0.00052
SRR8244707_1_kneaddata_paired	Cyanobacteria	9876	P	1072	15	1087	0.00018
SRR8244707_1_kneaddata_paired	Spirochaetota	32587	P	99	0	99	0.00002
SRR8244707_1_kneaddata_paired	Campylobacterota	8700	P	81	0	81	0.00001
SRR8244707_1_kneaddata_paired	Firmicutes_B	17289	P	51	1	52	0.00001
SRR8244707_1_kneaddata_paired	Firmicutes_C	17613	P	22	0	22	0.00000
SRR8244707_1_kneaddata_paired	Firmicutes_I	18140	P	22	0	22	0.00000
SRR8244707_1_kneaddata_paired	Elusimicrobiota	11888	P	2	0	2	0.00000
SRR8244707_1_kneaddata_paired	Thermotogota	33086	P	1	0	1	0.00000
SRR8244708_1_kneaddata_paired	Bacteroidota	4587	P	1213186	1359	1214545	0.51075
SRR8244708_1_kneaddata_paired	Verrucomicrobiota	33333	P	533918	11475	545393	0.22936
SRR8244708_1_kneaddata_paired	Firmicutes_A	14608	P	532960	1296	534256	0.22467
SRR8244708_1_kneaddata_paired	Firmicutes	12188	P	29676	73	29749	0.01251
SRR8244708_1_kneaddata_paired	Proteobacteria	22518	P	22812	16	22828	0.00960
SRR8244708_1_kneaddata_paired	Actinobacteriota	615	P	19995	20	20015	0.00842
SRR8244708_1_kneaddata_paired	Deferribacterota	10822	P	8648	11	8659	0.00364
SRR8244708_1_kneaddata_paired	Desulfobacterota_A	11509	P	1522	2	1524	0.00064
SRR8244708_1_kneaddata_paired	Cyanobacteria	9876	P	728	2	730	0.00031
SRR8244708_1_kneaddata_paired	Firmicutes_B	17289	P	101	1	102	0.00004
SRR8244708_1_kneaddata_paired	Spirochaetota	32587	P	61	0	61	0.00003
SRR8244708_1_kneaddata_paired	Firmicutes_C	17613	P	37	0	37	0.00002
SRR8244708_1_kneaddata_paired	Campylobacterota	8700	P	23	0	23	0.00001
SRR8244708_1_kneaddata_paired	Firmicutes_I	18140	P	11	0	11	0.00000
SRR8244708_1_kneaddata_paired	Thermotogota	33086	P	6	0	6	0.00000
SRR8244709_1_kneaddata_paired	Bacteroidota	4587	P	4984168	55920	5040088	0.55071
SRR8244709_1_kneaddata_paired	Firmicutes_A	14608	P	3500543	31969	3532512	0.38598
SRR8244709_1_kneaddata_paired	Firmicutes	12188	P	364022	5533	369555	0.04038
SRR8244709_1_kneaddata_paired	Actinobacteriota	615	P	137799	501	138300	0.01511
SRR8244709_1_kneaddata_paired	Proteobacteria	22518	P	26140	80	26220	0.00287
SRR8244709_1_kneaddata_paired	Desulfobacterota_A	11509	P	16439	136	16575	0.00181
SRR8244709_1_kneaddata_paired	Cyanobacteria	9876	P	15254	123	15377	0.00168
SRR8244709_1_kneaddata_paired	Deferribacterota	10822	P	6377	37	6414	0.00070
SRR8244709_1_kneaddata_paired	Verrucomicrobiota	33333	P	5049	460	5509	0.00060
SRR8244709_1_kneaddata_paired	Spirochaetota	32587	P	470	1	471	0.00005
SRR8244709_1_kneaddata_paired	Campylobacterota	8700	P	361	0	361	0.00004
SRR8244709_1_kneaddata_paired	Firmicutes_B	17289	P	330	19	349	0.00004
SRR8244709_1_kneaddata_paired	Firmicutes_I	18140	P	116	0	116	0.00001
SRR8244709_1_kneaddata_paired	Firmicutes_C	17613	P	62	0	62	0.00001
SRR8244709_1_kneaddata_paired	Thermotogota	33086	P	24	0	24	0.00000
SRR8244709_1_kneaddata_paired	Elusimicrobiota	11888	P	11	0	11	0.00000
SRR8244710_1_kneaddata_paired	Bacteroidota	4587	P	1258376	9671	1268047	0.92670
SRR8244710_1_kneaddata_paired	Firmicutes_A	14608	P	61030	1093	62123	0.04540
SRR8244710_1_kneaddata_paired	Firmicutes	12188	P	28807	233	29040	0.02122
SRR8244710_1_kneaddata_paired	Actinobacteriota	615	P	6348	17	6365	0.00465
SRR8244710_1_kneaddata_paired	Proteobacteria	22518	P	1798	5	1803	0.00132
SRR8244710_1_kneaddata_paired	Deferribacterota	10822	P	255	0	255	0.00019
SRR8244710_1_kneaddata_paired	Cyanobacteria	9876	P	224	3	227	0.00017
SRR8244710_1_kneaddata_paired	Verrucomicrobiota	33333	P	206	10	216	0.00016
SRR8244710_1_kneaddata_paired	Desulfobacterota_A	11509	P	196	2	198	0.00015
SRR8244710_1_kneaddata_paired	Campylobacterota	8700	P	36	0	36	0.00003
SRR8244710_1_kneaddata_paired	Spirochaetota	32587	P	19	0	19	0.00001
SRR8244710_1_kneaddata_paired	Firmicutes_I	18140	P	9	0	9	0.00001
SRR8244710_1_kneaddata_paired	Firmicutes_B	17289	P	5	0	5	0.00000
SRR8244711_1_kneaddata_paired	Firmicutes_A	14608	P	14718627	72272	14790899	0.67773
SRR8244711_1_kneaddata_paired	Bacteroidota	4587	P	6072551	38214	6110765	0.28000
SRR8244711_1_kneaddata_paired	Firmicutes	12188	P	291170	3382	294552	0.01350
SRR8244711_1_kneaddata_paired	Deferribacterota	10822	P	214353	731	215084	0.00986
SRR8244711_1_kneaddata_paired	Actinobacteriota	615	P	185234	563	185797	0.00851
SRR8244711_1_kneaddata_paired	Desulfobacterota_A	11509	P	145539	488	146027	0.00669
SRR8244711_1_kneaddata_paired	Proteobacteria	22518	P	54721	81	54802	0.00251
SRR8244711_1_kneaddata_paired	Cyanobacteria	9876	P	20835	106	20941	0.00096
SRR8244711_1_kneaddata_paired	Verrucomicrobiota	33333	P	2059	100	2159	0.00010
SRR8244711_1_kneaddata_paired	Firmicutes_B	17289	P	1309	43	1352	0.00006
SRR8244711_1_kneaddata_paired	Spirochaetota	32587	P	893	0	893	0.00004
SRR8244711_1_kneaddata_paired	Campylobacterota	8700	P	301	0	301	0.00001
SRR8244711_1_kneaddata_paired	Firmicutes_C	17613	P	263	0	263	0.00001
SRR8244711_1_kneaddata_paired	Firmicutes_I	18140	P	180	0	180	0.00001
SRR8244711_1_kneaddata_paired	Elusimicrobiota	11888	P	30	0	30	0.00000
SRR8244711_1_kneaddata_paired	Thermotogota	33086	P	23	0	23	0.00000
SRR8244712_1_kneaddata_paired	Bacteroidota	4587	P	5129035	36593	5165628	0.79287
SRR8244712_1_kneaddata_paired	Firmicutes_A	14608	P	1216078	8302	1224380	0.18793
SRR8244712_1_kneaddata_paired	Firmicutes	12188	P	68399	600	68999	0.01059
SRR8244712_1_kneaddata_paired	Deferribacterota	10822	P	23637	74	23711	0.00364
SRR8244712_1_kneaddata_paired	Proteobacteria	22518	P	17951	30	17981	0.00276
SRR8244712_1_kneaddata_paired	Actinobacteriota	615	P	9449	22	9471	0.00145
SRR8244712_1_kneaddata_paired	Desulfobacterota_A	11509	P	3074	24	3098	0.00048
SRR8244712_1_kneaddata_paired	Cyanobacteria	9876	P	794	12	806	0.00012
SRR8244712_1_kneaddata_paired	Verrucomicrobiota	33333	P	673	32	705	0.00011
SRR8244712_1_kneaddata_paired	Firmicutes_B	17289	P	107	3	110	0.00002
SRR8244712_1_kneaddata_paired	Campylobacterota	8700	P	94	0	94	0.00001
SRR8244712_1_kneaddata_paired	Spirochaetota	32587	P	86	0	86	0.00001
SRR8244712_1_kneaddata_paired	Firmicutes_C	17613	P	31	0	31	0.00000
SRR8244712_1_kneaddata_paired	Firmicutes_I	18140	P	27	0	27	0.00000
SRR8244712_1_kneaddata_paired	Elusimicrobiota	11888	P	3	0	3	0.00000
SRR8244712_1_kneaddata_paired	Thermotogota	33086	P	2	0	2	0.00000
SRR8244713_1_kneaddata_paired	Bacteroidota	4587	P	1075416	10820	1086236	0.49037
SRR8244713_1_kneaddata_paired	Firmicutes_A	14608	P	1069018	6635	1075653	0.48559
SRR8244713_1_kneaddata_paired	Firmicutes	12188	P	33078	808	33886	0.01530
SRR8244713_1_kneaddata_paired	Actinobacteriota	615	P	11028	35	11063	0.00499
SRR8244713_1_kneaddata_paired	Deferribacterota	10822	P	2234	11	2245	0.00101
SRR8244713_1_kneaddata_paired	Proteobacteria	22518	P	2213	10	2223	0.00100
SRR8244713_1_kneaddata_paired	Desulfobacterota_A	11509	P	1708	20	1728	0.00078
SRR8244713_1_kneaddata_paired	Cyanobacteria	9876	P	1063	9	1072	0.00048
SRR8244713_1_kneaddata_paired	Verrucomicrobiota	33333	P	701	54	755	0.00034
SRR8244713_1_kneaddata_paired	Spirochaetota	32587	P	109	0	109	0.00005
SRR8244713_1_kneaddata_paired	Firmicutes_B	17289	P	79	3	82	0.00004
SRR8244713_1_kneaddata_paired	Campylobacterota	8700	P	46	0	46	0.00002
SRR8244713_1_kneaddata_paired	Firmicutes_I	18140	P	19	0	19	0.00001
SRR8244713_1_kneaddata_paired	Firmicutes_C	17613	P	17	0	17	0.00001
SRR8244713_1_kneaddata_paired	Elusimicrobiota	11888	P	3	0	3	0.00000
SRR8244713_1_kneaddata_paired	Thermotogota	33086	P	1	0	1	0.00000
SRR8244714_1_kneaddata_paired	Bacteroidota	4587	P	7727421	65868	7793289	0.48340
SRR8244714_1_kneaddata_paired	Firmicutes_A	14608	P	7008165	54241	7062406	0.43807
SRR8244714_1_kneaddata_paired	Proteobacteria	22518	P	532905	2095	535000	0.03319
SRR8244714_1_kneaddata_paired	Firmicutes	12188	P	373110	5828	378938	0.02350
SRR8244714_1_kneaddata_paired	Desulfobacterota_A	11509	P	117329	512	117841	0.00731
SRR8244714_1_kneaddata_paired	Actinobacteriota	615	P	70806	378	71184	0.00442
SRR8244714_1_kneaddata_paired	Cyanobacteria	9876	P	69733	901	70634	0.00438
SRR8244714_1_kneaddata_paired	Deferribacterota	10822	P	56416	335	56751	0.00352
SRR8244714_1_kneaddata_paired	Verrucomicrobiota	33333	P	30368	2793	33161	0.00206
SRR8244714_1_kneaddata_paired	Spirochaetota	32587	P	1052	2	1054	0.00007
SRR8244714_1_kneaddata_paired	Campylobacterota	8700	P	567	0	567	0.00004
SRR8244714_1_kneaddata_paired	Firmicutes_B	17289	P	544	31	575	0.00004
SRR8244714_1_kneaddata_paired	Firmicutes_I	18140	P	137	0	137	0.00001
SRR8244714_1_kneaddata_paired	Firmicutes_C	17613	P	101	0	101	0.00001
SRR8244714_1_kneaddata_paired	Thermotogota	33086	P	22	0	22	0.00000
SRR8244714_1_kneaddata_paired	Elusimicrobiota	11888	P	15	0	15	0.00000
SRR8244715_1_kneaddata_paired	Bacteroidota	4587	P	1520772	11298	1532070	0.53980
SRR8244715_1_kneaddata_paired	Firmicutes_A	14608	P	1057180	7551	1064731	0.37514
SRR8244715_1_kneaddata_paired	Proteobacteria	22518	P	95207	185	95392	0.03361
SRR8244715_1_kneaddata_paired	Firmicutes	12188	P	54383	698	55081	0.01941
SRR8244715_1_kneaddata_paired	Desulfobacterota_A	11509	P	38613	118	38731	0.01365
SRR8244715_1_kneaddata_paired	Deferribacterota	10822	P	32625	142	32767	0.01154
SRR8244715_1_kneaddata_paired	Actinobacteriota	615	P	14834	50	14884	0.00524
SRR8244715_1_kneaddata_paired	Cyanobacteria	9876	P	3407	27	3434	0.00121
SRR8244715_1_kneaddata_paired	Verrucomicrobiota	33333	P	720	47	767	0.00027
SRR8244715_1_kneaddata_paired	Spirochaetota	32587	P	160	0	160	0.00006
SRR8244715_1_kneaddata_paired	Firmicutes_B	17289	P	106	4	110	0.00004
SRR8244715_1_kneaddata_paired	Campylobacterota	8700	P	36	0	36	0.00001
SRR8244715_1_kneaddata_paired	Firmicutes_C	17613	P	25	0	25	0.00001
SRR8244715_1_kneaddata_paired	Firmicutes_I	18140	P	16	0	16	0.00001
SRR8244715_1_kneaddata_paired	Thermotogota	33086	P	4	0	4	0.00000
SRR8244715_1_kneaddata_paired	Elusimicrobiota	11888	P	2	0	2	0.00000
SRR8244716_1_kneaddata_paired	Bacteroidota	4587	P	1341344	15330	1356674	0.74680
SRR8244716_1_kneaddata_paired	Firmicutes_A	14608	P	410515	4146	414661	0.22826
SRR8244716_1_kneaddata_paired	Firmicutes	12188	P	27087	453	27540	0.01516
SRR8244716_1_kneaddata_paired	Deferribacterota	10822	P	7991	43	8034	0.00442
SRR8244716_1_kneaddata_paired	Actinobacteriota	615	P	4268	16	4284	0.00236
SRR8244716_1_kneaddata_paired	Proteobacteria	22518	P	3359	13	3372	0.00186
SRR8244716_1_kneaddata_paired	Desulfobacterota_A	11509	P	920	11	931	0.00051
SRR8244716_1_kneaddata_paired	Cyanobacteria	9876	P	622	7	629	0.00035
SRR8244716_1_kneaddata_paired	Verrucomicrobiota	33333	P	331	27	358	0.00020
SRR8244716_1_kneaddata_paired	Spirochaetota	32587	P	70	0	70	0.00004
SRR8244716_1_kneaddata_paired	Firmicutes_B	17289	P	43	2	45	0.00002
SRR8244716_1_kneaddata_paired	Campylobacterota	8700	P	32	0	32	0.00002
SRR8244716_1_kneaddata_paired	Firmicutes_I	18140	P	10	0	10	0.00001
SRR8244716_1_kneaddata_paired	Firmicutes_C	17613	P	3	0	3	0.00000
SRR8244716_1_kneaddata_paired	Elusimicrobiota	11888	P	1	0	1	0.00000
SRR8244716_1_kneaddata_paired	Thermotogota	33086	P	1	0	1	0.00000
SRR8244717_1_kneaddata_paired	Firmicutes_A	14608	P	3330894	20368	3351262	0.68035
SRR8244717_1_kneaddata_paired	Bacteroidota	4587	P	1304275	13286	1317561	0.26748
SRR8244717_1_kneaddata_paired	Firmicutes	12188	P	97297	2157	99454	0.02019
SRR8244717_1_kneaddata_paired	Desulfobacterota_A	11509	P	60759	250	61009	0.01239
SRR8244717_1_kneaddata_paired	Deferribacterota	10822	P	53230	270	53500	0.01086
SRR8244717_1_kneaddata_paired	Actinobacteriota	615	P	29460	112	29572	0.00600
SRR8244717_1_kneaddata_paired	Proteobacteria	22518	P	5771	24	5795	0.00118
SRR8244717_1_kneaddata_paired	Cyanobacteria	9876	P	4620	41	4661	0.00095
SRR8244717_1_kneaddata_paired	Verrucomicrobiota	33333	P	1951	151	2102	0.00043
SRR8244717_1_kneaddata_paired	Spirochaetota	32587	P	395	0	395	0.00008
SRR8244717_1_kneaddata_paired	Firmicutes_B	17289	P	250	12	262	0.00005
SRR8244717_1_kneaddata_paired	Campylobacterota	8700	P	83	0	83	0.00002
SRR8244717_1_kneaddata_paired	Firmicutes_I	18140	P	46	0	46	0.00001
SRR8244717_1_kneaddata_paired	Firmicutes_C	17613	P	41	0	41	0.00001
SRR8244717_1_kneaddata_paired	Thermotogota	33086	P	8	0	8	0.00000
SRR8244717_1_kneaddata_paired	Elusimicrobiota	11888	P	6	0	6	0.00000
SRR8244718_1_kneaddata_paired	Firmicutes_A	14608	P	2298279	13959	2312238	0.50168
SRR8244718_1_kneaddata_paired	Bacteroidota	4587	P	2091812	13619	2105431	0.45681
SRR8244718_1_kneaddata_paired	Firmicutes	12188	P	95903	1435	97338	0.02112
SRR8244718_1_kneaddata_paired	Proteobacteria	22518	P	31498	166	31664	0.00687
SRR8244718_1_kneaddata_paired	Actinobacteriota	615	P	22259	82	22341	0.00485
SRR8244718_1_kneaddata_paired	Cyanobacteria	9876	P	20670	172	20842	0.00452
SRR8244718_1_kneaddata_paired	Desulfobacterota_A	11509	P	11038	64	11102	0.00241
SRR8244718_1_kneaddata_paired	Deferribacterota	10822	P	4457	20	4477	0.00097
SRR8244718_1_kneaddata_paired	Verrucomicrobiota	33333	P	2621	188	2809	0.00061
SRR8244718_1_kneaddata_paired	Spirochaetota	32587	P	242	0	242	0.00005
SRR8244718_1_kneaddata_paired	Campylobacterota	8700	P	231	0	231	0.00005
SRR8244718_1_kneaddata_paired	Firmicutes_B	17289	P	188	8	196	0.00004
SRR8244718_1_kneaddata_paired	Firmicutes_I	18140	P	53	0	53	0.00001
SRR8244718_1_kneaddata_paired	Firmicutes_C	17613	P	47	0	47	0.00001
SRR8244718_1_kneaddata_paired	Elusimicrobiota	11888	P	7	0	7	0.00000
SRR8244718_1_kneaddata_paired	Thermotogota	33086	P	4	0	4	0.00000
SRR8244719_1_kneaddata_paired	Bacteroidota	4587	P	2818316	22277	2840593	0.65458
SRR8244719_1_kneaddata_paired	Firmicutes_A	14608	P	1356866	9706	1366572	0.31491
SRR8244719_1_kneaddata_paired	Firmicutes	12188	P	89151	908	90059	0.02075
SRR8244719_1_kneaddata_paired	Actinobacteriota	615	P	22817	69	22886	0.00527
SRR8244719_1_kneaddata_paired	Proteobacteria	22518	P	11016	21	11037	0.00254
SRR8244719_1_kneaddata_paired	Deferribacterota	10822	P	4125	16	4141	0.00095
SRR8244719_1_kneaddata_paired	Desulfobacterota_A	11509	P	2161	31	2192	0.00051
SRR8244719_1_kneaddata_paired	Cyanobacteria	9876	P	1363	12	1375	0.00032
SRR8244719_1_kneaddata_paired	Verrucomicrobiota	33333	P	325	19	344	0.00008
SRR8244719_1_kneaddata_paired	Firmicutes_B	17289	P	107	4	111	0.00003
SRR8244719_1_kneaddata_paired	Campylobacterota	8700	P	90	0	90	0.00002
SRR8244719_1_kneaddata_paired	Spirochaetota	32587	P	79	0	79	0.00002
SRR8244719_1_kneaddata_paired	Firmicutes_I	18140	P	28	0	28	0.00001
SRR8244719_1_kneaddata_paired	Firmicutes_C	17613	P	22	0	22	0.00001
SRR8244719_1_kneaddata_paired	Elusimicrobiota	11888	P	7	0	7	0.00000
SRR8244719_1_kneaddata_paired	Thermotogota	33086	P	6	0	6	0.00000
SRR8244720_1_kneaddata_paired	Bacteroidota	4587	P	6777145	55501	6832646	0.59215
SRR8244720_1_kneaddata_paired	Firmicutes_A	14608	P	3587672	29529	3617201	0.31348
SRR8244720_1_kneaddata_paired	Firmicutes	12188	P	431320	5042	436362	0.03782
SRR8244720_1_kneaddata_paired	Proteobacteria	22518	P	273167	516	273683	0.02372
SRR8244720_1_kneaddata_paired	Actinobacteriota	615	P	173342	700	174042	0.01508
SRR8244720_1_kneaddata_paired	Deferribacterota	10822	P	123240	610	123850	0.01073
SRR8244720_1_kneaddata_paired	Desulfobacterota_A	11509	P	71076	300	71376	0.00619
SRR8244720_1_kneaddata_paired	Cyanobacteria	9876	P	6725	62	6787	0.00059
SRR8244720_1_kneaddata_paired	Verrucomicrobiota	33333	P	1142	84	1226	0.00011
SRR8244720_1_kneaddata_paired	Spirochaetota	32587	P	567	0	567	0.00005
SRR8244720_1_kneaddata_paired	Firmicutes_B	17289	P	531	25	556	0.00005
SRR8244720_1_kneaddata_paired	Campylobacterota	8700	P	241	0	241	0.00002
SRR8244720_1_kneaddata_paired	Firmicutes_I	18140	P	83	0	83	0.00001
SRR8244720_1_kneaddata_paired	Firmicutes_C	17613	P	72	0	72	0.00001
SRR8244720_1_kneaddata_paired	Elusimicrobiota	11888	P	10	0	10	0.00000
SRR8244720_1_kneaddata_paired	Thermotogota	33086	P	9	0	9	0.00000
SRR8244721_1_kneaddata_paired	Bacteroidota	4587	P	107400	683	108083	0.51257
SRR8244721_1_kneaddata_paired	Firmicutes_A	14608	P	93596	531	94127	0.44639
SRR8244721_1_kneaddata_paired	Firmicutes	12188	P	4256	57	4313	0.02046
SRR8244721_1_kneaddata_paired	Proteobacteria	22518	P	1432	6	1438	0.00682
SRR8244721_1_kneaddata_paired	Actinobacteriota	615	P	1184	3	1187	0.00563
SRR8244721_1_kneaddata_paired	Cyanobacteria	9876	P	648	9	657	0.00312
SRR8244721_1_kneaddata_paired	Desulfobacterota_A	11509	P	626	2	628	0.00298
SRR8244721_1_kneaddata_paired	Verrucomicrobiota	33333	P	272	18	290	0.00138
SRR8244721_1_kneaddata_paired	Deferribacterota	10822	P	100	0	100	0.00048
SRR8244721_1_kneaddata_paired	Campylobacterota	8700	P	12	0	12	0.00006
SRR8244721_1_kneaddata_paired	Firmicutes_B	17289	P	12	0	12	0.00006
SRR8244721_1_kneaddata_paired	Spirochaetota	32587	P	9	0	9	0.00004
SRR8244721_1_kneaddata_paired	Firmicutes_I	18140	P	2	0	2	0.00001
SRR8244721_1_kneaddata_paired	Elusimicrobiota	11888	P	1	0	1	0.00000
SRR8244721_1_kneaddata_paired	Firmicutes_C	17613	P	1	0	1	0.00000
SRR8244721_1_kneaddata_paired	Thermotogota	33086	P	1	0	1	0.00000
SRR8244722_1_kneaddata_paired	Bacteroidota	4587	P	7300406	55380	7355786	0.81421
SRR8244722_1_kneaddata_paired	Firmicutes_A	14608	P	1384600	15548	1400148	0.15498
SRR8244722_1_kneaddata_paired	Firmicutes	12188	P	127495	1733	129228	0.01430
SRR8244722_1_kneaddata_paired	Proteobacteria	22518	P	62540	311	62851	0.00696
SRR8244722_1_kneaddata_paired	Deferribacterota	10822	P	52630	289	52919	0.00586
SRR8244722_1_kneaddata_paired	Actinobacteriota	615	P	14227	63	14290	0.00158
SRR8244722_1_kneaddata_paired	Verrucomicrobiota	33333	P	9410	795	10205	0.00113
SRR8244722_1_kneaddata_paired	Desulfobacterota_A	11509	P	5371	44	5415	0.00060
SRR8244722_1_kneaddata_paired	Cyanobacteria	9876	P	2354	49	2403	0.00027
SRR8244722_1_kneaddata_paired	Spirochaetota	32587	P	359	1	360	0.00004
SRR8244722_1_kneaddata_paired	Campylobacterota	8700	P	345	0	345	0.00004
SRR8244722_1_kneaddata_paired	Firmicutes_B	17289	P	151	8	159	0.00002
SRR8244722_1_kneaddata_paired	Firmicutes_I	18140	P	72	0	72	0.00001
SRR8244722_1_kneaddata_paired	Firmicutes_C	17613	P	57	0	57	0.00001
SRR8244722_1_kneaddata_paired	Thermotogota	33086	P	7	0	7	0.00000
SRR8244722_1_kneaddata_paired	Elusimicrobiota	11888	P	4	0	4	0.00000
SRR8244723_1_kneaddata_paired	Bacteroidota	4587	P	4082851	30370	4113221	0.80479
SRR8244723_1_kneaddata_paired	Firmicutes_A	14608	P	928315	7153	935468	0.18303
SRR8244723_1_kneaddata_paired	Firmicutes	12188	P	24045	218	24263	0.00475
SRR8244723_1_kneaddata_paired	Proteobacteria	22518	P	17042	28	17070	0.00334
SRR8244723_1_kneaddata_paired	Deferribacterota	10822	P	10512	29	10541	0.00206
SRR8244723_1_kneaddata_paired	Actinobacteriota	615	P	4546	8	4554	0.00089
SRR8244723_1_kneaddata_paired	Desulfobacterota_A	11509	P	4515	24	4539	0.00089
SRR8244723_1_kneaddata_paired	Cyanobacteria	9876	P	925	7	932	0.00018
SRR8244723_1_kneaddata_paired	Verrucomicrobiota	33333	P	103	4	107	0.00002
SRR8244723_1_kneaddata_paired	Spirochaetota	32587	P	69	0	69	0.00001
SRR8244723_1_kneaddata_paired	Firmicutes_B	17289	P	63	1	64	0.00001
SRR8244723_1_kneaddata_paired	Campylobacterota	8700	P	29	0	29	0.00001
SRR8244723_1_kneaddata_paired	Firmicutes_I	18140	P	18	0	18	0.00000
SRR8244723_1_kneaddata_paired	Firmicutes_C	17613	P	10	0	10	0.00000
SRR8244723_1_kneaddata_paired	Thermotogota	33086	P	3	0	3	0.00000
SRR8244723_1_kneaddata_paired	Elusimicrobiota	11888	P	1	0	1	0.00000
SRR8291345_1_kneaddata_paired	Firmicutes_A	14608	P	15198212	90824	15289036	0.75749
SRR8291345_1_kneaddata_paired	Bacteroidota	4587	P	4346670	18340	4365010	0.21626
SRR8291345_1_kneaddata_paired	Firmicutes	12188	P	341868	8971	350839	0.01738
SRR8291345_1_kneaddata_paired	Verrucomicrobiota	33333	P	79800	5589	85389	0.00423
SRR8291345_1_kneaddata_paired	Actinobacteriota	615	P	52819	32	52851	0.00262
SRR8291345_1_kneaddata_paired	Proteobacteria	22518	P	20495	548	21043	0.00104
SRR8291345_1_kneaddata_paired	Cyanobacteria	9876	P	14612	998	15610	0.00077
SRR8291345_1_kneaddata_paired	Firmicutes_B	17289	P	1194	52	1246	0.00006
SRR8291345_1_kneaddata_paired	Desulfobacterota_A	11509	P	1188	154	1342	0.00007
SRR8291345_1_kneaddata_paired	Spirochaetota	32587	P	666	1	667	0.00003
SRR8291345_1_kneaddata_paired	Campylobacterota	8700	P	379	0	379	0.00002
SRR8291345_1_kneaddata_paired	Firmicutes_I	18140	P	160	0	160	0.00001
SRR8291345_1_kneaddata_paired	Thermotogota	33086	P	115	0	115	0.00001
SRR8291345_1_kneaddata_paired	Firmicutes_C	17613	P	108	0	108	0.00001
SRR8291345_1_kneaddata_paired	Deferribacterota	10822	P	80	0	80	0.00000
SRR8291345_1_kneaddata_paired	Elusimicrobiota	11888	P	9	0	9	0.00000
SRR8291346_1_kneaddata_paired	Firmicutes_A	14608	P	11075867	67338	11143205	0.80383
SRR8291346_1_kneaddata_paired	Bacteroidota	4587	P	2493711	13618	2507329	0.18087
SRR8291346_1_kneaddata_paired	Firmicutes	12188	P	133765	6614	140379	0.01013
SRR8291346_1_kneaddata_paired	Actinobacteriota	615	P	31839	26	31865	0.00230
SRR8291346_1_kneaddata_paired	Proteobacteria	22518	P	13649	385	14034	0.00101
SRR8291346_1_kneaddata_paired	Verrucomicrobiota	33333	P	12871	974	13845	0.00100
SRR8291346_1_kneaddata_paired	Cyanobacteria	9876	P	7034	48	7082	0.00051
SRR8291346_1_kneaddata_paired	Firmicutes_B	17289	P	1377	66	1443	0.00010
SRR8291346_1_kneaddata_paired	Desulfobacterota_A	11509	P	1316	216	1532	0.00011
SRR8291346_1_kneaddata_paired	Spirochaetota	32587	P	1300	1	1301	0.00009
SRR8291346_1_kneaddata_paired	Campylobacterota	8700	P	268	0	268	0.00002
SRR8291346_1_kneaddata_paired	Thermotogota	33086	P	108	0	108	0.00001
SRR8291346_1_kneaddata_paired	Firmicutes_I	18140	P	102	0	102	0.00001
SRR8291346_1_kneaddata_paired	Firmicutes_C	17613	P	90	0	90	0.00001
SRR8291346_1_kneaddata_paired	Deferribacterota	10822	P	73	0	73	0.00001
SRR8291346_1_kneaddata_paired	Elusimicrobiota	11888	P	3	0	3	0.00000
SRR8291347_1_kneaddata_paired	Firmicutes_A	14608	P	20361464	94685	20456149	0.80210
SRR8291347_1_kneaddata_paired	Bacteroidota	4587	P	3943974	19554	3963528	0.15541
SRR8291347_1_kneaddata_paired	Firmicutes	12188	P	883834	16871	900705	0.03532
SRR8291347_1_kneaddata_paired	Actinobacteriota	615	P	89542	36	89578	0.00351
SRR8291347_1_kneaddata_paired	Verrucomicrobiota	33333	P	62435	3657	66092	0.00259
SRR8291347_1_kneaddata_paired	Proteobacteria	22518	P	12760	264	13024	0.00051
SRR8291347_1_kneaddata_paired	Cyanobacteria	9876	P	6711	49	6760	0.00027
SRR8291347_1_kneaddata_paired	Firmicutes_B	17289	P	2319	86	2405	0.00009
SRR8291347_1_kneaddata_paired	Desulfobacterota_A	11509	P	1996	220	2216	0.00009
SRR8291347_1_kneaddata_paired	Spirochaetota	32587	P	1497	1	1498	0.00006
SRR8291347_1_kneaddata_paired	Campylobacterota	8700	P	602	0	602	0.00002
SRR8291347_1_kneaddata_paired	Firmicutes_I	18140	P	267	0	267	0.00001
SRR8291347_1_kneaddata_paired	Thermotogota	33086	P	191	0	191	0.00001
SRR8291347_1_kneaddata_paired	Firmicutes_C	17613	P	183	0	183	0.00001
SRR8291347_1_kneaddata_paired	Deferribacterota	10822	P	144	0	144	0.00001
SRR8291347_1_kneaddata_paired	Elusimicrobiota	11888	P	23	0	23	0.00000
SRR8291348_1_kneaddata_paired	Firmicutes_A	14608	P	18356871	92263	18449134	0.87412
SRR8291348_1_kneaddata_paired	Bacteroidota	4587	P	2120196	10266	2130462	0.10094
SRR8291348_1_kneaddata_paired	Firmicutes	12188	P	372664	12726	385390	0.01826
SRR8291348_1_kneaddata_paired	Verrucomicrobiota	33333	P	55212	3276	58488	0.00277
SRR8291348_1_kneaddata_paired	Actinobacteriota	615	P	54282	28	54310	0.00257
SRR8291348_1_kneaddata_paired	Proteobacteria	22518	P	13882	300	14182	0.00067
SRR8291348_1_kneaddata_paired	Cyanobacteria	9876	P	6138	46	6184	0.00029
SRR8291348_1_kneaddata_paired	Firmicutes_B	17289	P	2638	99	2737	0.00013
SRR8291348_1_kneaddata_paired	Desulfobacterota_A	11509	P	2211	284	2495	0.00012
SRR8291348_1_kneaddata_paired	Spirochaetota	32587	P	1175	1	1176	0.00006
SRR8291348_1_kneaddata_paired	Campylobacterota	8700	P	568	0	568	0.00003
SRR8291348_1_kneaddata_paired	Thermotogota	33086	P	254	0	254	0.00001
SRR8291348_1_kneaddata_paired	Firmicutes_I	18140	P	174	0	174	0.00001
SRR8291348_1_kneaddata_paired	Deferribacterota	10822	P	148	0	148	0.00001
SRR8291348_1_kneaddata_paired	Firmicutes_C	17613	P	123	0	123	0.00001
SRR8291348_1_kneaddata_paired	Elusimicrobiota	11888	P	14	0	14	0.00000
SRR8291350_1_kneaddata_paired	Firmicutes_A	14608	P	18738128	114104	18852232	0.80220
SRR8291350_1_kneaddata_paired	Bacteroidota	4587	P	3506155	49181	3555336	0.15129
SRR8291350_1_kneaddata_paired	Firmicutes	12188	P	875556	18716	894272	0.03805
SRR8291350_1_kneaddata_paired	Verrucomicrobiota	33333	P	131609	9727	141336	0.00601
SRR8291350_1_kneaddata_paired	Actinobacteriota	615	P	28263	18	28281	0.00120
SRR8291350_1_kneaddata_paired	Cyanobacteria	9876	P	11864	97	11961	0.00051
SRR8291350_1_kneaddata_paired	Proteobacteria	22518	P	8259	187	8446	0.00036
SRR8291350_1_kneaddata_paired	Firmicutes_B	17289	P	2781	130	2911	0.00012
SRR8291350_1_kneaddata_paired	Spirochaetota	32587	P	2518	3	2521	0.00011
SRR8291350_1_kneaddata_paired	Desulfobacterota_A	11509	P	1948	312	2260	0.00010
SRR8291350_1_kneaddata_paired	Campylobacterota	8700	P	374	0	374	0.00002
SRR8291350_1_kneaddata_paired	Deferribacterota	10822	P	220	0	220	0.00001
SRR8291350_1_kneaddata_paired	Firmicutes_I	18140	P	184	0	184	0.00001
SRR8291350_1_kneaddata_paired	Firmicutes_C	17613	P	140	0	140	0.00001
SRR8291350_1_kneaddata_paired	Thermotogota	33086	P	135	0	135	0.00001
SRR8291350_1_kneaddata_paired	Elusimicrobiota	11888	P	25	0	25	0.00000
SRR8291351_1_kneaddata_paired	Firmicutes_A	14608	P	21146702	100830	21247532	0.83013
SRR8291351_1_kneaddata_paired	Bacteroidota	4587	P	3537358	29264	3566622	0.13935
SRR8291351_1_kneaddata_paired	Firmicutes	12188	P	571037	10250	581287	0.02271
SRR8291351_1_kneaddata_paired	Verrucomicrobiota	33333	P	126715	6476	133191	0.00520
SRR8291351_1_kneaddata_paired	Actinobacteriota	615	P	37804	11	37815	0.00148
SRR8291351_1_kneaddata_paired	Cyanobacteria	9876	P	11250	92	11342	0.00044
SRR8291351_1_kneaddata_paired	Proteobacteria	22518	P	9154	163	9317	0.00036
SRR8291351_1_kneaddata_paired	Firmicutes_B	17289	P	3469	112	3581	0.00014
SRR8291351_1_kneaddata_paired	Desulfobacterota_A	11509	P	1805	188	1993	0.00008
SRR8291351_1_kneaddata_paired	Spirochaetota	32587	P	1507	1	1508	0.00006
SRR8291351_1_kneaddata_paired	Campylobacterota	8700	P	464	0	464	0.00002
SRR8291351_1_kneaddata_paired	Deferribacterota	10822	P	322	0	322	0.00001
SRR8291351_1_kneaddata_paired	Firmicutes_I	18140	P	208	0	208	0.00001
SRR8291351_1_kneaddata_paired	Thermotogota	33086	P	145	0	145	0.00001
SRR8291351_1_kneaddata_paired	Firmicutes_C	17613	P	88	0	88	0.00000
SRR8291351_1_kneaddata_paired	Elusimicrobiota	11888	P	14	0	14	0.00000
SRR8291352_1_kneaddata_paired	Firmicutes_A	14608	P	19079832	82383	19162215	0.80048
SRR8291352_1_kneaddata_paired	Bacteroidota	4587	P	4030483	38271	4068754	0.16997
SRR8291352_1_kneaddata_paired	Firmicutes	12188	P	436412	7367	443779	0.01854
SRR8291352_1_kneaddata_paired	Verrucomicrobiota	33333	P	202191	9504	211695	0.00884
SRR8291352_1_kneaddata_paired	Actinobacteriota	615	P	22860	9	22869	0.00096
SRR8291352_1_kneaddata_paired	Proteobacteria	22518	P	15125	263	15388	0.00064
SRR8291352_1_kneaddata_paired	Cyanobacteria	9876	P	7165	59	7224	0.00030
SRR8291352_1_kneaddata_paired	Desulfobacterota_A	11509	P	2696	329	3025	0.00013
SRR8291352_1_kneaddata_paired	Firmicutes_B	17289	P	1445	43	1488	0.00006
SRR8291352_1_kneaddata_paired	Spirochaetota	32587	P	1146	0	1146	0.00005
SRR8291352_1_kneaddata_paired	Thermotogota	33086	P	257	0	257	0.00001
SRR8291352_1_kneaddata_paired	Campylobacterota	8700	P	251	0	251	0.00001
SRR8291352_1_kneaddata_paired	Firmicutes_I	18140	P	167	0	167	0.00001
SRR8291352_1_kneaddata_paired	Firmicutes_C	17613	P	120	0	120	0.00001
SRR8291352_1_kneaddata_paired	Deferribacterota	10822	P	104	0	104	0.00000
SRR8291352_1_kneaddata_paired	Elusimicrobiota	11888	P	8	0	8	0.00000
SRR8291368_1_kneaddata_paired	Firmicutes_A	14608	P	19850097	81582	19931679	0.90933
SRR8291368_1_kneaddata_paired	Bacteroidota	4587	P	1689680	22088	1711768	0.07809
SRR8291368_1_kneaddata_paired	Firmicutes	12188	P	206526	4995	211521	0.00965
SRR8291368_1_kneaddata_paired	Verrucomicrobiota	33333	P	30746	1701	32447	0.00148
SRR8291368_1_kneaddata_paired	Actinobacteriota	615	P	14132	8	14140	0.00065
SRR8291368_1_kneaddata_paired	Proteobacteria	22518	P	5017	95	5112	0.00023
SRR8291368_1_kneaddata_paired	Cyanobacteria	9876	P	4263	52	4315	0.00020
SRR8291368_1_kneaddata_paired	Firmicutes_B	17289	P	3456	126	3582	0.00016
SRR8291368_1_kneaddata_paired	Desulfobacterota_A	11509	P	2414	319	2733	0.00012
SRR8291368_1_kneaddata_paired	Spirochaetota	32587	P	809	1	810	0.00004
SRR8291368_1_kneaddata_paired	Campylobacterota	8700	P	274	0	274	0.00001
SRR8291368_1_kneaddata_paired	Firmicutes_C	17613	P	211	0	211	0.00001
SRR8291368_1_kneaddata_paired	Deferribacterota	10822	P	206	0	206	0.00001
SRR8291368_1_kneaddata_paired	Firmicutes_I	18140	P	156	0	156	0.00001
SRR8291368_1_kneaddata_paired	Thermotogota	33086	P	136	0	136	0.00001
SRR8291368_1_kneaddata_paired	Elusimicrobiota	11888	P	4	0	4	0.00000
SRR8443399_1_kneaddata_paired	Firmicutes_A	14608	P	8790030	25288	8815318	0.70394
SRR8443399_1_kneaddata_paired	Bacteroidota	4587	P	2815981	45376	2861357	0.22849
SRR8443399_1_kneaddata_paired	Firmicutes	12188	P	536073	4977	541050	0.04321
SRR8443399_1_kneaddata_paired	Firmicutes_B	17289	P	155396	4288	159684	0.01275
SRR8443399_1_kneaddata_paired	Verrucomicrobiota	33333	P	60904	2666	63570	0.00508
SRR8443399_1_kneaddata_paired	Proteobacteria	22518	P	57019	997	58016	0.00463
SRR8443399_1_kneaddata_paired	Actinobacteriota	615	P	18699	4	18703	0.00149
SRR8443399_1_kneaddata_paired	Cyanobacteria	9876	P	2877	64	2941	0.00023
SRR8443399_1_kneaddata_paired	Desulfobacterota_A	11509	P	852	66	918	0.00007
SRR8443399_1_kneaddata_paired	Campylobacterota	8700	P	462	0	462	0.00004
SRR8443399_1_kneaddata_paired	Spirochaetota	32587	P	322	0	322	0.00003
SRR8443399_1_kneaddata_paired	Firmicutes_I	18140	P	214	0	214	0.00002
SRR8443399_1_kneaddata_paired	Deferribacterota	10822	P	137	0	137	0.00001
SRR8443399_1_kneaddata_paired	Firmicutes_C	17613	P	71	0	71	0.00001
SRR8443399_1_kneaddata_paired	Thermotogota	33086	P	37	0	37	0.00000
SRR8443399_1_kneaddata_paired	Elusimicrobiota	11888	P	10	0	10	0.00000
SRR8443400_1_kneaddata_paired	Firmicutes_A	14608	P	9859086	35134	9894220	0.81241
SRR8443400_1_kneaddata_paired	Bacteroidota	4587	P	1457813	26725	1484538	0.12189
SRR8443400_1_kneaddata_paired	Firmicutes	12188	P	630332	7798	638130	0.05240
SRR8443400_1_kneaddata_paired	Firmicutes_B	17289	P	89899	2734	92633	0.00761
SRR8443400_1_kneaddata_paired	Proteobacteria	22518	P	33606	646	34252	0.00281
SRR8443400_1_kneaddata_paired	Actinobacteriota	615	P	20032	4	20036	0.00165
SRR8443400_1_kneaddata_paired	Verrucomicrobiota	33333	P	10413	498	10911	0.00090
SRR8443400_1_kneaddata_paired	Cyanobacteria	9876	P	1965	42	2007	0.00016
SRR8443400_1_kneaddata_paired	Desulfobacterota_A	11509	P	1135	109	1244	0.00010
SRR8443400_1_kneaddata_paired	Campylobacterota	8700	P	375	0	375	0.00003
SRR8443400_1_kneaddata_paired	Spirochaetota	32587	P	199	0	199	0.00002
SRR8443400_1_kneaddata_paired	Firmicutes_I	18140	P	178	0	178	0.00001
SRR8443400_1_kneaddata_paired	Deferribacterota	10822	P	70	0	70	0.00001
SRR8443400_1_kneaddata_paired	Thermotogota	33086	P	60	0	60	0.00000
SRR8443400_1_kneaddata_paired	Firmicutes_C	17613	P	53	0	53	0.00000
SRR8443400_1_kneaddata_paired	Elusimicrobiota	11888	P	2	0	2	0.00000
SRR8443401_1_kneaddata_paired	Firmicutes_A	14608	P	10468894	42184	10511078	0.90742
SRR8443401_1_kneaddata_paired	Bacteroidota	4587	P	624706	14944	639650	0.05522
SRR8443401_1_kneaddata_paired	Firmicutes	12188	P	366149	6868	373017	0.03220
SRR8443401_1_kneaddata_paired	Proteobacteria	22518	P	24745	617	25362	0.00219
SRR8443401_1_kneaddata_paired	Actinobacteriota	615	P	14563	3	14566	0.00126
SRR8443401_1_kneaddata_paired	Firmicutes_B	17289	P	10158	407	10565	0.00091
SRR8443401_1_kneaddata_paired	Verrucomicrobiota	33333	P	5580	349	5929	0.00051
SRR8443401_1_kneaddata_paired	Cyanobacteria	9876	P	1681	35	1716	0.00015
SRR8443401_1_kneaddata_paired	Desulfobacterota_A	11509	P	926	120	1046	0.00009
SRR8443401_1_kneaddata_paired	Spirochaetota	32587	P	183	0	183	0.00002
SRR8443401_1_kneaddata_paired	Firmicutes_I	18140	P	137	0	137	0.00001
SRR8443401_1_kneaddata_paired	Campylobacterota	8700	P	113	0	113	0.00001
SRR8443401_1_kneaddata_paired	Deferribacterota	10822	P	55	0	55	0.00000
SRR8443401_1_kneaddata_paired	Firmicutes_C	17613	P	50	0	50	0.00000
SRR8443401_1_kneaddata_paired	Thermotogota	33086	P	18	0	18	0.00000
SRR8443401_1_kneaddata_paired	Elusimicrobiota	11888	P	8	0	8	0.00000
SRR8443402_1_kneaddata_paired	Firmicutes_A	14608	P	9881687	41588	9923275	0.94485
SRR8443402_1_kneaddata_paired	Bacteroidota	4587	P	370179	6496	376675	0.03587
SRR8443402_1_kneaddata_paired	Firmicutes	12188	P	146150	3597	149747	0.01426
SRR8443402_1_kneaddata_paired	Firmicutes_B	17289	P	28639	1032	29671	0.00283
SRR8443402_1_kneaddata_paired	Actinobacteriota	615	P	9814	3	9817	0.00093
SRR8443402_1_kneaddata_paired	Proteobacteria	22518	P	6691	150	6841	0.00065
SRR8443402_1_kneaddata_paired	Verrucomicrobiota	33333	P	2792	156	2948	0.00028
SRR8443402_1_kneaddata_paired	Cyanobacteria	9876	P	1669	24	1693	0.00016
SRR8443402_1_kneaddata_paired	Desulfobacterota_A	11509	P	975	112	1087	0.00010
SRR8443402_1_kneaddata_paired	Spirochaetota	32587	P	246	0	246	0.00002
SRR8443402_1_kneaddata_paired	Campylobacterota	8700	P	171	0	171	0.00002
SRR8443402_1_kneaddata_paired	Firmicutes_I	18140	P	118	0	118	0.00001
SRR8443402_1_kneaddata_paired	Deferribacterota	10822	P	88	0	88	0.00001
SRR8443402_1_kneaddata_paired	Firmicutes_C	17613	P	51	0	51	0.00000
SRR8443402_1_kneaddata_paired	Thermotogota	33086	P	34	0	34	0.00000
SRR8443402_1_kneaddata_paired	Elusimicrobiota	11888	P	1	0	1	0.00000
SRR8443405_1_kneaddata_paired	Firmicutes_A	14608	P	11504571	33335	11537906	0.92953
SRR8443405_1_kneaddata_paired	Bacteroidota	4587	P	680376	9932	690308	0.05561
SRR8443405_1_kneaddata_paired	Firmicutes	12188	P	137693	2259	139952	0.01127
SRR8443405_1_kneaddata_paired	Proteobacteria	22518	P	22534	317	22851	0.00184
SRR8443405_1_kneaddata_paired	Actinobacteriota	615	P	10656	2	10658	0.00086
SRR8443405_1_kneaddata_paired	Verrucomicrobiota	33333	P	6331	223	6554	0.00053
SRR8443405_1_kneaddata_paired	Cyanobacteria	9876	P	2200	24	2224	0.00018
SRR8443405_1_kneaddata_paired	Desulfobacterota_A	11509	P	907	64	971	0.00008
SRR8443405_1_kneaddata_paired	Firmicutes_B	17289	P	632	14	646	0.00005
SRR8443405_1_kneaddata_paired	Campylobacterota	8700	P	204	0	204	0.00002
SRR8443405_1_kneaddata_paired	Spirochaetota	32587	P	142	0	142	0.00001
SRR8443405_1_kneaddata_paired	Deferribacterota	10822	P	95	0	95	0.00001
SRR8443405_1_kneaddata_paired	Firmicutes_I	18140	P	80	0	80	0.00001
SRR8443405_1_kneaddata_paired	Firmicutes_C	17613	P	65	0	65	0.00001
SRR8443405_1_kneaddata_paired	Elusimicrobiota	11888	P	9	0	9	0.00000
SRR8443405_1_kneaddata_paired	Thermotogota	33086	P	9	0	9	0.00000
SRR8443406_1_kneaddata_paired	Firmicutes_A	14608	P	9816451	34658	9851109	0.86924
SRR8443406_1_kneaddata_paired	Firmicutes	12188	P	720512	9295	729807	0.06440
SRR8443406_1_kneaddata_paired	Bacteroidota	4587	P	669077	9708	678785	0.05989
SRR8443406_1_kneaddata_paired	Firmicutes_B	17289	P	36602	1226	37828	0.00334
SRR8443406_1_kneaddata_paired	Proteobacteria	22518	P	14344	302	14646	0.00129
SRR8443406_1_kneaddata_paired	Actinobacteriota	615	P	13206	3	13209	0.00117
SRR8443406_1_kneaddata_paired	Verrucomicrobiota	33333	P	3991	163	4154	0.00037
SRR8443406_1_kneaddata_paired	Cyanobacteria	9876	P	1740	31	1771	0.00016
SRR8443406_1_kneaddata_paired	Desulfobacterota_A	11509	P	928	108	1036	0.00009
SRR8443406_1_kneaddata_paired	Spirochaetota	32587	P	230	0	230	0.00002
SRR8443406_1_kneaddata_paired	Campylobacterota	8700	P	201	0	201	0.00002
SRR8443406_1_kneaddata_paired	Firmicutes_I	18140	P	118	0	118	0.00001
SRR8443406_1_kneaddata_paired	Deferribacterota	10822	P	77	0	77	0.00001
SRR8443406_1_kneaddata_paired	Thermotogota	33086	P	36	0	36	0.00000
SRR8443406_1_kneaddata_paired	Firmicutes_C	17613	P	30	0	30	0.00000
SRR8443406_1_kneaddata_paired	Elusimicrobiota	11888	P	4	0	4	0.00000
SRR8443407_1_kneaddata_paired	Firmicutes_A	14608	P	11071824	41541	11113365	0.87414
SRR8443407_1_kneaddata_paired	Bacteroidota	4587	P	1389101	13524	1402625	0.11033
SRR8443407_1_kneaddata_paired	Firmicutes	12188	P	138315	1981	140296	0.01104
SRR8443407_1_kneaddata_paired	Proteobacteria	22518	P	28354	394	28748	0.00226
SRR8443407_1_kneaddata_paired	Verrucomicrobiota	33333	P	15736	555	16291	0.00128
SRR8443407_1_kneaddata_paired	Actinobacteriota	615	P	8130	1	8131	0.00064
SRR8443407_1_kneaddata_paired	Firmicutes_B	17289	P	1325	29	1354	0.00011
SRR8443407_1_kneaddata_paired	Cyanobacteria	9876	P	1212	17	1229	0.00010
SRR8443407_1_kneaddata_paired	Desulfobacterota_A	11509	P	788	46	834	0.00007
SRR8443407_1_kneaddata_paired	Spirochaetota	32587	P	176	0	176	0.00001
SRR8443407_1_kneaddata_paired	Campylobacterota	8700	P	131	0	131	0.00001
SRR8443407_1_kneaddata_paired	Firmicutes_C	17613	P	121	0	121	0.00001
SRR8443407_1_kneaddata_paired	Deferribacterota	10822	P	100	0	100	0.00001
SRR8443407_1_kneaddata_paired	Firmicutes_I	18140	P	97	0	97	0.00001
SRR8443407_1_kneaddata_paired	Thermotogota	33086	P	14	0	14	0.00000
SRR8443407_1_kneaddata_paired	Elusimicrobiota	11888	P	12	0	12	0.00000
SRR8443408_1_kneaddata_paired	Firmicutes_A	14608	P	9900974	37349	9938323	0.83001
SRR8443408_1_kneaddata_paired	Bacteroidota	4587	P	1515026	36623	1551649	0.12959
SRR8443408_1_kneaddata_paired	Firmicutes	12188	P	392056	6818	398874	0.03331
SRR8443408_1_kneaddata_paired	Firmicutes_B	17289	P	31272	1028	32300	0.00270
SRR8443408_1_kneaddata_paired	Proteobacteria	22518	P	25995	537	26532	0.00222
SRR8443408_1_kneaddata_paired	Actinobacteriota	615	P	17783	4	17787	0.00149
SRR8443408_1_kneaddata_paired	Verrucomicrobiota	33333	P	3664	188	3852	0.00032
SRR8443408_1_kneaddata_paired	Cyanobacteria	9876	P	2400	63	2463	0.00021
SRR8443408_1_kneaddata_paired	Desulfobacterota_A	11509	P	1068	117	1185	0.00010
SRR8443408_1_kneaddata_paired	Spirochaetota	32587	P	278	0	278	0.00002
SRR8443408_1_kneaddata_paired	Campylobacterota	8700	P	209	0	209	0.00002
SRR8443408_1_kneaddata_paired	Deferribacterota	10822	P	117	0	117	0.00001
SRR8443408_1_kneaddata_paired	Firmicutes_I	18140	P	89	0	89	0.00001
SRR8443408_1_kneaddata_paired	Firmicutes_C	17613	P	57	0	57	0.00000
SRR8443408_1_kneaddata_paired	Thermotogota	33086	P	46	0	46	0.00000
SRR8443408_1_kneaddata_paired	Elusimicrobiota	11888	P	7	0	7	0.00000
SRR8443409_1_kneaddata_paired	Firmicutes_A	14608	P	7469592	30365	7499957	0.94776
SRR8443409_1_kneaddata_paired	Bacteroidota	4587	P	205597	5197	210794	0.02664
SRR8443409_1_kneaddata_paired	Firmicutes	12188	P	174374	4213	178587	0.02257
SRR8443409_1_kneaddata_paired	Firmicutes_B	17289	P	9981	399	10380	0.00131
SRR8443409_1_kneaddata_paired	Actinobacteriota	615	P	6707	2	6709	0.00085
SRR8443409_1_kneaddata_paired	Proteobacteria	22518	P	3446	78	3524	0.00045
SRR8443409_1_kneaddata_paired	Verrucomicrobiota	33333	P	1127	49	1176	0.00015
SRR8443409_1_kneaddata_paired	Cyanobacteria	9876	P	915	15	930	0.00012
SRR8443409_1_kneaddata_paired	Desulfobacterota_A	11509	P	760	97	857	0.00011
SRR8443409_1_kneaddata_paired	Spirochaetota	32587	P	118	0	118	0.00001
SRR8443409_1_kneaddata_paired	Campylobacterota	8700	P	84	0	84	0.00001
SRR8443409_1_kneaddata_paired	Firmicutes_C	17613	P	69	0	69	0.00001
SRR8443409_1_kneaddata_paired	Firmicutes_I	18140	P	69	0	69	0.00001
SRR8443409_1_kneaddata_paired	Deferribacterota	10822	P	60	0	60	0.00001
SRR8443409_1_kneaddata_paired	Thermotogota	33086	P	6	0	6	0.00000
SRR8443409_1_kneaddata_paired	Elusimicrobiota	11888	P	4	0	4	0.00000
SRR8443410_1_kneaddata_paired	Firmicutes_A	14608	P	19950631	77970	20028601	0.93052
SRR8443410_1_kneaddata_paired	Bacteroidota	4587	P	1051297	13142	1064439	0.04945
SRR8443410_1_kneaddata_paired	Firmicutes	12188	P	364493	4880	369373	0.01716
SRR8443410_1_kneaddata_paired	Proteobacteria	22518	P	22185	364	22549	0.00105
SRR8443410_1_kneaddata_paired	Verrucomicrobiota	33333	P	18457	791	19248	0.00089
SRR8443410_1_kneaddata_paired	Actinobacteriota	615	P	11966	4	11970	0.00056
SRR8443410_1_kneaddata_paired	Cyanobacteria	9876	P	2723	42	2765	0.00013
SRR8443410_1_kneaddata_paired	Desulfobacterota_A	11509	P	1838	158	1996	0.00009
SRR8443410_1_kneaddata_paired	Firmicutes_B	17289	P	1596	43	1639	0.00008
SRR8443410_1_kneaddata_paired	Campylobacterota	8700	P	437	0	437	0.00002
SRR8443410_1_kneaddata_paired	Spirochaetota	32587	P	408	0	408	0.00002
SRR8443410_1_kneaddata_paired	Deferribacterota	10822	P	289	0	289	0.00001
SRR8443410_1_kneaddata_paired	Firmicutes_I	18140	P	196	0	196	0.00001
SRR8443410_1_kneaddata_paired	Firmicutes_C	17613	P	174	0	174	0.00001
SRR8443410_1_kneaddata_paired	Thermotogota	33086	P	55	0	55	0.00000
SRR8443410_1_kneaddata_paired	Elusimicrobiota	11888	P	41	0	41	0.00000
SRR8443415_1_kneaddata_paired	Firmicutes_A	14608	P	9612966	32570	9645536	0.80472
SRR8443415_1_kneaddata_paired	Bacteroidota	4587	P	1956936	27649	1984585	0.16557
SRR8443415_1_kneaddata_paired	Firmicutes	12188	P	295267	3381	298648	0.02492
SRR8443415_1_kneaddata_paired	Proteobacteria	22518	P	23649	374	24023	0.00200
SRR8443415_1_kneaddata_paired	Verrucomicrobiota	33333	P	18537	741	19278	0.00161
SRR8443415_1_kneaddata_paired	Actinobacteriota	615	P	8697	2	8699	0.00073
SRR8443415_1_kneaddata_paired	Cyanobacteria	9876	P	2496	42	2538	0.00021
SRR8443415_1_kneaddata_paired	Firmicutes_B	17289	P	915	23	938	0.00008
SRR8443415_1_kneaddata_paired	Desulfobacterota_A	11509	P	871	59	930	0.00008
SRR8443415_1_kneaddata_paired	Campylobacterota	8700	P	327	0	327	0.00003
SRR8443415_1_kneaddata_paired	Spirochaetota	32587	P	276	0	276	0.00002
SRR8443415_1_kneaddata_paired	Firmicutes_I	18140	P	173	0	173	0.00001
SRR8443415_1_kneaddata_paired	Deferribacterota	10822	P	154	0	154	0.00001
SRR8443415_1_kneaddata_paired	Firmicutes_C	17613	P	72	0	72	0.00001
SRR8443415_1_kneaddata_paired	Thermotogota	33086	P	17	0	17	0.00000
SRR8443415_1_kneaddata_paired	Elusimicrobiota	11888	P	9	0	9	0.00000
SRR8443416_1_kneaddata_paired	Firmicutes_A	14608	P	12245388	44835	12290223	0.83379
SRR8443416_1_kneaddata_paired	Bacteroidota	4587	P	1854072	32872	1886944	0.12801
SRR8443416_1_kneaddata_paired	Firmicutes	12188	P	421135	4953	426088	0.02891
SRR8443416_1_kneaddata_paired	Proteobacteria	22518	P	48956	992	49948	0.00339
SRR8443416_1_kneaddata_paired	Firmicutes_B	17289	P	40205	1295	41500	0.00282
SRR8443416_1_kneaddata_paired	Verrucomicrobiota	33333	P	22024	1124	23148	0.00157
SRR8443416_1_kneaddata_paired	Actinobacteriota	615	P	16606	7	16613	0.00113
SRR8443416_1_kneaddata_paired	Cyanobacteria	9876	P	2678	50	2728	0.00019
SRR8443416_1_kneaddata_paired	Desulfobacterota_A	11509	P	1476	146	1622	0.00011
SRR8443416_1_kneaddata_paired	Campylobacterota	8700	P	445	0	445	0.00003
SRR8443416_1_kneaddata_paired	Spirochaetota	32587	P	333	0	333	0.00002
SRR8443416_1_kneaddata_paired	Firmicutes_I	18140	P	205	0	205	0.00001
SRR8443416_1_kneaddata_paired	Deferribacterota	10822	P	151	0	151	0.00001
SRR8443416_1_kneaddata_paired	Firmicutes_C	17613	P	132	0	132	0.00001
SRR8443416_1_kneaddata_paired	Thermotogota	33086	P	44	0	44	0.00000
SRR8443416_1_kneaddata_paired	Elusimicrobiota	11888	P	12	0	12	0.00000
SRR8609100_1_kneaddata_paired	Firmicutes_A	14608	P	5339734	23398	5363132	0.49108
SRR8609100_1_kneaddata_paired	Bacteroidota	4587	P	4506019	20223	4526242	0.41445
SRR8609100_1_kneaddata_paired	Firmicutes	12188	P	574131	6786	580917	0.05319
SRR8609100_1_kneaddata_paired	Verrucomicrobiota	33333	P	372873	14733	387606	0.03549
SRR8609100_1_kneaddata_paired	Actinobacteriota	615	P	51502	8	51510	0.00472
SRR8609100_1_kneaddata_paired	Proteobacteria	22518	P	10094	154	10248	0.00094
SRR8609100_1_kneaddata_paired	Desulfobacterota_A	11509	P	484	44	528	0.00005
SRR8609100_1_kneaddata_paired	Cyanobacteria	9876	P	397	9	406	0.00004
SRR8609100_1_kneaddata_paired	Firmicutes_B	17289	P	186	4	190	0.00002
SRR8609100_1_kneaddata_paired	Spirochaetota	32587	P	124	0	124	0.00001
SRR8609100_1_kneaddata_paired	Firmicutes_I	18140	P	88	0	88	0.00001
SRR8609100_1_kneaddata_paired	Firmicutes_C	17613	P	36	0	36	0.00000
SRR8609100_1_kneaddata_paired	Campylobacterota	8700	P	29	0	29	0.00000
SRR8609100_1_kneaddata_paired	Deferribacterota	10822	P	13	0	13	0.00000
SRR8609100_1_kneaddata_paired	Elusimicrobiota	11888	P	5	0	5	0.00000
SRR8609100_1_kneaddata_paired	Thermotogota	33086	P	4	0	4	0.00000
SRR8609101_1_kneaddata_paired	Firmicutes_A	14608	P	8562770	52331	8615101	0.69666
SRR8609101_1_kneaddata_paired	Bacteroidota	4587	P	2654010	47300	2701310	0.21844
SRR8609101_1_kneaddata_paired	Firmicutes	12188	P	927596	14100	941696	0.07615
SRR8609101_1_kneaddata_paired	Actinobacteriota	615	P	72897	7	72904	0.00590
SRR8609101_1_kneaddata_paired	Proteobacteria	22518	P	31843	610	32453	0.00262
SRR8609101_1_kneaddata_paired	Verrucomicrobiota	33333	P	972	47	1019	0.00008
SRR8609101_1_kneaddata_paired	Cyanobacteria	9876	P	812	28	840	0.00007
SRR8609101_1_kneaddata_paired	Desulfobacterota_A	11509	P	416	52	468	0.00004
SRR8609101_1_kneaddata_paired	Firmicutes_B	17289	P	234	7	241	0.00002
SRR8609101_1_kneaddata_paired	Spirochaetota	32587	P	148	0	148	0.00001
SRR8609101_1_kneaddata_paired	Firmicutes_I	18140	P	45	0	45	0.00000
SRR8609101_1_kneaddata_paired	Campylobacterota	8700	P	36	0	36	0.00000
SRR8609101_1_kneaddata_paired	Deferribacterota	10822	P	29	0	29	0.00000
SRR8609101_1_kneaddata_paired	Firmicutes_C	17613	P	29	0	29	0.00000
SRR8609101_1_kneaddata_paired	Elusimicrobiota	11888	P	19	0	19	0.00000
SRR8609101_1_kneaddata_paired	Thermotogota	33086	P	12	0	12	0.00000
SRR8609102_1_kneaddata_paired	Firmicutes_A	14608	P	7321535	40095	7361630	0.74870
SRR8609102_1_kneaddata_paired	Bacteroidota	4587	P	1931697	24953	1956650	0.19900
SRR8609102_1_kneaddata_paired	Firmicutes	12188	P	446685	6227	452912	0.04606
SRR8609102_1_kneaddata_paired	Actinobacteriota	615	P	32184	4	32188	0.00327
SRR8609102_1_kneaddata_paired	Verrucomicrobiota	33333	P	17736	849	18585	0.00189
SRR8609102_1_kneaddata_paired	Proteobacteria	22518	P	8304	152	8456	0.00086
SRR8609102_1_kneaddata_paired	Cyanobacteria	9876	P	740	22	762	0.00008
SRR8609102_1_kneaddata_paired	Desulfobacterota_A	11509	P	475	50	525	0.00005
SRR8609102_1_kneaddata_paired	Firmicutes_B	17289	P	353	10	363	0.00004
SRR8609102_1_kneaddata_paired	Spirochaetota	32587	P	285	1	286	0.00003
SRR8609102_1_kneaddata_paired	Firmicutes_I	18140	P	85	0	85	0.00001
SRR8609102_1_kneaddata_paired	Campylobacterota	8700	P	73	0	73	0.00001
SRR8609102_1_kneaddata_paired	Firmicutes_C	17613	P	36	0	36	0.00000
SRR8609102_1_kneaddata_paired	Deferribacterota	10822	P	25	0	25	0.00000
SRR8609102_1_kneaddata_paired	Elusimicrobiota	11888	P	24	0	24	0.00000
SRR8609102_1_kneaddata_paired	Thermotogota	33086	P	7	0	7	0.00000
SRR8609103_1_kneaddata_paired	Firmicutes_A	14608	P	5674119	25791	5699910	0.53849
SRR8609103_1_kneaddata_paired	Bacteroidota	4587	P	4498741	75704	4574445	0.43216
SRR8609103_1_kneaddata_paired	Firmicutes	12188	P	236263	3537	239800	0.02265
SRR8609103_1_kneaddata_paired	Actinobacteriota	615	P	38301	7	38308	0.00362
SRR8609103_1_kneaddata_paired	Verrucomicrobiota	33333	P	20047	973	21020	0.00199
SRR8609103_1_kneaddata_paired	Proteobacteria	22518	P	8126	152	8278	0.00078
SRR8609103_1_kneaddata_paired	Cyanobacteria	9876	P	1272	56	1328	0.00013
SRR8609103_1_kneaddata_paired	Desulfobacterota_A	11509	P	811	95	906	0.00009
SRR8609103_1_kneaddata_paired	Firmicutes_B	17289	P	379	11	390	0.00004
SRR8609103_1_kneaddata_paired	Spirochaetota	32587	P	319	1	320	0.00003
SRR8609103_1_kneaddata_paired	Firmicutes_I	18140	P	122	0	122	0.00001
SRR8609103_1_kneaddata_paired	Campylobacterota	8700	P	82	0	82	0.00001
SRR8609103_1_kneaddata_paired	Deferribacterota	10822	P	81	0	81	0.00001
SRR8609103_1_kneaddata_paired	Firmicutes_C	17613	P	27	0	27	0.00000
SRR8609103_1_kneaddata_paired	Elusimicrobiota	11888	P	11	0	11	0.00000
SRR8609103_1_kneaddata_paired	Thermotogota	33086	P	8	0	8	0.00000
SRR8609104_1_kneaddata_paired	Firmicutes_A	14608	P	2670143	13573	2683716	0.56392
SRR8609104_1_kneaddata_paired	Bacteroidota	4587	P	1417934	11680	1429614	0.30040
SRR8609104_1_kneaddata_paired	Firmicutes	12188	P	612072	5887	617959	0.12985
SRR8609104_1_kneaddata_paired	Actinobacteriota	615	P	24204	12	24216	0.00509
SRR8609104_1_kneaddata_paired	Verrucomicrobiota	33333	P	961	43	1004	0.00021
SRR8609104_1_kneaddata_paired	Proteobacteria	22518	P	903	14	917	0.00019
SRR8609104_1_kneaddata_paired	Cyanobacteria	9876	P	785	29	814	0.00017
SRR8609104_1_kneaddata_paired	Desulfobacterota_A	11509	P	360	39	399	0.00008
SRR8609104_1_kneaddata_paired	Firmicutes_B	17289	P	169	4	173	0.00004
SRR8609104_1_kneaddata_paired	Deferribacterota	10822	P	57	0	57	0.00001
SRR8609104_1_kneaddata_paired	Campylobacterota	8700	P	55	0	55	0.00001
SRR8609104_1_kneaddata_paired	Spirochaetota	32587	P	55	0	55	0.00001
SRR8609104_1_kneaddata_paired	Firmicutes_I	18140	P	47	0	47	0.00001
SRR8609104_1_kneaddata_paired	Firmicutes_C	17613	P	12	0	12	0.00000
SRR8609104_1_kneaddata_paired	Elusimicrobiota	11888	P	5	0	5	0.00000
SRR8609104_1_kneaddata_paired	Thermotogota	33086	P	4	0	4	0.00000
SRR8609105_1_kneaddata_paired	Firmicutes_A	14608	P	5527419	26473	5553892	0.63238
SRR8609105_1_kneaddata_paired	Bacteroidota	4587	P	2739746	34492	2774238	0.31588
SRR8609105_1_kneaddata_paired	Verrucomicrobiota	33333	P	254364	9630	263994	0.03006
SRR8609105_1_kneaddata_paired	Firmicutes	12188	P	146033	2455	148488	0.01691
SRR8609105_1_kneaddata_paired	Actinobacteriota	615	P	34890	7	34897	0.00397
SRR8609105_1_kneaddata_paired	Proteobacteria	22518	P	4430	62	4492	0.00051
SRR8609105_1_kneaddata_paired	Cyanobacteria	9876	P	824	27	851	0.00010
SRR8609105_1_kneaddata_paired	Desulfobacterota_A	11509	P	749	67	816	0.00009
SRR8609105_1_kneaddata_paired	Firmicutes_B	17289	P	504	12	516	0.00006
SRR8609105_1_kneaddata_paired	Spirochaetota	32587	P	87	0	87	0.00001
SRR8609105_1_kneaddata_paired	Firmicutes_I	18140	P	81	0	81	0.00001
SRR8609105_1_kneaddata_paired	Campylobacterota	8700	P	59	0	59	0.00001
SRR8609105_1_kneaddata_paired	Firmicutes_C	17613	P	56	0	56	0.00001
SRR8609105_1_kneaddata_paired	Deferribacterota	10822	P	48	0	48	0.00001
SRR8609105_1_kneaddata_paired	Elusimicrobiota	11888	P	19	0	19	0.00000
SRR8609105_1_kneaddata_paired	Thermotogota	33086	P	7	0	7	0.00000
SRR8609106_1_kneaddata_paired	Firmicutes_A	14608	P	3624530	16026	3640556	0.54151
SRR8609106_1_kneaddata_paired	Bacteroidota	4587	P	2623995	22933	2646928	0.39371
SRR8609106_1_kneaddata_paired	Firmicutes	12188	P	333878	3511	337389	0.05018
SRR8609106_1_kneaddata_paired	Verrucomicrobiota	33333	P	57380	2647	60027	0.00893
SRR8609106_1_kneaddata_paired	Actinobacteriota	615	P	31308	18	31326	0.00466
SRR8609106_1_kneaddata_paired	Proteobacteria	22518	P	4241	33	4274	0.00064
SRR8609106_1_kneaddata_paired	Cyanobacteria	9876	P	1036	44	1080	0.00016
SRR8609106_1_kneaddata_paired	Desulfobacterota_A	11509	P	617	68	685	0.00010
SRR8609106_1_kneaddata_paired	Firmicutes_B	17289	P	342	10	352	0.00005
SRR8609106_1_kneaddata_paired	Spirochaetota	32587	P	113	0	113	0.00002
SRR8609106_1_kneaddata_paired	Firmicutes_I	18140	P	81	0	81	0.00001
SRR8609106_1_kneaddata_paired	Campylobacterota	8700	P	63	0	63	0.00001
SRR8609106_1_kneaddata_paired	Deferribacterota	10822	P	51	0	51	0.00001
SRR8609106_1_kneaddata_paired	Firmicutes_C	17613	P	23	0	23	0.00000
SRR8609106_1_kneaddata_paired	Thermotogota	33086	P	5	0	5	0.00000
SRR8609106_1_kneaddata_paired	Elusimicrobiota	11888	P	4	0	4	0.00000
SRR8609107_1_kneaddata_paired	Firmicutes_A	14608	P	8475062	35246	8510308	0.49565
SRR8609107_1_kneaddata_paired	Bacteroidota	4587	P	6136211	60176	6196387	0.36089
SRR8609107_1_kneaddata_paired	Firmicutes	12188	P	2172822	25317	2198139	0.12802
SRR8609107_1_kneaddata_paired	Verrucomicrobiota	33333	P	146910	7290	154200	0.00898
SRR8609107_1_kneaddata_paired	Actinobacteriota	615	P	97841	68	97909	0.00570
SRR8609107_1_kneaddata_paired	Proteobacteria	22518	P	7367	149	7516	0.00044
SRR8609107_1_kneaddata_paired	Cyanobacteria	9876	P	1968	54	2022	0.00012
SRR8609107_1_kneaddata_paired	Desulfobacterota_A	11509	P	1741	219	1960	0.00011
SRR8609107_1_kneaddata_paired	Firmicutes_B	17289	P	589	18	607	0.00004
SRR8609107_1_kneaddata_paired	Deferribacterota	10822	P	256	0	256	0.00001
SRR8609107_1_kneaddata_paired	Spirochaetota	32587	P	243	0	243	0.00001
SRR8609107_1_kneaddata_paired	Campylobacterota	8700	P	219	0	219	0.00001
SRR8609107_1_kneaddata_paired	Firmicutes_I	18140	P	126	0	126	0.00001
SRR8609107_1_kneaddata_paired	Firmicutes_C	17613	P	47	0	47	0.00000
SRR8609107_1_kneaddata_paired	Thermotogota	33086	P	9	0	9	0.00000
SRR8609107_1_kneaddata_paired	Elusimicrobiota	11888	P	5	0	5	0.00000
SRR8609108_1_kneaddata_paired	Firmicutes_A	14608	P	3094871	11405	3106276	0.46796
SRR8609108_1_kneaddata_paired	Bacteroidota	4587	P	2638268	13596	2651864	0.39951
SRR8609108_1_kneaddata_paired	Firmicutes	12188	P	522657	4241	526898	0.07938
SRR8609108_1_kneaddata_paired	Verrucomicrobiota	33333	P	296115	10542	306657	0.04620
SRR8609108_1_kneaddata_paired	Actinobacteriota	615	P	40130	19	40149	0.00605
SRR8609108_1_kneaddata_paired	Proteobacteria	22518	P	4214	56	4270	0.00064
SRR8609108_1_kneaddata_paired	Cyanobacteria	9876	P	706	21	727	0.00011
SRR8609108_1_kneaddata_paired	Desulfobacterota_A	11509	P	456	37	493	0.00007
SRR8609108_1_kneaddata_paired	Firmicutes_B	17289	P	254	5	259	0.00004
SRR8609108_1_kneaddata_paired	Firmicutes_I	18140	P	69	0	69	0.00001
SRR8609108_1_kneaddata_paired	Campylobacterota	8700	P	61	0	61	0.00001
SRR8609108_1_kneaddata_paired	Spirochaetota	32587	P	55	0	55	0.00001
SRR8609108_1_kneaddata_paired	Deferribacterota	10822	P	49	0	49	0.00001
SRR8609108_1_kneaddata_paired	Firmicutes_C	17613	P	27	0	27	0.00000
SRR8609108_1_kneaddata_paired	Elusimicrobiota	11888	P	7	0	7	0.00000
SRR8609108_1_kneaddata_paired	Thermotogota	33086	P	2	0	2	0.00000
SRR8909024_1_kneaddata_paired	Firmicutes_A	14608	P	2289068	6700	2295768	0.72120
SRR8909024_1_kneaddata_paired	Bacteroidota	4587	P	731378	2318	733696	0.23049
SRR8909024_1_kneaddata_paired	Cyanobacteria	9876	P	58022	394	58416	0.01835
SRR8909024_1_kneaddata_paired	Verrucomicrobiota	33333	P	32031	1019	33050	0.01038
SRR8909024_1_kneaddata_paired	Firmicutes	12188	P	23399	162	23561	0.00740
SRR8909024_1_kneaddata_paired	Desulfobacterota_A	11509	P	13041	59	13100	0.00412
SRR8909024_1_kneaddata_paired	Proteobacteria	22518	P	10716	10	10726	0.00337
SRR8909024_1_kneaddata_paired	Deferribacterota	10822	P	8156	16	8172	0.00257
SRR8909024_1_kneaddata_paired	Actinobacteriota	615	P	5703	11	5714	0.00180
SRR8909024_1_kneaddata_paired	Firmicutes_B	17289	P	514	10	524	0.00016
SRR8909024_1_kneaddata_paired	Spirochaetota	32587	P	266	0	266	0.00008
SRR8909024_1_kneaddata_paired	Campylobacterota	8700	P	157	0	157	0.00005
SRR8909024_1_kneaddata_paired	Firmicutes_I	18140	P	54	0	54	0.00002
SRR8909024_1_kneaddata_paired	Firmicutes_C	17613	P	26	0	26	0.00001
SRR8909024_1_kneaddata_paired	Thermotogota	33086	P	20	0	20	0.00001
SRR8909024_1_kneaddata_paired	Elusimicrobiota	11888	P	14	0	14	0.00000
SRR8909025_1_kneaddata_paired	Firmicutes_A	14608	P	1884194	5495	1889689	0.62436
SRR8909025_1_kneaddata_paired	Bacteroidota	4587	P	717101	1167	718268	0.23732
SRR8909025_1_kneaddata_paired	Cyanobacteria	9876	P	161999	282	162281	0.05362
SRR8909025_1_kneaddata_paired	Firmicutes	12188	P	100052	1395	101447	0.03352
SRR8909025_1_kneaddata_paired	Deferribacterota	10822	P	59636	99	59735	0.01974
SRR8909025_1_kneaddata_paired	Proteobacteria	22518	P	33310	31	33341	0.01102
SRR8909025_1_kneaddata_paired	Verrucomicrobiota	33333	P	33083	857	33940	0.01121
SRR8909025_1_kneaddata_paired	Desulfobacterota_A	11509	P	19627	48	19675	0.00650
SRR8909025_1_kneaddata_paired	Actinobacteriota	615	P	7194	6	7200	0.00238
SRR8909025_1_kneaddata_paired	Firmicutes_B	17289	P	395	6	401	0.00013
SRR8909025_1_kneaddata_paired	Spirochaetota	32587	P	336	0	336	0.00011
SRR8909025_1_kneaddata_paired	Campylobacterota	8700	P	172	0	172	0.00006
SRR8909025_1_kneaddata_paired	Firmicutes_I	18140	P	73	0	73	0.00002
SRR8909025_1_kneaddata_paired	Firmicutes_C	17613	P	43	0	43	0.00001
SRR8909025_1_kneaddata_paired	Thermotogota	33086	P	11	0	11	0.00000
SRR8909025_1_kneaddata_paired	Elusimicrobiota	11888	P	4	0	4	0.00000
SRR8909026_1_kneaddata_paired	Bacteroidota	4587	P	4248263	15761	4264024	0.85369
SRR8909026_1_kneaddata_paired	Firmicutes_A	14608	P	553458	3228	556686	0.11145
SRR8909026_1_kneaddata_paired	Cyanobacteria	9876	P	55812	819	56631	0.01134
SRR8909026_1_kneaddata_paired	Proteobacteria	22518	P	48994	87	49081	0.00983
SRR8909026_1_kneaddata_paired	Verrucomicrobiota	33333	P	31186	1327	32513	0.00651
SRR8909026_1_kneaddata_paired	Firmicutes	12188	P	28469	283	28752	0.00576
SRR8909026_1_kneaddata_paired	Desulfobacterota_A	11509	P	4093	34	4127	0.00083
SRR8909026_1_kneaddata_paired	Actinobacteriota	615	P	2302	4	2306	0.00046
SRR8909026_1_kneaddata_paired	Campylobacterota	8700	P	284	0	284	0.00006
SRR8909026_1_kneaddata_paired	Spirochaetota	32587	P	130	0	130	0.00003
SRR8909026_1_kneaddata_paired	Deferribacterota	10822	P	122	0	122	0.00002
SRR8909026_1_kneaddata_paired	Thermotogota	33086	P	104	0	104	0.00002
SRR8909026_1_kneaddata_paired	Firmicutes_I	18140	P	35	0	35	0.00001
SRR8909026_1_kneaddata_paired	Firmicutes_B	17289	P	26	0	26	0.00001
SRR8909026_1_kneaddata_paired	Elusimicrobiota	11888	P	8	0	8	0.00000
SRR8909026_1_kneaddata_paired	Firmicutes_C	17613	P	7	0	7	0.00000
SRR8909027_1_kneaddata_paired	Bacteroidota	4587	P	2782389	8714	2791103	0.49410
SRR8909027_1_kneaddata_paired	Firmicutes_A	14608	P	2453328	8394	2461722	0.43579
SRR8909027_1_kneaddata_paired	Cyanobacteria	9876	P	182908	1592	184500	0.03266
SRR8909027_1_kneaddata_paired	Firmicutes	12188	P	95748	1073	96821	0.01714
SRR8909027_1_kneaddata_paired	Proteobacteria	22518	P	49081	106	49187	0.00871
SRR8909027_1_kneaddata_paired	Verrucomicrobiota	33333	P	36636	1525	38161	0.00676
SRR8909027_1_kneaddata_paired	Desulfobacterota_A	11509	P	22435	76	22511	0.00399
SRR8909027_1_kneaddata_paired	Actinobacteriota	615	P	3489	7	3496	0.00062
SRR8909027_1_kneaddata_paired	Campylobacterota	8700	P	456	0	456	0.00008
SRR8909027_1_kneaddata_paired	Spirochaetota	32587	P	341	0	341	0.00006
SRR8909027_1_kneaddata_paired	Deferribacterota	10822	P	198	0	198	0.00004
SRR8909027_1_kneaddata_paired	Firmicutes_B	17289	P	165	4	169	0.00003
SRR8909027_1_kneaddata_paired	Firmicutes_I	18140	P	117	0	117	0.00002
SRR8909027_1_kneaddata_paired	Thermotogota	33086	P	69	0	69	0.00001
SRR8909027_1_kneaddata_paired	Firmicutes_C	17613	P	33	0	33	0.00001
SRR8909027_1_kneaddata_paired	Elusimicrobiota	11888	P	21	0	21	0.00000
SRR8909029_1_kneaddata_paired	Firmicutes_A	14608	P	2760264	8804	2769068	0.79154
SRR8909029_1_kneaddata_paired	Bacteroidota	4587	P	500994	1491	502485	0.14364
SRR8909029_1_kneaddata_paired	Cyanobacteria	9876	P	79396	590	79986	0.02286
SRR8909029_1_kneaddata_paired	Firmicutes	12188	P	55503	349	55852	0.01597
SRR8909029_1_kneaddata_paired	Deferribacterota	10822	P	51386	112	51498	0.01472
SRR8909029_1_kneaddata_paired	Proteobacteria	22518	P	14440	16	14456	0.00413
SRR8909029_1_kneaddata_paired	Desulfobacterota_A	11509	P	13720	62	13782	0.00394
SRR8909029_1_kneaddata_paired	Actinobacteriota	615	P	5345	9	5354	0.00153
SRR8909029_1_kneaddata_paired	Verrucomicrobiota	33333	P	4413	150	4563	0.00130
SRR8909029_1_kneaddata_paired	Firmicutes_B	17289	P	488	10	498	0.00014
SRR8909029_1_kneaddata_paired	Spirochaetota	32587	P	431	0	431	0.00012
SRR8909029_1_kneaddata_paired	Campylobacterota	8700	P	205	0	205	0.00006
SRR8909029_1_kneaddata_paired	Firmicutes_I	18140	P	99	0	99	0.00003
SRR8909029_1_kneaddata_paired	Firmicutes_C	17613	P	29	0	29	0.00001
SRR8909029_1_kneaddata_paired	Elusimicrobiota	11888	P	15	0	15	0.00000
SRR8909029_1_kneaddata_paired	Thermotogota	33086	P	5	0	5	0.00000
SRR8909036_1_kneaddata_paired	Bacteroidota	4587	P	2641136	7245	2648381	0.55855
SRR8909036_1_kneaddata_paired	Firmicutes_A	14608	P	1996527	6961	2003488	0.42254
SRR8909036_1_kneaddata_paired	Cyanobacteria	9876	P	37600	136	37736	0.00796
SRR8909036_1_kneaddata_paired	Firmicutes	12188	P	20546	626	21172	0.00447
SRR8909036_1_kneaddata_paired	Proteobacteria	22518	P	15318	18	15336	0.00323
SRR8909036_1_kneaddata_paired	Desulfobacterota_A	11509	P	6324	36	6360	0.00134
SRR8909036_1_kneaddata_paired	Verrucomicrobiota	33333	P	6201	241	6442	0.00136
SRR8909036_1_kneaddata_paired	Actinobacteriota	615	P	1600	3	1603	0.00034
SRR8909036_1_kneaddata_paired	Firmicutes_B	17289	P	490	12	502	0.00011
SRR8909036_1_kneaddata_paired	Campylobacterota	8700	P	161	0	161	0.00003
SRR8909036_1_kneaddata_paired	Spirochaetota	32587	P	88	0	88	0.00002
SRR8909036_1_kneaddata_paired	Deferribacterota	10822	P	83	0	83	0.00002
SRR8909036_1_kneaddata_paired	Thermotogota	33086	P	74	0	74	0.00002
SRR8909036_1_kneaddata_paired	Firmicutes_I	18140	P	55	0	55	0.00001
SRR8909036_1_kneaddata_paired	Firmicutes_C	17613	P	30	0	30	0.00001
SRR8909036_1_kneaddata_paired	Elusimicrobiota	11888	P	1	0	1	0.00000
SRR8909037_1_kneaddata_paired	Bacteroidota	4587	P	3691561	13210	3704771	0.59447
SRR8909037_1_kneaddata_paired	Firmicutes_A	14608	P	2368417	10171	2378588	0.38167
SRR8909037_1_kneaddata_paired	Cyanobacteria	9876	P	46839	316	47155	0.00757
SRR8909037_1_kneaddata_paired	Firmicutes	12188	P	44848	1088	45936	0.00737
SRR8909037_1_kneaddata_paired	Proteobacteria	22518	P	19755	20	19775	0.00317
SRR8909037_1_kneaddata_paired	Verrucomicrobiota	33333	P	16192	746	16938	0.00272
SRR8909037_1_kneaddata_paired	Desulfobacterota_A	11509	P	10186	55	10241	0.00164
SRR8909037_1_kneaddata_paired	Actinobacteriota	615	P	7723	11	7734	0.00124
SRR8909037_1_kneaddata_paired	Spirochaetota	32587	P	266	0	266	0.00004
SRR8909037_1_kneaddata_paired	Firmicutes_B	17289	P	227	6	233	0.00004
SRR8909037_1_kneaddata_paired	Campylobacterota	8700	P	167	0	167	0.00003
SRR8909037_1_kneaddata_paired	Deferribacterota	10822	P	125	0	125	0.00002
SRR8909037_1_kneaddata_paired	Firmicutes_I	18140	P	87	0	87	0.00001
SRR8909037_1_kneaddata_paired	Thermotogota	33086	P	39	0	39	0.00001
SRR8909037_1_kneaddata_paired	Firmicutes_C	17613	P	32	0	32	0.00001
SRR8909037_1_kneaddata_paired	Elusimicrobiota	11888	P	5	0	5	0.00000
SRR8909038_1_kneaddata_paired	Bacteroidota	4587	P	3006280	12759	3019039	0.78796
SRR8909038_1_kneaddata_paired	Firmicutes_A	14608	P	684649	3683	688332	0.17965
SRR8909038_1_kneaddata_paired	Cyanobacteria	9876	P	41135	549	41684	0.01088
SRR8909038_1_kneaddata_paired	Proteobacteria	22518	P	30097	57	30154	0.00787
SRR8909038_1_kneaddata_paired	Firmicutes	12188	P	23469	301	23770	0.00620
SRR8909038_1_kneaddata_paired	Verrucomicrobiota	33333	P	20410	965	21375	0.00558
SRR8909038_1_kneaddata_paired	Desulfobacterota_A	11509	P	3799	27	3826	0.00100
SRR8909038_1_kneaddata_paired	Actinobacteriota	615	P	2592	4	2596	0.00068
SRR8909038_1_kneaddata_paired	Spirochaetota	32587	P	222	0	222	0.00006
SRR8909038_1_kneaddata_paired	Campylobacterota	8700	P	206	0	206	0.00005
SRR8909038_1_kneaddata_paired	Deferribacterota	10822	P	92	0	92	0.00002
SRR8909038_1_kneaddata_paired	Firmicutes_B	17289	P	66	1	67	0.00002
SRR8909038_1_kneaddata_paired	Thermotogota	33086	P	56	0	56	0.00001
SRR8909038_1_kneaddata_paired	Firmicutes_I	18140	P	31	0	31	0.00001
SRR8909038_1_kneaddata_paired	Firmicutes_C	17613	P	11	0	11	0.00000
SRR8909038_1_kneaddata_paired	Elusimicrobiota	11888	P	5	0	5	0.00000
SRR8909040_1_kneaddata_paired	Firmicutes_A	14608	P	1896611	5496	1902107	0.63975
SRR8909040_1_kneaddata_paired	Bacteroidota	4587	P	752727	2769	755496	0.25410
SRR8909040_1_kneaddata_paired	Cyanobacteria	9876	P	196370	1811	198181	0.06666
SRR8909040_1_kneaddata_paired	Deferribacterota	10822	P	43694	94	43788	0.01473
SRR8909040_1_kneaddata_paired	Firmicutes	12188	P	27806	196	28002	0.00942
SRR8909040_1_kneaddata_paired	Verrucomicrobiota	33333	P	19371	649	20020	0.00673
SRR8909040_1_kneaddata_paired	Proteobacteria	22518	P	13471	19	13490	0.00454
SRR8909040_1_kneaddata_paired	Desulfobacterota_A	11509	P	8570	52	8622	0.00290
SRR8909040_1_kneaddata_paired	Actinobacteriota	615	P	2323	3	2326	0.00078
SRR8909040_1_kneaddata_paired	Spirochaetota	32587	P	490	0	490	0.00017
SRR8909040_1_kneaddata_paired	Campylobacterota	8700	P	284	0	284	0.00010
SRR8909040_1_kneaddata_paired	Firmicutes_B	17289	P	251	5	256	0.00009
SRR8909040_1_kneaddata_paired	Firmicutes_I	18140	P	91	0	91	0.00003
SRR8909040_1_kneaddata_paired	Elusimicrobiota	11888	P	29	0	29	0.00001
SRR8909040_1_kneaddata_paired	Firmicutes_C	17613	P	21	0	21	0.00001
SRR8909040_1_kneaddata_paired	Thermotogota	33086	P	19	0	19	0.00001
SRR8909046_1_kneaddata_paired	Firmicutes_A	14608	P	1883097	4593	1887690	0.71535
SRR8909046_1_kneaddata_paired	Bacteroidota	4587	P	361901	838	362739	0.13746
SRR8909046_1_kneaddata_paired	Cyanobacteria	9876	P	216227	2001	218228	0.08270
SRR8909046_1_kneaddata_paired	Firmicutes	12188	P	70273	352	70625	0.02676
SRR8909046_1_kneaddata_paired	Verrucomicrobiota	33333	P	37538	1120	38658	0.01465
SRR8909046_1_kneaddata_paired	Desulfobacterota_A	11509	P	21149	62	21211	0.00804
SRR8909046_1_kneaddata_paired	Proteobacteria	22518	P	18330	27	18357	0.00696
SRR8909046_1_kneaddata_paired	Deferribacterota	10822	P	17059	32	17091	0.00648
SRR8909046_1_kneaddata_paired	Actinobacteriota	615	P	2826	3	2829	0.00107
SRR8909046_1_kneaddata_paired	Spirochaetota	32587	P	596	0	596	0.00023
SRR8909046_1_kneaddata_paired	Campylobacterota	8700	P	385	0	385	0.00015
SRR8909046_1_kneaddata_paired	Firmicutes_B	17289	P	234	4	238	0.00009
SRR8909046_1_kneaddata_paired	Elusimicrobiota	11888	P	56	0	56	0.00002
SRR8909046_1_kneaddata_paired	Thermotogota	33086	P	52	0	52	0.00002
SRR8909046_1_kneaddata_paired	Firmicutes_I	18140	P	51	0	51	0.00002
SRR8909046_1_kneaddata_paired	Firmicutes_C	17613	P	22	0	22	0.00001
SRR8909052_1_kneaddata_paired	Firmicutes_A	14608	P	1907520	8429	1915949	0.61174
SRR8909052_1_kneaddata_paired	Bacteroidota	4587	P	993135	3433	996568	0.31819
SRR8909052_1_kneaddata_paired	Cyanobacteria	9876	P	180152	974	181126	0.05783
SRR8909052_1_kneaddata_paired	Firmicutes	12188	P	15019	695	15714	0.00502
SRR8909052_1_kneaddata_paired	Desulfobacterota_A	11509	P	10434	59	10493	0.00335
SRR8909052_1_kneaddata_paired	Proteobacteria	22518	P	8445	12	8457	0.00270
SRR8909052_1_kneaddata_paired	Verrucomicrobiota	33333	P	1598	73	1671	0.00053
SRR8909052_1_kneaddata_paired	Actinobacteriota	615	P	1527	4	1531	0.00049
SRR8909052_1_kneaddata_paired	Firmicutes_B	17289	P	172	5	177	0.00006
SRR8909052_1_kneaddata_paired	Spirochaetota	32587	P	122	0	122	0.00004
SRR8909052_1_kneaddata_paired	Campylobacterota	8700	P	62	0	62	0.00002
SRR8909052_1_kneaddata_paired	Deferribacterota	10822	P	53	0	53	0.00002
SRR8909052_1_kneaddata_paired	Firmicutes_C	17613	P	24	0	24	0.00001
SRR8909052_1_kneaddata_paired	Firmicutes_I	18140	P	22	0	22	0.00001
SRR8909052_1_kneaddata_paired	Elusimicrobiota	11888	P	9	0	9	0.00000
SRR8909053_1_kneaddata_paired	Firmicutes_A	14608	P	2519985	5138	2525123	0.75118
SRR8909053_1_kneaddata_paired	Bacteroidota	4587	P	645245	1550	646795	0.19241
SRR8909053_1_kneaddata_paired	Cyanobacteria	9876	P	132765	474	133239	0.03964
SRR8909053_1_kneaddata_paired	Proteobacteria	22518	P	24377	38	24415	0.00726
SRR8909053_1_kneaddata_paired	Firmicutes	12188	P	13881	122	14003	0.00417
SRR8909053_1_kneaddata_paired	Desulfobacterota_A	11509	P	11179	45	11224	0.00334
SRR8909053_1_kneaddata_paired	Verrucomicrobiota	33333	P	3141	96	3237	0.00096
SRR8909053_1_kneaddata_paired	Actinobacteriota	615	P	2875	7	2882	0.00086
SRR8909053_1_kneaddata_paired	Firmicutes_B	17289	P	264	5	269	0.00008
SRR8909053_1_kneaddata_paired	Spirochaetota	32587	P	107	0	107	0.00003
SRR8909053_1_kneaddata_paired	Campylobacterota	8700	P	71	0	71	0.00002
SRR8909053_1_kneaddata_paired	Deferribacterota	10822	P	59	0	59	0.00002
SRR8909053_1_kneaddata_paired	Firmicutes_I	18140	P	47	0	47	0.00001
SRR8909053_1_kneaddata_paired	Firmicutes_C	17613	P	32	0	32	0.00001
SRR8909053_1_kneaddata_paired	Elusimicrobiota	11888	P	11	0	11	0.00000
SRR8909053_1_kneaddata_paired	Thermotogota	33086	P	4	0	4	0.00000
SRR8909054_1_kneaddata_paired	Bacteroidota	4587	P	1400048	4235	1404283	0.52219
SRR8909054_1_kneaddata_paired	Firmicutes_A	14608	P	1131684	5229	1136913	0.42277
SRR8909054_1_kneaddata_paired	Cyanobacteria	9876	P	104133	596	104729	0.03894
SRR8909054_1_kneaddata_paired	Proteobacteria	22518	P	18051	15	18066	0.00672
SRR8909054_1_kneaddata_paired	Firmicutes	12188	P	16114	149	16263	0.00605
SRR8909054_1_kneaddata_paired	Desulfobacterota_A	11509	P	4746	27	4773	0.00177
SRR8909054_1_kneaddata_paired	Actinobacteriota	615	P	2116	6	2122	0.00079
SRR8909054_1_kneaddata_paired	Verrucomicrobiota	33333	P	1486	53	1539	0.00057
SRR8909054_1_kneaddata_paired	Firmicutes_B	17289	P	209	4	213	0.00008
SRR8909054_1_kneaddata_paired	Campylobacterota	8700	P	85	0	85	0.00003
SRR8909054_1_kneaddata_paired	Spirochaetota	32587	P	83	0	83	0.00003
SRR8909054_1_kneaddata_paired	Deferribacterota	10822	P	81	0	81	0.00003
SRR8909054_1_kneaddata_paired	Firmicutes_I	18140	P	41	0	41	0.00002
SRR8909054_1_kneaddata_paired	Firmicutes_C	17613	P	25	0	25	0.00001
SRR8909054_1_kneaddata_paired	Elusimicrobiota	11888	P	4	0	4	0.00000
SRR8909055_1_kneaddata_paired	Bacteroidota	4587	P	1698700	5977	1704677	0.50403
SRR8909055_1_kneaddata_paired	Firmicutes_A	14608	P	1412645	5791	1418436	0.41940
SRR8909055_1_kneaddata_paired	Cyanobacteria	9876	P	207756	583	208339	0.06160
SRR8909055_1_kneaddata_paired	Proteobacteria	22518	P	21347	37	21384	0.00632
SRR8909055_1_kneaddata_paired	Firmicutes	12188	P	20854	143	20997	0.00621
SRR8909055_1_kneaddata_paired	Actinobacteriota	615	P	3672	10	3682	0.00109
SRR8909055_1_kneaddata_paired	Desulfobacterota_A	11509	P	2173	27	2200	0.00065
SRR8909055_1_kneaddata_paired	Verrucomicrobiota	33333	P	1609	63	1672	0.00049
SRR8909055_1_kneaddata_paired	Firmicutes_B	17289	P	316	8	324	0.00010
SRR8909055_1_kneaddata_paired	Deferribacterota	10822	P	106	0	106	0.00003
SRR8909055_1_kneaddata_paired	Campylobacterota	8700	P	82	0	82	0.00002
SRR8909055_1_kneaddata_paired	Spirochaetota	32587	P	68	0	68	0.00002
SRR8909055_1_kneaddata_paired	Firmicutes_C	17613	P	49	0	49	0.00001
SRR8909055_1_kneaddata_paired	Firmicutes_I	18140	P	35	0	35	0.00001
SRR8909055_1_kneaddata_paired	Elusimicrobiota	11888	P	7	0	7	0.00000
SRR8909055_1_kneaddata_paired	Thermotogota	33086	P	3	0	3	0.00000
SRR8909058_1_kneaddata_paired	Firmicutes_A	14608	P	1973523	5108	1978631	0.64814
SRR8909058_1_kneaddata_paired	Bacteroidota	4587	P	972662	2746	975408	0.31952
SRR8909058_1_kneaddata_paired	Cyanobacteria	9876	P	53333	244	53577	0.01755
SRR8909058_1_kneaddata_paired	Firmicutes	12188	P	13111	365	13476	0.00441
SRR8909058_1_kneaddata_paired	Desulfobacterota_A	11509	P	11852	54	11906	0.00390
SRR8909058_1_kneaddata_paired	Proteobacteria	22518	P	11405	9	11414	0.00374
SRR8909058_1_kneaddata_paired	Actinobacteriota	615	P	4525	12	4537	0.00149
SRR8909058_1_kneaddata_paired	Verrucomicrobiota	33333	P	3295	124	3419	0.00112
SRR8909058_1_kneaddata_paired	Firmicutes_B	17289	P	139	3	142	0.00005
SRR8909058_1_kneaddata_paired	Spirochaetota	32587	P	106	0	106	0.00003
SRR8909058_1_kneaddata_paired	Deferribacterota	10822	P	40	0	40	0.00001
SRR8909058_1_kneaddata_paired	Campylobacterota	8700	P	38	0	38	0.00001
SRR8909058_1_kneaddata_paired	Firmicutes_I	18140	P	32	0	32	0.00001
SRR8909058_1_kneaddata_paired	Firmicutes_C	17613	P	24	0	24	0.00001
SRR8909058_1_kneaddata_paired	Elusimicrobiota	11888	P	7	0	7	0.00000
SRR8909058_1_kneaddata_paired	Thermotogota	33086	P	2	0	2	0.00000
SRR8909073_1_kneaddata_paired	Bacteroidota	4587	P	4131700	28590	4160290	0.84476
SRR8909073_1_kneaddata_paired	Firmicutes_A	14608	P	587094	5037	592131	0.12023
SRR8909073_1_kneaddata_paired	Firmicutes	12188	P	53834	632	54466	0.01106
SRR8909073_1_kneaddata_paired	Proteobacteria	22518	P	52803	67	52870	0.01074
SRR8909073_1_kneaddata_paired	Campylobacterota	8700	P	23626	1	23627	0.00480
SRR8909073_1_kneaddata_paired	Actinobacteriota	615	P	18900	32	18932	0.00384
SRR8909073_1_kneaddata_paired	Desulfobacterota_A	11509	P	9616	36	9652	0.00196
SRR8909073_1_kneaddata_paired	Cyanobacteria	9876	P	8252	214	8466	0.00172
SRR8909073_1_kneaddata_paired	Deferribacterota	10822	P	3943	14	3957	0.00080
SRR8909073_1_kneaddata_paired	Verrucomicrobiota	33333	P	177	4	181	0.00004
SRR8909073_1_kneaddata_paired	Firmicutes_B	17289	P	85	3	88	0.00002
SRR8909073_1_kneaddata_paired	Spirochaetota	32587	P	67	0	67	0.00001
SRR8909073_1_kneaddata_paired	Firmicutes_C	17613	P	58	0	58	0.00001
SRR8909073_1_kneaddata_paired	Firmicutes_I	18140	P	30	0	30	0.00001
SRR8909073_1_kneaddata_paired	Elusimicrobiota	11888	P	8	0	8	0.00000
SRR8909073_1_kneaddata_paired	Thermotogota	33086	P	1	0	1	0.00000
SRR8909078_1_kneaddata_paired	Bacteroidota	4587	P	4545221	16486	4561707	0.89546
SRR8909078_1_kneaddata_paired	Firmicutes_A	14608	P	343461	3480	346941	0.06810
SRR8909078_1_kneaddata_paired	Proteobacteria	22518	P	70712	110	70822	0.01390
SRR8909078_1_kneaddata_paired	Firmicutes	12188	P	52629	697	53326	0.01047
SRR8909078_1_kneaddata_paired	Campylobacterota	8700	P	25477	1	25478	0.00500
SRR8909078_1_kneaddata_paired	Cyanobacteria	9876	P	21425	238	21663	0.00425
SRR8909078_1_kneaddata_paired	Actinobacteriota	615	P	7725	10	7735	0.00152
SRR8909078_1_kneaddata_paired	Deferribacterota	10822	P	3840	12	3852	0.00076
SRR8909078_1_kneaddata_paired	Desulfobacterota_A	11509	P	2289	11	2300	0.00045
SRR8909078_1_kneaddata_paired	Verrucomicrobiota	33333	P	158	2	160	0.00003
SRR8909078_1_kneaddata_paired	Spirochaetota	32587	P	119	0	119	0.00002
SRR8909078_1_kneaddata_paired	Firmicutes_C	17613	P	69	0	69	0.00001
SRR8909078_1_kneaddata_paired	Firmicutes_B	17289	P	59	1	60	0.00001
SRR8909078_1_kneaddata_paired	Firmicutes_I	18140	P	29	0	29	0.00001
SRR8909078_1_kneaddata_paired	Elusimicrobiota	11888	P	3	0	3	0.00000
SRR8909080_1_kneaddata_paired	Bacteroidota	4587	P	4514096	17910	4532006	0.91767
SRR8909080_1_kneaddata_paired	Firmicutes_A	14608	P	250212	3330	253542	0.05134
SRR8909080_1_kneaddata_paired	Proteobacteria	22518	P	84102	125	84227	0.01705
SRR8909080_1_kneaddata_paired	Firmicutes	12188	P	46494	569	47063	0.00953
SRR8909080_1_kneaddata_paired	Cyanobacteria	9876	P	7594	101	7695	0.00156
SRR8909080_1_kneaddata_paired	Actinobacteriota	615	P	4197	5	4202	0.00085
SRR8909080_1_kneaddata_paired	Campylobacterota	8700	P	4176	0	4176	0.00085
SRR8909080_1_kneaddata_paired	Deferribacterota	10822	P	3809	13	3822	0.00077
SRR8909080_1_kneaddata_paired	Desulfobacterota_A	11509	P	869	6	875	0.00018
SRR8909080_1_kneaddata_paired	Verrucomicrobiota	33333	P	700	4	704	0.00014
SRR8909080_1_kneaddata_paired	Spirochaetota	32587	P	131	0	131	0.00003
SRR8909080_1_kneaddata_paired	Firmicutes_C	17613	P	61	0	61	0.00001
SRR8909080_1_kneaddata_paired	Firmicutes_B	17289	P	47	1	48	0.00001
SRR8909080_1_kneaddata_paired	Firmicutes_I	18140	P	25	0	25	0.00001
SRR8909080_1_kneaddata_paired	Thermotogota	33086	P	2	0	2	0.00000
SRR8909080_1_kneaddata_paired	Elusimicrobiota	11888	P	1	0	1	0.00000
SRR8909081_1_kneaddata_paired	Bacteroidota	4587	P	4696234	21863	4718097	0.92394
SRR8909081_1_kneaddata_paired	Firmicutes_A	14608	P	227283	4022	231305	0.04530
SRR8909081_1_kneaddata_paired	Proteobacteria	22518	P	86858	154	87012	0.01704
SRR8909081_1_kneaddata_paired	Firmicutes	12188	P	43238	749	43987	0.00861
SRR8909081_1_kneaddata_paired	Cyanobacteria	9876	P	8703	131	8834	0.00173
SRR8909081_1_kneaddata_paired	Actinobacteriota	615	P	6772	10	6782	0.00133
SRR8909081_1_kneaddata_paired	Campylobacterota	8700	P	6643	0	6643	0.00130
SRR8909081_1_kneaddata_paired	Deferribacterota	10822	P	2133	9	2142	0.00042
SRR8909081_1_kneaddata_paired	Desulfobacterota_A	11509	P	1126	8	1134	0.00022
SRR8909081_1_kneaddata_paired	Spirochaetota	32587	P	213	0	213	0.00004
SRR8909081_1_kneaddata_paired	Verrucomicrobiota	33333	P	155	2	157	0.00003
SRR8909081_1_kneaddata_paired	Firmicutes_C	17613	P	73	0	73	0.00001
SRR8909081_1_kneaddata_paired	Firmicutes_B	17289	P	63	2	65	0.00001
SRR8909081_1_kneaddata_paired	Firmicutes_I	18140	P	23	0	23	0.00000
SRR8909081_1_kneaddata_paired	Elusimicrobiota	11888	P	2	0	2	0.00000
SRR8909081_1_kneaddata_paired	Thermotogota	33086	P	2	0	2	0.00000
SRR8909083_1_kneaddata_paired	Bacteroidota	4587	P	2531170	11160	2542330	0.55104
SRR8909083_1_kneaddata_paired	Firmicutes_A	14608	P	1675072	8008	1683080	0.36480
SRR8909083_1_kneaddata_paired	Campylobacterota	8700	P	141749	8	141757	0.03073
SRR8909083_1_kneaddata_paired	Proteobacteria	22518	P	83190	103	83293	0.01805
SRR8909083_1_kneaddata_paired	Cyanobacteria	9876	P	46739	1391	48130	0.01043
SRR8909083_1_kneaddata_paired	Firmicutes	12188	P	38881	1026	39907	0.00865
SRR8909083_1_kneaddata_paired	Desulfobacterota_A	11509	P	29619	84	29703	0.00644
SRR8909083_1_kneaddata_paired	Deferribacterota	10822	P	22472	74	22546	0.00489
SRR8909083_1_kneaddata_paired	Firmicutes_I	18140	P	15989	7	15996	0.00347
SRR8909083_1_kneaddata_paired	Actinobacteriota	615	P	5840	30	5870	0.00127
SRR8909083_1_kneaddata_paired	Verrucomicrobiota	33333	P	384	11	395	0.00009
SRR8909083_1_kneaddata_paired	Firmicutes_B	17289	P	290	9	299	0.00006
SRR8909083_1_kneaddata_paired	Spirochaetota	32587	P	178	0	178	0.00004
SRR8909083_1_kneaddata_paired	Firmicutes_C	17613	P	129	0	129	0.00003
SRR8909083_1_kneaddata_paired	Elusimicrobiota	11888	P	31	0	31	0.00001
SRR8909083_1_kneaddata_paired	Thermotogota	33086	P	9	0	9	0.00000
SRR9047463_1_kneaddata_paired	Firmicutes_A	14608	P	3772516	9357	3781873	0.80992
SRR9047463_1_kneaddata_paired	Bacteroidota	4587	P	857814	1853	859667	0.18411
SRR9047463_1_kneaddata_paired	Firmicutes	12188	P	16620	789	17409	0.00373
SRR9047463_1_kneaddata_paired	Actinobacteriota	615	P	5030	18	5048	0.00108
SRR9047463_1_kneaddata_paired	Verrucomicrobiota	33333	P	2228	229	2457	0.00053
SRR9047463_1_kneaddata_paired	Proteobacteria	22518	P	990	30	1020	0.00022
SRR9047463_1_kneaddata_paired	Firmicutes_B	17289	P	734	51	785	0.00017
SRR9047463_1_kneaddata_paired	Cyanobacteria	9876	P	613	8	621	0.00013
SRR9047463_1_kneaddata_paired	Desulfobacterota_A	11509	P	254	78	332	0.00007
SRR9047463_1_kneaddata_paired	Spirochaetota	32587	P	92	0	92	0.00002
SRR9047463_1_kneaddata_paired	Firmicutes_I	18140	P	65	0	65	0.00001
SRR9047463_1_kneaddata_paired	Firmicutes_C	17613	P	13	0	13	0.00000
SRR9047463_1_kneaddata_paired	Deferribacterota	10822	P	11	0	11	0.00000
SRR9047463_1_kneaddata_paired	Campylobacterota	8700	P	10	0	10	0.00000
SRR9047463_1_kneaddata_paired	Thermotogota	33086	P	9	0	9	0.00000
SRR9047463_1_kneaddata_paired	Elusimicrobiota	11888	P	2	0	2	0.00000
SRR9047467_1_kneaddata_paired	Bacteroidota	4587	P	6715655	9383	6725038	0.78144
SRR9047467_1_kneaddata_paired	Firmicutes_A	14608	P	1837215	2898	1840113	0.21382
SRR9047467_1_kneaddata_paired	Firmicutes	12188	P	33710	2697	36407	0.00423
SRR9047467_1_kneaddata_paired	Actinobacteriota	615	P	3467	8	3475	0.00040
SRR9047467_1_kneaddata_paired	Proteobacteria	22518	P	216	1	217	0.00003
SRR9047467_1_kneaddata_paired	Cyanobacteria	9876	P	176	3	179	0.00002
SRR9047467_1_kneaddata_paired	Desulfobacterota_A	11509	P	167	36	203	0.00002
SRR9047467_1_kneaddata_paired	Firmicutes_I	18140	P	138	0	138	0.00002
SRR9047467_1_kneaddata_paired	Firmicutes_B	17289	P	80	3	83	0.00001
SRR9047467_1_kneaddata_paired	Campylobacterota	8700	P	36	0	36	0.00000
SRR9047467_1_kneaddata_paired	Spirochaetota	32587	P	36	0	36	0.00000
SRR9047467_1_kneaddata_paired	Verrucomicrobiota	33333	P	30	2	32	0.00000
SRR9047467_1_kneaddata_paired	Deferribacterota	10822	P	5	0	5	0.00000
SRR9047467_1_kneaddata_paired	Thermotogota	33086	P	5	0	5	0.00000
SRR9047467_1_kneaddata_paired	Elusimicrobiota	11888	P	1	0	1	0.00000
SRR9047469_1_kneaddata_paired	Firmicutes_A	14608	P	723274	1974	725248	0.73080
SRR9047469_1_kneaddata_paired	Bacteroidota	4587	P	222993	421	223414	0.22512
SRR9047469_1_kneaddata_paired	Firmicutes	12188	P	39932	852	40784	0.04110
SRR9047469_1_kneaddata_paired	Actinobacteriota	615	P	1467	6	1473	0.00148
SRR9047469_1_kneaddata_paired	Campylobacterota	8700	P	788	0	788	0.00079
SRR9047469_1_kneaddata_paired	Cyanobacteria	9876	P	286	18	304	0.00031
SRR9047469_1_kneaddata_paired	Proteobacteria	22518	P	144	1	145	0.00015
SRR9047469_1_kneaddata_paired	Spirochaetota	32587	P	61	0	61	0.00006
SRR9047469_1_kneaddata_paired	Firmicutes_B	17289	P	58	3	61	0.00006
SRR9047469_1_kneaddata_paired	Firmicutes_I	18140	P	45	0	45	0.00005
SRR9047469_1_kneaddata_paired	Desulfobacterota_A	11509	P	27	7	34	0.00003
SRR9047469_1_kneaddata_paired	Firmicutes_C	17613	P	17	0	17	0.00002
SRR9047469_1_kneaddata_paired	Deferribacterota	10822	P	15	0	15	0.00002
SRR9047469_1_kneaddata_paired	Verrucomicrobiota	33333	P	8	0	8	0.00001
SRR9047469_1_kneaddata_paired	Thermotogota	33086	P	5	0	5	0.00001
SRR9047471_1_kneaddata_paired	Bacteroidota	4587	P	553970	781	554751	0.66908
SRR9047471_1_kneaddata_paired	Firmicutes_A	14608	P	194203	348	194551	0.23465
SRR9047471_1_kneaddata_paired	Firmicutes	12188	P	73846	1210	75056	0.09053
SRR9047471_1_kneaddata_paired	Actinobacteriota	615	P	3459	5	3464	0.00418
SRR9047471_1_kneaddata_paired	Campylobacterota	8700	P	487	0	487	0.00059
SRR9047471_1_kneaddata_paired	Cyanobacteria	9876	P	480	22	502	0.00061
SRR9047471_1_kneaddata_paired	Firmicutes_I	18140	P	84	0	84	0.00010
SRR9047471_1_kneaddata_paired	Proteobacteria	22518	P	67	0	67	0.00008
SRR9047471_1_kneaddata_paired	Spirochaetota	32587	P	62	0	62	0.00008
SRR9047471_1_kneaddata_paired	Verrucomicrobiota	33333	P	53	3	56	0.00007
SRR9047471_1_kneaddata_paired	Desulfobacterota_A	11509	P	25	3	28	0.00003
SRR9047471_1_kneaddata_paired	Deferribacterota	10822	P	7	0	7	0.00001
SRR9047471_1_kneaddata_paired	Firmicutes_B	17289	P	5	0	5	0.00001
SRR9047472_1_kneaddata_paired	Bacteroidota	4587	P	2458342	3269	2461611	0.82888
SRR9047472_1_kneaddata_paired	Firmicutes_A	14608	P	489432	877	490309	0.16510
SRR9047472_1_kneaddata_paired	Firmicutes	12188	P	14283	1030	15313	0.00516
SRR9047472_1_kneaddata_paired	Actinobacteriota	615	P	1307	3	1310	0.00044
SRR9047472_1_kneaddata_paired	Proteobacteria	22518	P	394	3	397	0.00013
SRR9047472_1_kneaddata_paired	Verrucomicrobiota	33333	P	393	27	420	0.00014
SRR9047472_1_kneaddata_paired	Campylobacterota	8700	P	165	0	165	0.00006
SRR9047472_1_kneaddata_paired	Cyanobacteria	9876	P	99	2	101	0.00003
SRR9047472_1_kneaddata_paired	Firmicutes_I	18140	P	47	0	47	0.00002
SRR9047472_1_kneaddata_paired	Desulfobacterota_A	11509	P	39	8	47	0.00002
SRR9047472_1_kneaddata_paired	Firmicutes_B	17289	P	35	1	36	0.00001
SRR9047472_1_kneaddata_paired	Spirochaetota	32587	P	17	0	17	0.00001
SRR9047472_1_kneaddata_paired	Firmicutes_C	17613	P	9	0	9	0.00000
SRR9047472_1_kneaddata_paired	Thermotogota	33086	P	2	0	2	0.00000
SRR9047472_1_kneaddata_paired	Deferribacterota	10822	P	1	0	1	0.00000
SRR9157333_1_kneaddata_paired	Firmicutes_A	14608	P	2227604	12696	2240300	0.68868
SRR9157333_1_kneaddata_paired	Bacteroidota	4587	P	646001	2558	648559	0.19937
SRR9157333_1_kneaddata_paired	Desulfobacterota_A	11509	P	192603	2248	194851	0.05990
SRR9157333_1_kneaddata_paired	Campylobacterota	8700	P	96495	111	96606	0.02970
SRR9157333_1_kneaddata_paired	Firmicutes	12188	P	58099	626	58725	0.01805
SRR9157333_1_kneaddata_paired	Actinobacteriota	615	P	6169	19	6188	0.00190
SRR9157333_1_kneaddata_paired	Proteobacteria	22518	P	3139	6	3145	0.00097
SRR9157333_1_kneaddata_paired	Cyanobacteria	9876	P	3065	114	3179	0.00098
SRR9157333_1_kneaddata_paired	Verrucomicrobiota	33333	P	802	44	846	0.00026
SRR9157333_1_kneaddata_paired	Firmicutes_B	17289	P	299	10	309	0.00010
SRR9157333_1_kneaddata_paired	Spirochaetota	32587	P	139	0	139	0.00004
SRR9157333_1_kneaddata_paired	Firmicutes_C	17613	P	96	0	96	0.00003
SRR9157333_1_kneaddata_paired	Firmicutes_I	18140	P	52	0	52	0.00002
SRR9157333_1_kneaddata_paired	Deferribacterota	10822	P	20	0	20	0.00001
SRR9157333_1_kneaddata_paired	Elusimicrobiota	11888	P	7	0	7	0.00000
SRR9157333_1_kneaddata_paired	Thermotogota	33086	P	6	0	6	0.00000
SRR9157334_1_kneaddata_paired	Bacteroidota	4587	P	1448375	7249	1455624	0.52585
SRR9157334_1_kneaddata_paired	Firmicutes_A	14608	P	1050896	9575	1060471	0.38310
SRR9157334_1_kneaddata_paired	Desulfobacterota_A	11509	P	142905	1635	144540	0.05222
SRR9157334_1_kneaddata_paired	Firmicutes	12188	P	57339	1740	59079	0.02134
SRR9157334_1_kneaddata_paired	Proteobacteria	22518	P	18070	27	18097	0.00654
SRR9157334_1_kneaddata_paired	Actinobacteriota	615	P	11255	40	11295	0.00408
SRR9157334_1_kneaddata_paired	Campylobacterota	8700	P	10301	6	10307	0.00372
SRR9157334_1_kneaddata_paired	Cyanobacteria	9876	P	5959	311	6270	0.00227
SRR9157334_1_kneaddata_paired	Verrucomicrobiota	33333	P	2076	36	2112	0.00076
SRR9157334_1_kneaddata_paired	Spirochaetota	32587	P	162	0	162	0.00006
SRR9157334_1_kneaddata_paired	Firmicutes_B	17289	P	67	2	69	0.00003
SRR9157334_1_kneaddata_paired	Firmicutes_I	18140	P	56	0	56	0.00002
SRR9157334_1_kneaddata_paired	Deferribacterota	10822	P	37	0	37	0.00001
SRR9157334_1_kneaddata_paired	Firmicutes_C	17613	P	22	0	22	0.00001
SRR9157334_1_kneaddata_paired	Elusimicrobiota	11888	P	3	0	3	0.00000
SRR9157334_1_kneaddata_paired	Thermotogota	33086	P	1	0	1	0.00000
SRR9157335_1_kneaddata_paired	Bacteroidota	4587	P	1131408	8893	1140301	0.64033
SRR9157335_1_kneaddata_paired	Firmicutes_A	14608	P	410083	7604	417687	0.23455
SRR9157335_1_kneaddata_paired	Campylobacterota	8700	P	102810	377	103187	0.05794
SRR9157335_1_kneaddata_paired	Firmicutes	12188	P	85903	1893	87796	0.04930
SRR9157335_1_kneaddata_paired	Desulfobacterota_A	11509	P	12492	376	12868	0.00723
SRR9157335_1_kneaddata_paired	Actinobacteriota	615	P	7510	46	7556	0.00424
SRR9157335_1_kneaddata_paired	Proteobacteria	22518	P	5759	25	5784	0.00325
SRR9157335_1_kneaddata_paired	Cyanobacteria	9876	P	4778	606	5384	0.00302
SRR9157335_1_kneaddata_paired	Verrucomicrobiota	33333	P	103	14	117	0.00007
SRR9157335_1_kneaddata_paired	Spirochaetota	32587	P	43	0	43	0.00002
SRR9157335_1_kneaddata_paired	Firmicutes_B	17289	P	36	3	39	0.00002
SRR9157335_1_kneaddata_paired	Deferribacterota	10822	P	20	0	20	0.00001
SRR9157335_1_kneaddata_paired	Firmicutes_C	17613	P	12	0	12	0.00001
SRR9157335_1_kneaddata_paired	Firmicutes_I	18140	P	11	0	11	0.00001
SRR9157335_1_kneaddata_paired	Elusimicrobiota	11888	P	1	0	1	0.00000
SRR9157336_1_kneaddata_paired	Bacteroidota	4587	P	477070	2241	479311	0.58654
SRR9157336_1_kneaddata_paired	Firmicutes_A	14608	P	273785	2955	276740	0.33865
SRR9157336_1_kneaddata_paired	Desulfobacterota_A	11509	P	39037	630	39667	0.04854
SRR9157336_1_kneaddata_paired	Firmicutes	12188	P	10958	185	11143	0.01364
SRR9157336_1_kneaddata_paired	Campylobacterota	8700	P	3868	6	3874	0.00474
SRR9157336_1_kneaddata_paired	Cyanobacteria	9876	P	2519	187	2706	0.00331
SRR9157336_1_kneaddata_paired	Actinobacteriota	615	P	2327	9	2336	0.00286
SRR9157336_1_kneaddata_paired	Proteobacteria	22518	P	1213	3	1216	0.00149
SRR9157336_1_kneaddata_paired	Verrucomicrobiota	33333	P	101	8	109	0.00013
SRR9157336_1_kneaddata_paired	Spirochaetota	32587	P	37	0	37	0.00005
SRR9157336_1_kneaddata_paired	Deferribacterota	10822	P	9	0	9	0.00001
SRR9157336_1_kneaddata_paired	Firmicutes_B	17289	P	9	0	9	0.00001
SRR9157336_1_kneaddata_paired	Firmicutes_C	17613	P	9	0	9	0.00001
SRR9157336_1_kneaddata_paired	Firmicutes_I	18140	P	9	0	9	0.00001
SRR9157336_1_kneaddata_paired	Elusimicrobiota	11888	P	2	0	2	0.00000
SRR9157337_1_kneaddata_paired	Bacteroidota	4587	P	1663812	8682	1672494	0.46233
SRR9157337_1_kneaddata_paired	Firmicutes_A	14608	P	1633426	11667	1645093	0.45476
SRR9157337_1_kneaddata_paired	Desulfobacterota_A	11509	P	189463	2259	191722	0.05300
SRR9157337_1_kneaddata_paired	Firmicutes	12188	P	69007	724	69731	0.01928
SRR9157337_1_kneaddata_paired	Campylobacterota	8700	P	20317	30	20347	0.00562
SRR9157337_1_kneaddata_paired	Proteobacteria	22518	P	9100	19	9119	0.00252
SRR9157337_1_kneaddata_paired	Actinobacteriota	615	P	6535	25	6560	0.00181
SRR9157337_1_kneaddata_paired	Cyanobacteria	9876	P	1474	56	1530	0.00042
SRR9157337_1_kneaddata_paired	Verrucomicrobiota	33333	P	442	24	466	0.00013
SRR9157337_1_kneaddata_paired	Spirochaetota	32587	P	166	0	166	0.00005
SRR9157337_1_kneaddata_paired	Firmicutes_B	17289	P	104	3	107	0.00003
SRR9157337_1_kneaddata_paired	Firmicutes_C	17613	P	64	0	64	0.00002
SRR9157337_1_kneaddata_paired	Deferribacterota	10822	P	48	0	48	0.00001
SRR9157337_1_kneaddata_paired	Firmicutes_I	18140	P	35	0	35	0.00001
SRR9157337_1_kneaddata_paired	Elusimicrobiota	11888	P	5	0	5	0.00000
SRR9157337_1_kneaddata_paired	Thermotogota	33086	P	4	0	4	0.00000
SRR9157338_1_kneaddata_paired	Bacteroidota	4587	P	611977	4954	616931	0.70402
SRR9157338_1_kneaddata_paired	Firmicutes_A	14608	P	161237	2933	164170	0.18734
SRR9157338_1_kneaddata_paired	Campylobacterota	8700	P	28529	60	28589	0.03263
SRR9157338_1_kneaddata_paired	Desulfobacterota_A	11509	P	27227	507	27734	0.03165
SRR9157338_1_kneaddata_paired	Firmicutes	12188	P	19552	540	20092	0.02293
SRR9157338_1_kneaddata_paired	Proteobacteria	22518	P	10003	20	10023	0.01144
SRR9157338_1_kneaddata_paired	Actinobacteriota	615	P	7987	70	8057	0.00919
SRR9157338_1_kneaddata_paired	Cyanobacteria	9876	P	427	24	451	0.00051
SRR9157338_1_kneaddata_paired	Verrucomicrobiota	33333	P	137	5	142	0.00016
SRR9157338_1_kneaddata_paired	Deferribacterota	10822	P	47	0	47	0.00005
SRR9157338_1_kneaddata_paired	Spirochaetota	32587	P	42	0	42	0.00005
SRR9157338_1_kneaddata_paired	Firmicutes_I	18140	P	6	0	6	0.00001
SRR9157338_1_kneaddata_paired	Firmicutes_B	17289	P	5	0	5	0.00001
SRR9157338_1_kneaddata_paired	Firmicutes_C	17613	P	5	0	5	0.00001
SRR9157338_1_kneaddata_paired	Elusimicrobiota	11888	P	2	0	2	0.00000
SRR9157339_1_kneaddata_paired	Bacteroidota	4587	P	1247460	6963	1254423	0.59889
SRR9157339_1_kneaddata_paired	Firmicutes_A	14608	P	676113	7338	683451	0.32630
SRR9157339_1_kneaddata_paired	Desulfobacterota_A	11509	P	106947	1671	108618	0.05186
SRR9157339_1_kneaddata_paired	Firmicutes	12188	P	28719	1752	30471	0.01455
SRR9157339_1_kneaddata_paired	Proteobacteria	22518	P	8661	21	8682	0.00415
SRR9157339_1_kneaddata_paired	Actinobacteriota	615	P	4933	24	4957	0.00237
SRR9157339_1_kneaddata_paired	Campylobacterota	8700	P	2077	0	2077	0.00099
SRR9157339_1_kneaddata_paired	Cyanobacteria	9876	P	1305	70	1375	0.00066
SRR9157339_1_kneaddata_paired	Verrucomicrobiota	33333	P	243	15	258	0.00012
SRR9157339_1_kneaddata_paired	Spirochaetota	32587	P	122	0	122	0.00006
SRR9157339_1_kneaddata_paired	Deferribacterota	10822	P	51	0	51	0.00002
SRR9157339_1_kneaddata_paired	Firmicutes_B	17289	P	42	1	43	0.00002
SRR9157339_1_kneaddata_paired	Firmicutes_I	18140	P	20	0	20	0.00001
SRR9157339_1_kneaddata_paired	Firmicutes_C	17613	P	14	0	14	0.00001
SRR9157339_1_kneaddata_paired	Thermotogota	33086	P	6	0	6	0.00000
SRR9157339_1_kneaddata_paired	Elusimicrobiota	11888	P	2	0	2	0.00000
SRR9157340_1_kneaddata_paired	Firmicutes_A	14608	P	706788	8463	715251	0.53802
SRR9157340_1_kneaddata_paired	Bacteroidota	4587	P	517875	1895	519770	0.39098
SRR9157340_1_kneaddata_paired	Firmicutes	12188	P	44311	2007	46318	0.03484
SRR9157340_1_kneaddata_paired	Desulfobacterota_A	11509	P	35468	415	35883	0.02699
SRR9157340_1_kneaddata_paired	Actinobacteriota	615	P	5863	26	5889	0.00443
SRR9157340_1_kneaddata_paired	Cyanobacteria	9876	P	3163	196	3359	0.00253
SRR9157340_1_kneaddata_paired	Proteobacteria	22518	P	1205	7	1212	0.00091
SRR9157340_1_kneaddata_paired	Campylobacterota	8700	P	936	0	936	0.00070
SRR9157340_1_kneaddata_paired	Verrucomicrobiota	33333	P	404	20	424	0.00032
SRR9157340_1_kneaddata_paired	Spirochaetota	32587	P	284	1	285	0.00021
SRR9157340_1_kneaddata_paired	Firmicutes_B	17289	P	28	1	29	0.00002
SRR9157340_1_kneaddata_paired	Firmicutes_I	18140	P	20	0	20	0.00002
SRR9157340_1_kneaddata_paired	Deferribacterota	10822	P	15	0	15	0.00001
SRR9157340_1_kneaddata_paired	Firmicutes_C	17613	P	4	0	4	0.00000
SRR9157340_1_kneaddata_paired	Elusimicrobiota	11888	P	3	0	3	0.00000
SRR9157340_1_kneaddata_paired	Thermotogota	33086	P	2	0	2	0.00000
SRR9157345_1_kneaddata_paired	Bacteroidota	4587	P	813667	5877	819544	0.78096
SRR9157345_1_kneaddata_paired	Firmicutes_A	14608	P	131543	1681	133224	0.12695
SRR9157345_1_kneaddata_paired	Firmicutes	12188	P	54599	1110	55709	0.05309
SRR9157345_1_kneaddata_paired	Proteobacteria	22518	P	11939	21	11960	0.01140
SRR9157345_1_kneaddata_paired	Desulfobacterota_A	11509	P	11640	135	11775	0.01122
SRR9157345_1_kneaddata_paired	Actinobacteriota	615	P	11606	42	11648	0.01110
SRR9157345_1_kneaddata_paired	Campylobacterota	8700	P	3872	4	3876	0.00369
SRR9157345_1_kneaddata_paired	Cyanobacteria	9876	P	1328	90	1418	0.00135
SRR9157345_1_kneaddata_paired	Verrucomicrobiota	33333	P	173	4	177	0.00017
SRR9157345_1_kneaddata_paired	Spirochaetota	32587	P	28	0	28	0.00003
SRR9157345_1_kneaddata_paired	Deferribacterota	10822	P	17	0	17	0.00002
SRR9157345_1_kneaddata_paired	Firmicutes_B	17289	P	9	0	9	0.00001
SRR9157345_1_kneaddata_paired	Firmicutes_I	18140	P	8	0	8	0.00001
SRR9157345_1_kneaddata_paired	Elusimicrobiota	11888	P	5	0	5	0.00000
SRR9157345_1_kneaddata_paired	Firmicutes_C	17613	P	4	0	4	0.00000
SRR916930_kneaddata	Firmicutes_A	14608	P	11226694	73387	11300081	0.70059
SRR916930_kneaddata	Bacteroidota	4587	P	4388836	207118	4595954	0.28494
SRR916930_kneaddata	Firmicutes	12188	P	196295	5110	201405	0.01249
SRR916930_kneaddata	Proteobacteria	22518	P	22485	60	22545	0.00140
SRR916930_kneaddata	Cyanobacteria	9876	P	3495	126	3621	0.00022
SRR916930_kneaddata	Actinobacteriota	615	P	3244	5	3249	0.00020
SRR916930_kneaddata	Firmicutes_B	17289	P	909	51	960	0.00006
SRR916930_kneaddata	Desulfobacterota_A	11509	P	736	146	882	0.00005
SRR916930_kneaddata	Verrucomicrobiota	33333	P	270	21	291	0.00002
SRR916930_kneaddata	Spirochaetota	32587	P	130	0	130	0.00001
SRR916930_kneaddata	Campylobacterota	8700	P	118	0	118	0.00001
SRR916930_kneaddata	Firmicutes_I	18140	P	72	0	72	0.00000
SRR916930_kneaddata	Deferribacterota	10822	P	48	0	48	0.00000
SRR916930_kneaddata	Firmicutes_C	17613	P	45	0	45	0.00000
SRR916930_kneaddata	Thermotogota	33086	P	28	0	28	0.00000
SRR916930_kneaddata	Elusimicrobiota	11888	P	12	0	12	0.00000
SRR9205126_1_kneaddata_paired	Firmicutes_A	14608	P	17129548	74194	17203742	0.90012
SRR9205126_1_kneaddata_paired	Campylobacterota	8700	P	819215	23	819238	0.04286
SRR9205126_1_kneaddata_paired	Bacteroidota	4587	P	385579	1494	387073	0.02025
SRR9205126_1_kneaddata_paired	Firmicutes	12188	P	286475	6739	293214	0.01534
SRR9205126_1_kneaddata_paired	Desulfobacterota_A	11509	P	183704	2062	185766	0.00972
SRR9205126_1_kneaddata_paired	Proteobacteria	22518	P	93955	85	94040	0.00492
SRR9205126_1_kneaddata_paired	Actinobacteriota	615	P	77674	528	78202	0.00409
SRR9205126_1_kneaddata_paired	Deferribacterota	10822	P	33546	114	33660	0.00176
SRR9205126_1_kneaddata_paired	Cyanobacteria	9876	P	14759	570	15329	0.00080
SRR9205126_1_kneaddata_paired	Firmicutes_B	17289	P	849	28	877	0.00005
SRR9205126_1_kneaddata_paired	Verrucomicrobiota	33333	P	717	25	742	0.00004
SRR9205126_1_kneaddata_paired	Spirochaetota	32587	P	450	0	450	0.00002
SRR9205126_1_kneaddata_paired	Firmicutes_C	17613	P	144	0	144	0.00001
SRR9205126_1_kneaddata_paired	Firmicutes_I	18140	P	122	0	122	0.00001
SRR9205126_1_kneaddata_paired	Thermotogota	33086	P	58	0	58	0.00000
SRR9205126_1_kneaddata_paired	Elusimicrobiota	11888	P	5	0	5	0.00000
SRR9205127_1_kneaddata_paired	Firmicutes_A	14608	P	17254578	61608	17316186	0.90099
SRR9205127_1_kneaddata_paired	Bacteroidota	4587	P	965055	6161	971216	0.05053
SRR9205127_1_kneaddata_paired	Firmicutes	12188	P	436343	4586	440929	0.02294
SRR9205127_1_kneaddata_paired	Campylobacterota	8700	P	223479	63	223542	0.01163
SRR9205127_1_kneaddata_paired	Desulfobacterota_A	11509	P	149563	1168	150731	0.00784
SRR9205127_1_kneaddata_paired	Actinobacteriota	615	P	94830	243	95073	0.00495
SRR9205127_1_kneaddata_paired	Proteobacteria	22518	P	10749	15	10764	0.00056
SRR9205127_1_kneaddata_paired	Cyanobacteria	9876	P	5059	100	5159	0.00027
SRR9205127_1_kneaddata_paired	Firmicutes_B	17289	P	1620	39	1659	0.00009
SRR9205127_1_kneaddata_paired	Deferribacterota	10822	P	1555	3	1558	0.00008
SRR9205127_1_kneaddata_paired	Verrucomicrobiota	33333	P	1169	39	1208	0.00006
SRR9205127_1_kneaddata_paired	Spirochaetota	32587	P	378	0	378	0.00002
SRR9205127_1_kneaddata_paired	Firmicutes_I	18140	P	281	0	281	0.00001
SRR9205127_1_kneaddata_paired	Firmicutes_C	17613	P	222	0	222	0.00001
SRR9205127_1_kneaddata_paired	Elusimicrobiota	11888	P	28	0	28	0.00000
SRR9205127_1_kneaddata_paired	Thermotogota	33086	P	19	0	19	0.00000
SRR9205128_1_kneaddata_paired	Firmicutes_A	14608	P	15565308	56736	15622044	0.90958
SRR9205128_1_kneaddata_paired	Bacteroidota	4587	P	549358	3715	553073	0.03220
SRR9205128_1_kneaddata_paired	Firmicutes	12188	P	343563	4078	347641	0.02024
SRR9205128_1_kneaddata_paired	Proteobacteria	22518	P	249927	391	250318	0.01457
SRR9205128_1_kneaddata_paired	Campylobacterota	8700	P	247941	74	248015	0.01444
SRR9205128_1_kneaddata_paired	Actinobacteriota	615	P	75190	410	75600	0.00440
SRR9205128_1_kneaddata_paired	Desulfobacterota_A	11509	P	51097	760	51857	0.00302
SRR9205128_1_kneaddata_paired	Cyanobacteria	9876	P	13894	550	14444	0.00084
SRR9205128_1_kneaddata_paired	Deferribacterota	10822	P	9700	35	9735	0.00057
SRR9205128_1_kneaddata_paired	Verrucomicrobiota	33333	P	1219	61	1280	0.00007
SRR9205128_1_kneaddata_paired	Firmicutes_B	17289	P	496	17	513	0.00003
SRR9205128_1_kneaddata_paired	Spirochaetota	32587	P	306	0	306	0.00002
SRR9205128_1_kneaddata_paired	Firmicutes_C	17613	P	94	0	94	0.00001
SRR9205128_1_kneaddata_paired	Firmicutes_I	18140	P	90	0	90	0.00001
SRR9205128_1_kneaddata_paired	Thermotogota	33086	P	20	0	20	0.00000
SRR9205128_1_kneaddata_paired	Elusimicrobiota	11888	P	11	0	11	0.00000
SRR9205129_1_kneaddata_paired	Firmicutes_A	14608	P	17631589	57149	17688738	0.87667
SRR9205129_1_kneaddata_paired	Bacteroidota	4587	P	1193679	11386	1205065	0.05972
SRR9205129_1_kneaddata_paired	Campylobacterota	8700	P	374512	53	374565	0.01856
SRR9205129_1_kneaddata_paired	Firmicutes	12188	P	355290	3547	358837	0.01778
SRR9205129_1_kneaddata_paired	Proteobacteria	22518	P	202376	285	202661	0.01004
SRR9205129_1_kneaddata_paired	Desulfobacterota_A	11509	P	199436	1951	201387	0.00998
SRR9205129_1_kneaddata_paired	Deferribacterota	10822	P	73855	244	74099	0.00367
SRR9205129_1_kneaddata_paired	Actinobacteriota	615	P	58172	173	58345	0.00289
SRR9205129_1_kneaddata_paired	Cyanobacteria	9876	P	10255	53	10308	0.00051
SRR9205129_1_kneaddata_paired	Firmicutes_B	17289	P	1050	34	1084	0.00005
SRR9205129_1_kneaddata_paired	Verrucomicrobiota	33333	P	925	38	963	0.00005
SRR9205129_1_kneaddata_paired	Spirochaetota	32587	P	644	1	645	0.00003
SRR9205129_1_kneaddata_paired	Firmicutes_I	18140	P	231	0	231	0.00001
SRR9205129_1_kneaddata_paired	Firmicutes_C	17613	P	165	0	165	0.00001
SRR9205129_1_kneaddata_paired	Thermotogota	33086	P	35	0	35	0.00000
SRR9205129_1_kneaddata_paired	Elusimicrobiota	11888	P	23	0	23	0.00000
SRR9205130_1_kneaddata_paired	Firmicutes_A	14608	P	13291912	51819	13343731	0.89423
SRR9205130_1_kneaddata_paired	Firmicutes	12188	P	584860	7499	592359	0.03970
SRR9205130_1_kneaddata_paired	Bacteroidota	4587	P	552003	3802	555805	0.03725
SRR9205130_1_kneaddata_paired	Campylobacterota	8700	P	264704	43	264747	0.01774
SRR9205130_1_kneaddata_paired	Desulfobacterota_A	11509	P	98617	867	99484	0.00667
SRR9205130_1_kneaddata_paired	Actinobacteriota	615	P	47354	165	47519	0.00318
SRR9205130_1_kneaddata_paired	Proteobacteria	22518	P	6472	68	6540	0.00044
SRR9205130_1_kneaddata_paired	Deferribacterota	10822	P	6047	15	6062	0.00041
SRR9205130_1_kneaddata_paired	Cyanobacteria	9876	P	4048	77	4125	0.00028
SRR9205130_1_kneaddata_paired	Firmicutes_B	17289	P	525	13	538	0.00004
SRR9205130_1_kneaddata_paired	Verrucomicrobiota	33333	P	446	8	454	0.00003
SRR9205130_1_kneaddata_paired	Firmicutes_I	18140	P	277	0	277	0.00002
SRR9205130_1_kneaddata_paired	Spirochaetota	32587	P	228	0	228	0.00002
SRR9205130_1_kneaddata_paired	Firmicutes_C	17613	P	116	0	116	0.00001
SRR9205130_1_kneaddata_paired	Elusimicrobiota	11888	P	32	0	32	0.00000
SRR9205130_1_kneaddata_paired	Thermotogota	33086	P	32	0	32	0.00000
SRR9205131_1_kneaddata_paired	Firmicutes_A	14608	P	12482402	43813	12526215	0.92940
SRR9205131_1_kneaddata_paired	Firmicutes	12188	P	337067	2820	339887	0.02522
SRR9205131_1_kneaddata_paired	Campylobacterota	8700	P	316380	22	316402	0.02348
SRR9205131_1_kneaddata_paired	Bacteroidota	4587	P	184476	1324	185800	0.01379
SRR9205131_1_kneaddata_paired	Actinobacteriota	615	P	44392	178	44570	0.00331
SRR9205131_1_kneaddata_paired	Desulfobacterota_A	11509	P	37518	325	37843	0.00281
SRR9205131_1_kneaddata_paired	Deferribacterota	10822	P	18461	48	18509	0.00137
SRR9205131_1_kneaddata_paired	Cyanobacteria	9876	P	5265	190	5455	0.00040
SRR9205131_1_kneaddata_paired	Proteobacteria	22518	P	1653	17	1670	0.00012
SRR9205131_1_kneaddata_paired	Verrucomicrobiota	33333	P	577	20	597	0.00004
SRR9205131_1_kneaddata_paired	Firmicutes_B	17289	P	302	7	309	0.00002
SRR9205131_1_kneaddata_paired	Spirochaetota	32587	P	290	0	290	0.00002
SRR9205131_1_kneaddata_paired	Firmicutes_C	17613	P	84	0	84	0.00001
SRR9205131_1_kneaddata_paired	Firmicutes_I	18140	P	68	0	68	0.00001
SRR9205131_1_kneaddata_paired	Thermotogota	33086	P	60	0	60	0.00000
SRR9205131_1_kneaddata_paired	Elusimicrobiota	11888	P	10	0	10	0.00000
SRR9205132_1_kneaddata_paired	Firmicutes_A	14608	P	15864432	62037	15926469	0.87084
SRR9205132_1_kneaddata_paired	Bacteroidota	4587	P	1134334	11005	1145339	0.06263
SRR9205132_1_kneaddata_paired	Firmicutes	12188	P	551434	4851	556285	0.03042
SRR9205132_1_kneaddata_paired	Campylobacterota	8700	P	279793	23	279816	0.01530
SRR9205132_1_kneaddata_paired	Desulfobacterota_A	11509	P	223264	2315	225579	0.01233
SRR9205132_1_kneaddata_paired	Actinobacteriota	615	P	110529	412	110941	0.00607
SRR9205132_1_kneaddata_paired	Deferribacterota	10822	P	24084	84	24168	0.00132
SRR9205132_1_kneaddata_paired	Proteobacteria	22518	P	9921	43	9964	0.00054
SRR9205132_1_kneaddata_paired	Cyanobacteria	9876	P	6324	259	6583	0.00036
SRR9205132_1_kneaddata_paired	Firmicutes_B	17289	P	1462	50	1512	0.00008
SRR9205132_1_kneaddata_paired	Verrucomicrobiota	33333	P	908	31	939	0.00005
SRR9205132_1_kneaddata_paired	Spirochaetota	32587	P	598	0	598	0.00003
SRR9205132_1_kneaddata_paired	Firmicutes_I	18140	P	194	0	194	0.00001
SRR9205132_1_kneaddata_paired	Firmicutes_C	17613	P	146	0	146	0.00001
SRR9205132_1_kneaddata_paired	Thermotogota	33086	P	36	0	36	0.00000
SRR9205132_1_kneaddata_paired	Elusimicrobiota	11888	P	22	0	22	0.00000
SRR9205133_1_kneaddata_paired	Firmicutes_A	14608	P	19604734	88236	19692970	0.91825
SRR9205133_1_kneaddata_paired	Bacteroidota	4587	P	829674	4359	834033	0.03889
SRR9205133_1_kneaddata_paired	Firmicutes	12188	P	312649	3007	315656	0.01472
SRR9205133_1_kneaddata_paired	Campylobacterota	8700	P	297212	12	297224	0.01386
SRR9205133_1_kneaddata_paired	Desulfobacterota_A	11509	P	148014	1334	149348	0.00696
SRR9205133_1_kneaddata_paired	Actinobacteriota	615	P	93206	493	93699	0.00437
SRR9205133_1_kneaddata_paired	Deferribacterota	10822	P	46326	134	46460	0.00217
SRR9205133_1_kneaddata_paired	Cyanobacteria	9876	P	6692	167	6859	0.00032
SRR9205133_1_kneaddata_paired	Proteobacteria	22518	P	6400	131	6531	0.00030
SRR9205133_1_kneaddata_paired	Verrucomicrobiota	33333	P	1424	57	1481	0.00007
SRR9205133_1_kneaddata_paired	Firmicutes_B	17289	P	805	22	827	0.00004
SRR9205133_1_kneaddata_paired	Spirochaetota	32587	P	582	0	582	0.00003
SRR9205133_1_kneaddata_paired	Firmicutes_I	18140	P	199	0	199	0.00001
SRR9205133_1_kneaddata_paired	Firmicutes_C	17613	P	162	0	162	0.00001
SRR9205133_1_kneaddata_paired	Thermotogota	33086	P	28	0	28	0.00000
SRR9205133_1_kneaddata_paired	Elusimicrobiota	11888	P	24	0	24	0.00000
SRR9205134_1_kneaddata_paired	Firmicutes_A	14608	P	13930704	55087	13985791	0.87303
SRR9205134_1_kneaddata_paired	Bacteroidota	4587	P	907030	8939	915969	0.05718
SRR9205134_1_kneaddata_paired	Campylobacterota	8700	P	467583	36	467619	0.02919
SRR9205134_1_kneaddata_paired	Firmicutes	12188	P	389008	7356	396364	0.02474
SRR9205134_1_kneaddata_paired	Actinobacteriota	615	P	129515	287	129802	0.00810
SRR9205134_1_kneaddata_paired	Desulfobacterota_A	11509	P	95873	962	96835	0.00604
SRR9205134_1_kneaddata_paired	Proteobacteria	22518	P	10342	98	10440	0.00065
SRR9205134_1_kneaddata_paired	Cyanobacteria	9876	P	10189	402	10591	0.00066
SRR9205134_1_kneaddata_paired	Deferribacterota	10822	P	4471	12	4483	0.00028
SRR9205134_1_kneaddata_paired	Verrucomicrobiota	33333	P	727	23	750	0.00005
SRR9205134_1_kneaddata_paired	Firmicutes_B	17289	P	491	14	505	0.00003
SRR9205134_1_kneaddata_paired	Spirochaetota	32587	P	312	0	312	0.00002
SRR9205134_1_kneaddata_paired	Firmicutes_C	17613	P	169	0	169	0.00001
SRR9205134_1_kneaddata_paired	Firmicutes_I	18140	P	111	0	111	0.00001
SRR9205134_1_kneaddata_paired	Thermotogota	33086	P	16	0	16	0.00000
SRR9205134_1_kneaddata_paired	Elusimicrobiota	11888	P	15	0	15	0.00000
SRR9205135_1_kneaddata_paired	Firmicutes_A	14608	P	13709589	53555	13763144	0.89269
SRR9205135_1_kneaddata_paired	Bacteroidota	4587	P	572492	4210	576702	0.03741
SRR9205135_1_kneaddata_paired	Firmicutes	12188	P	438310	6038	444348	0.02882
SRR9205135_1_kneaddata_paired	Campylobacterota	8700	P	332674	81	332755	0.02158
SRR9205135_1_kneaddata_paired	Proteobacteria	22518	P	136404	229	136633	0.00886
SRR9205135_1_kneaddata_paired	Desulfobacterota_A	11509	P	82649	957	83606	0.00542
SRR9205135_1_kneaddata_paired	Actinobacteriota	615	P	59353	273	59626	0.00387
SRR9205135_1_kneaddata_paired	Deferribacterota	10822	P	9407	30	9437	0.00061
SRR9205135_1_kneaddata_paired	Cyanobacteria	9876	P	8961	282	9243	0.00060
SRR9205135_1_kneaddata_paired	Verrucomicrobiota	33333	P	904	38	942	0.00006
SRR9205135_1_kneaddata_paired	Firmicutes_B	17289	P	598	19	617	0.00004
SRR9205135_1_kneaddata_paired	Spirochaetota	32587	P	272	0	272	0.00002
SRR9205135_1_kneaddata_paired	Firmicutes_I	18140	P	183	0	183	0.00001
SRR9205135_1_kneaddata_paired	Firmicutes_C	17613	P	128	0	128	0.00001
SRR9205135_1_kneaddata_paired	Elusimicrobiota	11888	P	15	0	15	0.00000
SRR9205135_1_kneaddata_paired	Thermotogota	33086	P	11	0	11	0.00000
SRR9205136_1_kneaddata_paired	Firmicutes_A	14608	P	24804189	96504	24900693	0.96074
SRR9205136_1_kneaddata_paired	Bacteroidota	4587	P	600515	2116	602631	0.02325
SRR9205136_1_kneaddata_paired	Firmicutes	12188	P	290062	2220	292282	0.01128
SRR9205136_1_kneaddata_paired	Deferribacterota	10822	P	76796	211	77007	0.00297
SRR9205136_1_kneaddata_paired	Actinobacteriota	615	P	18138	73	18211	0.00070
SRR9205136_1_kneaddata_paired	Verrucomicrobiota	33333	P	11987	146	12133	0.00047
SRR9205136_1_kneaddata_paired	Desulfobacterota_A	11509	P	4513	453	4966	0.00019
SRR9205136_1_kneaddata_paired	Cyanobacteria	9876	P	3773	107	3880	0.00015
SRR9205136_1_kneaddata_paired	Proteobacteria	22518	P	2280	21	2301	0.00009
SRR9205136_1_kneaddata_paired	Firmicutes_B	17289	P	1875	50	1925	0.00007
SRR9205136_1_kneaddata_paired	Campylobacterota	8700	P	1121	0	1121	0.00004
SRR9205136_1_kneaddata_paired	Spirochaetota	32587	P	417	1	418	0.00002
SRR9205136_1_kneaddata_paired	Firmicutes_C	17613	P	351	0	351	0.00001
SRR9205136_1_kneaddata_paired	Firmicutes_I	18140	P	140	0	140	0.00001
SRR9205136_1_kneaddata_paired	Elusimicrobiota	11888	P	64	0	64	0.00000
SRR9205136_1_kneaddata_paired	Thermotogota	33086	P	45	0	45	0.00000
SRR9205137_1_kneaddata_paired	Firmicutes_A	14608	P	28932294	111024	29043318	0.95058
SRR9205137_1_kneaddata_paired	Bacteroidota	4587	P	800321	3530	803851	0.02631
SRR9205137_1_kneaddata_paired	Firmicutes	12188	P	443355	3469	446824	0.01462
SRR9205137_1_kneaddata_paired	Deferribacterota	10822	P	208477	695	209172	0.00685
SRR9205137_1_kneaddata_paired	Actinobacteriota	615	P	17408	84	17492	0.00057
SRR9205137_1_kneaddata_paired	Verrucomicrobiota	33333	P	12417	220	12637	0.00041
SRR9205137_1_kneaddata_paired	Desulfobacterota_A	11509	P	7523	943	8466	0.00028
SRR9205137_1_kneaddata_paired	Firmicutes_B	17289	P	3501	114	3615	0.00012
SRR9205137_1_kneaddata_paired	Proteobacteria	22518	P	3076	31	3107	0.00010
SRR9205137_1_kneaddata_paired	Cyanobacteria	9876	P	2823	66	2889	0.00009
SRR9205137_1_kneaddata_paired	Campylobacterota	8700	P	837	0	837	0.00003
SRR9205137_1_kneaddata_paired	Spirochaetota	32587	P	498	1	499	0.00002
SRR9205137_1_kneaddata_paired	Firmicutes_C	17613	P	445	0	445	0.00001
SRR9205137_1_kneaddata_paired	Firmicutes_I	18140	P	136	0	136	0.00000
SRR9205137_1_kneaddata_paired	Thermotogota	33086	P	46	0	46	0.00000
SRR9205137_1_kneaddata_paired	Elusimicrobiota	11888	P	22	0	22	0.00000
SRR9205138_1_kneaddata_paired	Firmicutes_A	14608	P	16553440	68860	16622300	0.90302
SRR9205138_1_kneaddata_paired	Bacteroidota	4587	P	1302224	6233	1308457	0.07108
SRR9205138_1_kneaddata_paired	Firmicutes	12188	P	284201	2264	286465	0.01556
SRR9205138_1_kneaddata_paired	Deferribacterota	10822	P	84892	295	85187	0.00463
SRR9205138_1_kneaddata_paired	Verrucomicrobiota	33333	P	80456	130	80586	0.00438
SRR9205138_1_kneaddata_paired	Actinobacteriota	615	P	10829	55	10884	0.00059
SRR9205138_1_kneaddata_paired	Firmicutes_B	17289	P	3624	124	3748	0.00020
SRR9205138_1_kneaddata_paired	Desulfobacterota_A	11509	P	3420	429	3849	0.00021
SRR9205138_1_kneaddata_paired	Cyanobacteria	9876	P	2100	41	2141	0.00012
SRR9205138_1_kneaddata_paired	Proteobacteria	22518	P	1879	15	1894	0.00010
SRR9205138_1_kneaddata_paired	Campylobacterota	8700	P	1038	0	1038	0.00006
SRR9205138_1_kneaddata_paired	Spirochaetota	32587	P	367	1	368	0.00002
SRR9205138_1_kneaddata_paired	Firmicutes_C	17613	P	250	0	250	0.00001
SRR9205138_1_kneaddata_paired	Firmicutes_I	18140	P	136	0	136	0.00001
SRR9205138_1_kneaddata_paired	Thermotogota	33086	P	39	0	39	0.00000
SRR9205138_1_kneaddata_paired	Elusimicrobiota	11888	P	15	0	15	0.00000
SRR9205139_1_kneaddata_paired	Firmicutes_A	14608	P	19916621	73225	19989846	0.89923
SRR9205139_1_kneaddata_paired	Bacteroidota	4587	P	1563941	6530	1570471	0.07065
SRR9205139_1_kneaddata_paired	Firmicutes	12188	P	400550	2445	402995	0.01813
SRR9205139_1_kneaddata_paired	Deferribacterota	10822	P	166532	515	167047	0.00751
SRR9205139_1_kneaddata_paired	Verrucomicrobiota	33333	P	70375	146	70521	0.00317
SRR9205139_1_kneaddata_paired	Actinobacteriota	615	P	14462	62	14524	0.00065
SRR9205139_1_kneaddata_paired	Desulfobacterota_A	11509	P	3804	384	4188	0.00019
SRR9205139_1_kneaddata_paired	Firmicutes_B	17289	P	3257	98	3355	0.00015
SRR9205139_1_kneaddata_paired	Cyanobacteria	9876	P	2568	51	2619	0.00012
SRR9205139_1_kneaddata_paired	Proteobacteria	22518	P	1959	14	1973	0.00009
SRR9205139_1_kneaddata_paired	Campylobacterota	8700	P	1379	0	1379	0.00006
SRR9205139_1_kneaddata_paired	Spirochaetota	32587	P	412	0	412	0.00002
SRR9205139_1_kneaddata_paired	Firmicutes_C	17613	P	299	0	299	0.00001
SRR9205139_1_kneaddata_paired	Firmicutes_I	18140	P	185	0	185	0.00001
SRR9205139_1_kneaddata_paired	Thermotogota	33086	P	37	0	37	0.00000
SRR9205139_1_kneaddata_paired	Elusimicrobiota	11888	P	14	0	14	0.00000
SRR9205146_1_kneaddata_paired	Firmicutes_A	14608	P	12310183	42113	12352296	0.85295
SRR9205146_1_kneaddata_paired	Bacteroidota	4587	P	1703502	6953	1710455	0.11811
SRR9205146_1_kneaddata_paired	Firmicutes	12188	P	209124	1377	210501	0.01454
SRR9205146_1_kneaddata_paired	Verrucomicrobiota	33333	P	152392	123	152515	0.01053
SRR9205146_1_kneaddata_paired	Deferribacterota	10822	P	29228	86	29314	0.00202
SRR9205146_1_kneaddata_paired	Actinobacteriota	615	P	14232	59	14291	0.00099
SRR9205146_1_kneaddata_paired	Desulfobacterota_A	11509	P	3681	413	4094	0.00028
SRR9205146_1_kneaddata_paired	Firmicutes_B	17289	P	3184	92	3276	0.00023
SRR9205146_1_kneaddata_paired	Cyanobacteria	9876	P	2232	67	2299	0.00016
SRR9205146_1_kneaddata_paired	Proteobacteria	22518	P	1295	5	1300	0.00009
SRR9205146_1_kneaddata_paired	Campylobacterota	8700	P	770	0	770	0.00005
SRR9205146_1_kneaddata_paired	Spirochaetota	32587	P	296	0	296	0.00002
SRR9205146_1_kneaddata_paired	Firmicutes_C	17613	P	270	0	270	0.00002
SRR9205146_1_kneaddata_paired	Firmicutes_I	18140	P	102	0	102	0.00001
SRR9205146_1_kneaddata_paired	Thermotogota	33086	P	23	0	23	0.00000
SRR9205146_1_kneaddata_paired	Elusimicrobiota	11888	P	7	0	7	0.00000
SRR9205147_1_kneaddata_paired	Firmicutes_A	14608	P	6386873	25576	6412449	0.90132
SRR9205147_1_kneaddata_paired	Bacteroidota	4587	P	465061	2526	467587	0.06572
SRR9205147_1_kneaddata_paired	Firmicutes	12188	P	155826	1228	157054	0.02208
SRR9205147_1_kneaddata_paired	Verrucomicrobiota	33333	P	41433	55	41488	0.00583
SRR9205147_1_kneaddata_paired	Deferribacterota	10822	P	23250	86	23336	0.00328
SRR9205147_1_kneaddata_paired	Actinobacteriota	615	P	6738	34	6772	0.00095
SRR9205147_1_kneaddata_paired	Desulfobacterota_A	11509	P	1864	242	2106	0.00030
SRR9205147_1_kneaddata_paired	Cyanobacteria	9876	P	1035	42	1077	0.00015
SRR9205147_1_kneaddata_paired	Firmicutes_B	17289	P	1030	37	1067	0.00015
SRR9205147_1_kneaddata_paired	Campylobacterota	8700	P	722	0	722	0.00010
SRR9205147_1_kneaddata_paired	Proteobacteria	22518	P	584	3	587	0.00008
SRR9205147_1_kneaddata_paired	Firmicutes_C	17613	P	109	0	109	0.00002
SRR9205147_1_kneaddata_paired	Spirochaetota	32587	P	97	0	97	0.00001
SRR9205147_1_kneaddata_paired	Firmicutes_I	18140	P	46	0	46	0.00001
SRR9205147_1_kneaddata_paired	Thermotogota	33086	P	7	0	7	0.00000
SRR9205147_1_kneaddata_paired	Elusimicrobiota	11888	P	5	0	5	0.00000
SRR9205148_1_kneaddata_paired	Firmicutes_A	14608	P	20924288	73002	20997290	0.92654
SRR9205148_1_kneaddata_paired	Bacteroidota	4587	P	1077422	3641	1081063	0.04770
SRR9205148_1_kneaddata_paired	Firmicutes	12188	P	441850	2623	444473	0.01961
SRR9205148_1_kneaddata_paired	Deferribacterota	10822	P	95013	237	95250	0.00420
SRR9205148_1_kneaddata_paired	Verrucomicrobiota	33333	P	15359	127	15486	0.00068
SRR9205148_1_kneaddata_paired	Actinobacteriota	615	P	12485	46	12531	0.00055
SRR9205148_1_kneaddata_paired	Desulfobacterota_A	11509	P	5336	481	5817	0.00026
SRR9205148_1_kneaddata_paired	Firmicutes_B	17289	P	3759	92	3851	0.00017
SRR9205148_1_kneaddata_paired	Cyanobacteria	9876	P	2284	23	2307	0.00010
SRR9205148_1_kneaddata_paired	Proteobacteria	22518	P	1707	8	1715	0.00008
SRR9205148_1_kneaddata_paired	Campylobacterota	8700	P	1219	0	1219	0.00005
SRR9205148_1_kneaddata_paired	Spirochaetota	32587	P	455	1	456	0.00002
SRR9205148_1_kneaddata_paired	Firmicutes_C	17613	P	366	0	366	0.00002
SRR9205148_1_kneaddata_paired	Firmicutes_I	18140	P	140	0	140	0.00001
SRR9205148_1_kneaddata_paired	Elusimicrobiota	11888	P	33	0	33	0.00000
SRR9205148_1_kneaddata_paired	Thermotogota	33086	P	33	0	33	0.00000
SRR9205149_1_kneaddata_paired	Firmicutes_A	14608	P	13718296	47806	13766102	0.88004
SRR9205149_1_kneaddata_paired	Bacteroidota	4587	P	1456373	5991	1462364	0.09349
SRR9205149_1_kneaddata_paired	Firmicutes	12188	P	133985	1291	135276	0.00865
SRR9205149_1_kneaddata_paired	Verrucomicrobiota	33333	P	131044	109	131153	0.00838
SRR9205149_1_kneaddata_paired	Deferribacterota	10822	P	122319	363	122682	0.00784
SRR9205149_1_kneaddata_paired	Actinobacteriota	615	P	13220	55	13275	0.00085
SRR9205149_1_kneaddata_paired	Firmicutes_B	17289	P	4318	125	4443	0.00028
SRR9205149_1_kneaddata_paired	Desulfobacterota_A	11509	P	2647	248	2895	0.00019
SRR9205149_1_kneaddata_paired	Cyanobacteria	9876	P	1705	48	1753	0.00011
SRR9205149_1_kneaddata_paired	Proteobacteria	22518	P	1115	5	1120	0.00007
SRR9205149_1_kneaddata_paired	Campylobacterota	8700	P	910	0	910	0.00006
SRR9205149_1_kneaddata_paired	Spirochaetota	32587	P	247	0	247	0.00002
SRR9205149_1_kneaddata_paired	Firmicutes_C	17613	P	217	0	217	0.00001
SRR9205149_1_kneaddata_paired	Firmicutes_I	18140	P	110	0	110	0.00001
SRR9205149_1_kneaddata_paired	Thermotogota	33086	P	18	0	18	0.00000
SRR9205149_1_kneaddata_paired	Elusimicrobiota	11888	P	13	0	13	0.00000
SRR9205150_1_kneaddata_paired	Firmicutes_A	14608	P	8164335	31827	8196162	0.89630
SRR9205150_1_kneaddata_paired	Bacteroidota	4587	P	778291	3876	782167	0.08553
SRR9205150_1_kneaddata_paired	Firmicutes	12188	P	86835	841	87676	0.00959
SRR9205150_1_kneaddata_paired	Verrucomicrobiota	33333	P	44494	60	44554	0.00487
SRR9205150_1_kneaddata_paired	Deferribacterota	10822	P	19566	70	19636	0.00215
SRR9205150_1_kneaddata_paired	Actinobacteriota	615	P	7561	37	7598	0.00083
SRR9205150_1_kneaddata_paired	Desulfobacterota_A	11509	P	2112	215	2327	0.00025
SRR9205150_1_kneaddata_paired	Campylobacterota	8700	P	994	0	994	0.00011
SRR9205150_1_kneaddata_paired	Proteobacteria	22518	P	982	5	987	0.00011
SRR9205150_1_kneaddata_paired	Cyanobacteria	9876	P	955	29	984	0.00011
SRR9205150_1_kneaddata_paired	Firmicutes_B	17289	P	949	33	982	0.00011
SRR9205150_1_kneaddata_paired	Firmicutes_C	17613	P	163	0	163	0.00002
SRR9205150_1_kneaddata_paired	Spirochaetota	32587	P	119	0	119	0.00001
SRR9205150_1_kneaddata_paired	Firmicutes_I	18140	P	82	0	82	0.00001
SRR9205150_1_kneaddata_paired	Thermotogota	33086	P	18	0	18	0.00000
SRR9205150_1_kneaddata_paired	Elusimicrobiota	11888	P	9	0	9	0.00000
SRR9205151_1_kneaddata_paired	Firmicutes_A	14608	P	19032065	72646	19104711	0.91453
SRR9205151_1_kneaddata_paired	Bacteroidota	4587	P	1224461	6047	1230508	0.05890
SRR9205151_1_kneaddata_paired	Firmicutes	12188	P	361370	2315	363685	0.01741
SRR9205151_1_kneaddata_paired	Verrucomicrobiota	33333	P	110496	167	110663	0.00530
SRR9205151_1_kneaddata_paired	Deferribacterota	10822	P	53427	179	53606	0.00257
SRR9205151_1_kneaddata_paired	Actinobacteriota	615	P	12558	59	12617	0.00060
SRR9205151_1_kneaddata_paired	Desulfobacterota_A	11509	P	4816	605	5421	0.00026
SRR9205151_1_kneaddata_paired	Firmicutes_B	17289	P	2874	94	2968	0.00014
SRR9205151_1_kneaddata_paired	Cyanobacteria	9876	P	2376	57	2433	0.00012
SRR9205151_1_kneaddata_paired	Proteobacteria	22518	P	1737	10	1747	0.00008
SRR9205151_1_kneaddata_paired	Campylobacterota	8700	P	1040	0	1040	0.00005
SRR9205151_1_kneaddata_paired	Firmicutes_C	17613	P	369	0	369	0.00002
SRR9205151_1_kneaddata_paired	Spirochaetota	32587	P	328	0	328	0.00002
SRR9205151_1_kneaddata_paired	Firmicutes_I	18140	P	122	0	122	0.00001
SRR9205151_1_kneaddata_paired	Thermotogota	33086	P	41	0	41	0.00000
SRR9205151_1_kneaddata_paired	Elusimicrobiota	11888	P	21	0	21	0.00000
SRR9205152_1_kneaddata_paired	Firmicutes_A	14608	P	24104387	102644	24207031	0.95526
SRR9205152_1_kneaddata_paired	Bacteroidota	4587	P	628631	2686	631317	0.02491
SRR9205152_1_kneaddata_paired	Deferribacterota	10822	P	249715	698	250413	0.00988
SRR9205152_1_kneaddata_paired	Firmicutes	12188	P	216967	2012	218979	0.00864
SRR9205152_1_kneaddata_paired	Actinobacteriota	615	P	8995	35	9030	0.00036
SRR9205152_1_kneaddata_paired	Verrucomicrobiota	33333	P	8057	179	8236	0.00033
SRR9205152_1_kneaddata_paired	Proteobacteria	22518	P	5064	35	5099	0.00020
SRR9205152_1_kneaddata_paired	Cyanobacteria	9876	P	3431	88	3519	0.00014
SRR9205152_1_kneaddata_paired	Desulfobacterota_A	11509	P	3340	323	3663	0.00014
SRR9205152_1_kneaddata_paired	Firmicutes_B	17289	P	1683	46	1729	0.00007
SRR9205152_1_kneaddata_paired	Campylobacterota	8700	P	841	0	841	0.00003
SRR9205152_1_kneaddata_paired	Spirochaetota	32587	P	436	0	436	0.00002
SRR9205152_1_kneaddata_paired	Firmicutes_C	17613	P	376	0	376	0.00001
SRR9205152_1_kneaddata_paired	Firmicutes_I	18140	P	146	0	146	0.00001
SRR9205152_1_kneaddata_paired	Elusimicrobiota	11888	P	60	0	60	0.00000
SRR9205152_1_kneaddata_paired	Thermotogota	33086	P	29	0	29	0.00000
SRR9205153_1_kneaddata_paired	Firmicutes_A	14608	P	494630	1713	496343	0.88311
SRR9205153_1_kneaddata_paired	Bacteroidota	4587	P	53028	216	53244	0.09473
SRR9205153_1_kneaddata_paired	Firmicutes	12188	P	6648	60	6708	0.01194
SRR9205153_1_kneaddata_paired	Verrucomicrobiota	33333	P	3376	4	3380	0.00601
SRR9205153_1_kneaddata_paired	Deferribacterota	10822	P	1357	3	1360	0.00242
SRR9205153_1_kneaddata_paired	Actinobacteriota	615	P	289	1	290	0.00052
SRR9205153_1_kneaddata_paired	Proteobacteria	22518	P	232	0	232	0.00041
SRR9205153_1_kneaddata_paired	Desulfobacterota_A	11509	P	165	14	179	0.00032
SRR9205153_1_kneaddata_paired	Firmicutes_B	17289	P	121	3	124	0.00022
SRR9205153_1_kneaddata_paired	Campylobacterota	8700	P	95	0	95	0.00017
SRR9205153_1_kneaddata_paired	Cyanobacteria	9876	P	64	1	65	0.00012
SRR9205153_1_kneaddata_paired	Spirochaetota	32587	P	7	0	7	0.00001
SRR9205153_1_kneaddata_paired	Firmicutes_C	17613	P	6	0	6	0.00001
SRR9205154_1_kneaddata_paired	Firmicutes_A	14608	P	14762107	367150	15129257	0.88962
SRR9205154_1_kneaddata_paired	Bacteroidota	4587	P	1447328	33991	1481319	0.08710
SRR9205154_1_kneaddata_paired	Firmicutes	12188	P	284739	8692	293431	0.01725
SRR9205154_1_kneaddata_paired	Deferribacterota	10822	P	51403	1026	52429	0.00308
SRR9205154_1_kneaddata_paired	Verrucomicrobiota	33333	P	38379	418	38797	0.00228
SRR9205154_1_kneaddata_paired	Actinobacteriota	615	P	3558	94	3652	0.00021
SRR9205154_1_kneaddata_paired	Firmicutes_B	17289	P	1670	325	1995	0.00012
SRR9205154_1_kneaddata_paired	Desulfobacterota_A	11509	P	1528	1104	2632	0.00015
SRR9205154_1_kneaddata_paired	Cyanobacteria	9876	P	1191	272	1463	0.00009
SRR9205154_1_kneaddata_paired	Proteobacteria	22518	P	588	25	613	0.00004
SRR9205154_1_kneaddata_paired	Campylobacterota	8700	P	423	0	423	0.00002
SRR9205154_1_kneaddata_paired	Spirochaetota	32587	P	243	5	248	0.00001
SRR9205154_1_kneaddata_paired	Firmicutes_C	17613	P	92	1	93	0.00001
SRR9205154_1_kneaddata_paired	Firmicutes_I	18140	P	23	0	23	0.00000
SRR9205154_1_kneaddata_paired	Thermotogota	33086	P	14	0	14	0.00000
SRR9205154_1_kneaddata_paired	Elusimicrobiota	11888	P	5	0	5	0.00000
SRR9205155_1_kneaddata_paired	Firmicutes_A	14608	P	14932896	45749	14978645	0.94136
SRR9205155_1_kneaddata_paired	Bacteroidota	4587	P	745646	2540	748186	0.04702
SRR9205155_1_kneaddata_paired	Firmicutes	12188	P	93402	983	94385	0.00593
SRR9205155_1_kneaddata_paired	Deferribacterota	10822	P	62640	161	62801	0.00395
SRR9205155_1_kneaddata_paired	Actinobacteriota	615	P	9829	37	9866	0.00062
SRR9205155_1_kneaddata_paired	Verrucomicrobiota	33333	P	6031	28	6059	0.00038
SRR9205155_1_kneaddata_paired	Desulfobacterota_A	11509	P	4122	403	4525	0.00028
SRR9205155_1_kneaddata_paired	Firmicutes_B	17289	P	2109	53	2162	0.00014
SRR9205155_1_kneaddata_paired	Proteobacteria	22518	P	1997	14	2011	0.00013
SRR9205155_1_kneaddata_paired	Cyanobacteria	9876	P	1614	32	1646	0.00010
SRR9205155_1_kneaddata_paired	Campylobacterota	8700	P	756	0	756	0.00005
SRR9205155_1_kneaddata_paired	Spirochaetota	32587	P	266	0	266	0.00002
SRR9205155_1_kneaddata_paired	Firmicutes_C	17613	P	256	0	256	0.00002
SRR9205155_1_kneaddata_paired	Firmicutes_I	18140	P	101	0	101	0.00001
SRR9205155_1_kneaddata_paired	Elusimicrobiota	11888	P	32	0	32	0.00000
SRR9205155_1_kneaddata_paired	Thermotogota	33086	P	23	0	23	0.00000
SRR9205157_1_kneaddata_paired	Firmicutes_A	14608	P	16670726	60905	16731631	0.81255
SRR9205157_1_kneaddata_paired	Bacteroidota	4587	P	2231513	21714	2253227	0.10943
SRR9205157_1_kneaddata_paired	Firmicutes	12188	P	752402	6016	758418	0.03683
SRR9205157_1_kneaddata_paired	Desulfobacterota_A	11509	P	405775	4135	409910	0.01991
SRR9205157_1_kneaddata_paired	Campylobacterota	8700	P	223416	10	223426	0.01085
SRR9205157_1_kneaddata_paired	Actinobacteriota	615	P	162860	567	163427	0.00794
SRR9205157_1_kneaddata_paired	Deferribacterota	10822	P	28931	102	29033	0.00141
SRR9205157_1_kneaddata_paired	Proteobacteria	22518	P	11654	47	11701	0.00057
SRR9205157_1_kneaddata_paired	Cyanobacteria	9876	P	5817	202	6019	0.00029
SRR9205157_1_kneaddata_paired	Firmicutes_B	17289	P	2359	82	2441	0.00012
SRR9205157_1_kneaddata_paired	Verrucomicrobiota	33333	P	936	24	960	0.00005
SRR9205157_1_kneaddata_paired	Spirochaetota	32587	P	912	1	913	0.00004
SRR9205157_1_kneaddata_paired	Firmicutes_I	18140	P	231	0	231	0.00001
SRR9205157_1_kneaddata_paired	Firmicutes_C	17613	P	127	0	127	0.00001
SRR9205157_1_kneaddata_paired	Elusimicrobiota	11888	P	34	0	34	0.00000
SRR9205157_1_kneaddata_paired	Thermotogota	33086	P	14	0	14	0.00000
SRR9205166_1_kneaddata_paired	Firmicutes_A	14608	P	32836342	122854	32959196	0.87301
SRR9205166_1_kneaddata_paired	Bacteroidota	4587	P	2835829	24172	2860001	0.07575
SRR9205166_1_kneaddata_paired	Campylobacterota	8700	P	731427	21	731448	0.01937
SRR9205166_1_kneaddata_paired	Desulfobacterota_A	11509	P	391350	2862	394212	0.01044
SRR9205166_1_kneaddata_paired	Firmicutes	12188	P	349634	4932	354566	0.00939
SRR9205166_1_kneaddata_paired	Cyanobacteria	9876	P	252910	2276	255186	0.00676
SRR9205166_1_kneaddata_paired	Actinobacteriota	615	P	113982	334	114316	0.00303
SRR9205166_1_kneaddata_paired	Deferribacterota	10822	P	70604	169	70773	0.00187
SRR9205166_1_kneaddata_paired	Proteobacteria	22518	P	6984	23	7007	0.00019
SRR9205166_1_kneaddata_paired	Verrucomicrobiota	33333	P	3055	83	3138	0.00008
SRR9205166_1_kneaddata_paired	Firmicutes_B	17289	P	1501	35	1536	0.00004
SRR9205166_1_kneaddata_paired	Spirochaetota	32587	P	1399	1	1400	0.00004
SRR9205166_1_kneaddata_paired	Firmicutes_C	17613	P	291	0	291	0.00001
SRR9205166_1_kneaddata_paired	Firmicutes_I	18140	P	278	0	278	0.00001
SRR9205166_1_kneaddata_paired	Thermotogota	33086	P	50	0	50	0.00000
SRR9205166_1_kneaddata_paired	Elusimicrobiota	11888	P	49	0	49	0.00000
SRR9205167_1_kneaddata_paired	Firmicutes_A	14608	P	16270526	63411	16333937	0.83240
SRR9205167_1_kneaddata_paired	Bacteroidota	4587	P	1768334	12188	1780522	0.09074
SRR9205167_1_kneaddata_paired	Campylobacterota	8700	P	617618	25	617643	0.03148
SRR9205167_1_kneaddata_paired	Firmicutes	12188	P	406368	7854	414222	0.02111
SRR9205167_1_kneaddata_paired	Actinobacteriota	615	P	189010	823	189833	0.00967
SRR9205167_1_kneaddata_paired	Desulfobacterota_A	11509	P	124088	944	125032	0.00637
SRR9205167_1_kneaddata_paired	Deferribacterota	10822	P	107912	285	108197	0.00551
SRR9205167_1_kneaddata_paired	Proteobacteria	22518	P	29695	66	29761	0.00152
SRR9205167_1_kneaddata_paired	Cyanobacteria	9876	P	20539	526	21065	0.00107
SRR9205167_1_kneaddata_paired	Verrucomicrobiota	33333	P	775	27	802	0.00004
SRR9205167_1_kneaddata_paired	Firmicutes_B	17289	P	739	19	758	0.00004
SRR9205167_1_kneaddata_paired	Spirochaetota	32587	P	523	0	523	0.00003
SRR9205167_1_kneaddata_paired	Firmicutes_C	17613	P	167	0	167	0.00001
SRR9205167_1_kneaddata_paired	Firmicutes_I	18140	P	160	0	160	0.00001
SRR9205167_1_kneaddata_paired	Thermotogota	33086	P	46	0	46	0.00000
SRR9205167_1_kneaddata_paired	Elusimicrobiota	11888	P	16	0	16	0.00000
SRR9205168_1_kneaddata_paired	Firmicutes_A	14608	P	16284787	61993	16346780	0.84221
SRR9205168_1_kneaddata_paired	Bacteroidota	4587	P	1294341	8576	1302917	0.06713
SRR9205168_1_kneaddata_paired	Firmicutes	12188	P	725309	5413	730722	0.03765
SRR9205168_1_kneaddata_paired	Campylobacterota	8700	P	695578	49	695627	0.03584
SRR9205168_1_kneaddata_paired	Desulfobacterota_A	11509	P	175010	1623	176633	0.00910
SRR9205168_1_kneaddata_paired	Actinobacteriota	615	P	108779	450	109229	0.00563
SRR9205168_1_kneaddata_paired	Deferribacterota	10822	P	24069	66	24135	0.00124
SRR9205168_1_kneaddata_paired	Proteobacteria	22518	P	11381	39	11420	0.00059
SRR9205168_1_kneaddata_paired	Cyanobacteria	9876	P	9170	245	9415	0.00049
SRR9205168_1_kneaddata_paired	Firmicutes_B	17289	P	909	24	933	0.00005
SRR9205168_1_kneaddata_paired	Verrucomicrobiota	33333	P	801	27	828	0.00004
SRR9205168_1_kneaddata_paired	Spirochaetota	32587	P	441	0	441	0.00002
SRR9205168_1_kneaddata_paired	Firmicutes_C	17613	P	186	0	186	0.00001
SRR9205168_1_kneaddata_paired	Firmicutes_I	18140	P	143	0	143	0.00001
SRR9205168_1_kneaddata_paired	Elusimicrobiota	11888	P	24	0	24	0.00000
SRR9205168_1_kneaddata_paired	Thermotogota	33086	P	16	0	16	0.00000
SRR9205169_1_kneaddata_paired	Firmicutes_A	14608	P	32593393	128697	32722090	0.96267
SRR9205169_1_kneaddata_paired	Firmicutes	12188	P	360245	6424	366669	0.01079
SRR9205169_1_kneaddata_paired	Campylobacterota	8700	P	338041	14	338055	0.00995
SRR9205169_1_kneaddata_paired	Bacteroidota	4587	P	277354	911	278265	0.00819
SRR9205169_1_kneaddata_paired	Desulfobacterota_A	11509	P	119903	972	120875	0.00356
SRR9205169_1_kneaddata_paired	Actinobacteriota	615	P	76826	243	77069	0.00227
SRR9205169_1_kneaddata_paired	Cyanobacteria	9876	P	55513	2113	57626	0.00170
SRR9205169_1_kneaddata_paired	Deferribacterota	10822	P	21109	44	21153	0.00062
SRR9205169_1_kneaddata_paired	Proteobacteria	22518	P	5887	46	5933	0.00017
SRR9205169_1_kneaddata_paired	Verrucomicrobiota	33333	P	1139	33	1172	0.00003
SRR9205169_1_kneaddata_paired	Firmicutes_B	17289	P	886	18	904	0.00003
SRR9205169_1_kneaddata_paired	Firmicutes_I	18140	P	430	0	430	0.00001
SRR9205169_1_kneaddata_paired	Spirochaetota	32587	P	406	0	406	0.00001
SRR9205169_1_kneaddata_paired	Firmicutes_C	17613	P	289	0	289	0.00001
SRR9205169_1_kneaddata_paired	Thermotogota	33086	P	43	0	43	0.00000
SRR9205169_1_kneaddata_paired	Elusimicrobiota	11888	P	10	0	10	0.00000
SRR959100_kneaddata	Firmicutes_A	14608	P	14103709	91439	14195148	0.75150
SRR959100_kneaddata	Bacteroidota	4587	P	3857290	28766	3886056	0.20573
SRR959100_kneaddata	Campylobacterota	8700	P	254669	56	254725	0.01349
SRR959100_kneaddata	Firmicutes	12188	P	223468	3498	226966	0.01202
SRR959100_kneaddata	Deferribacterota	10822	P	144384	13	144397	0.00764
SRR959100_kneaddata	Desulfobacterota_A	11509	P	121569	370	121939	0.00646
SRR959100_kneaddata	Cyanobacteria	9876	P	43266	343	43609	0.00231
SRR959100_kneaddata	Actinobacteriota	615	P	6617	22	6639	0.00035
SRR959100_kneaddata	Proteobacteria	22518	P	5330	61	5391	0.00029
SRR959100_kneaddata	Firmicutes_B	17289	P	1662	65	1727	0.00009
SRR959100_kneaddata	Verrucomicrobiota	33333	P	951	51	1002	0.00005
SRR959100_kneaddata	Spirochaetota	32587	P	798	0	798	0.00004
SRR959100_kneaddata	Thermotogota	33086	P	275	0	275	0.00001
SRR959100_kneaddata	Firmicutes_C	17613	P	181	0	181	0.00001
SRR959100_kneaddata	Firmicutes_I	18140	P	161	0	161	0.00001
SRR959100_kneaddata	Elusimicrobiota	11888	P	15	0	15	0.00000
SRR959124_kneaddata	Firmicutes_A	14608	P	17990373	102860	18093233	0.61752
SRR959124_kneaddata	Bacteroidota	4587	P	8404869	58216	8463085	0.28885
SRR959124_kneaddata	Thermotogota	33086	P	991585	927	992512	0.03387
SRR959124_kneaddata	Firmicutes	12188	P	759024	9556	768580	0.02623
SRR959124_kneaddata	Campylobacterota	8700	P	265347	55	265402	0.00906
SRR959124_kneaddata	Verrucomicrobiota	33333	P	204924	13465	218389	0.00745
SRR959124_kneaddata	Deferribacterota	10822	P	196890	20	196910	0.00672
SRR959124_kneaddata	Cyanobacteria	9876	P	169974	1897	171871	0.00587
SRR959124_kneaddata	Desulfobacterota_A	11509	P	91265	464	91729	0.00313
SRR959124_kneaddata	Proteobacteria	22518	P	25876	238	26114	0.00089
SRR959124_kneaddata	Actinobacteriota	615	P	6864	41	6905	0.00024
SRR959124_kneaddata	Firmicutes_B	17289	P	3457	148	3605	0.00012
SRR959124_kneaddata	Spirochaetota	32587	P	844	1	845	0.00003
SRR959124_kneaddata	Firmicutes_C	17613	P	261	0	261	0.00001
SRR959124_kneaddata	Firmicutes_I	18140	P	236	0	236	0.00001
SRR959124_kneaddata	Elusimicrobiota	11888	P	14	0	14	0.00000
SRR959127_kneaddata	Bacteroidota	4587	P	10527475	91205	10618680	0.46962
SRR959127_kneaddata	Firmicutes_A	14608	P	10249286	75387	10324673	0.45662
SRR959127_kneaddata	Firmicutes	12188	P	474518	8571	483089	0.02137
SRR959127_kneaddata	Thermotogota	33086	P	310330	353	310683	0.01374
SRR959127_kneaddata	Cyanobacteria	9876	P	298524	1916	300440	0.01329
SRR959127_kneaddata	Campylobacterota	8700	P	280330	69	280399	0.01240
SRR959127_kneaddata	Deferribacterota	10822	P	188039	26	188065	0.00832
SRR959127_kneaddata	Desulfobacterota_A	11509	P	43042	337	43379	0.00192
SRR959127_kneaddata	Verrucomicrobiota	33333	P	26528	2112	28640	0.00127
SRR959127_kneaddata	Proteobacteria	22518	P	24154	226	24380	0.00108
SRR959127_kneaddata	Actinobacteriota	615	P	5493	33	5526	0.00024
SRR959127_kneaddata	Firmicutes_B	17289	P	2143	112	2255	0.00010
SRR959127_kneaddata	Spirochaetota	32587	P	589	1	590	0.00003
SRR959127_kneaddata	Firmicutes_C	17613	P	178	0	178	0.00001
SRR959127_kneaddata	Firmicutes_I	18140	P	173	0	173	0.00001
SRR959127_kneaddata	Elusimicrobiota	11888	P	17	0	17	0.00000
SRR9677887_1_kneaddata_paired	Bacteroidota	4587	P	3958083	30652	3988735	0.72083
SRR9677887_1_kneaddata_paired	Firmicutes_A	14608	P	1408136	12539	1420675	0.25674
SRR9677887_1_kneaddata_paired	Desulfobacterota_A	11509	P	61760	114	61874	0.01118
SRR9677887_1_kneaddata_paired	Firmicutes	12188	P	30394	342	30736	0.00555
SRR9677887_1_kneaddata_paired	Proteobacteria	22518	P	25647	33	25680	0.00464
SRR9677887_1_kneaddata_paired	Actinobacteriota	615	P	4942	29	4971	0.00090
SRR9677887_1_kneaddata_paired	Cyanobacteria	9876	P	456	20	476	0.00009
SRR9677887_1_kneaddata_paired	Spirochaetota	32587	P	105	0	105	0.00002
SRR9677887_1_kneaddata_paired	Firmicutes_B	17289	P	102	4	106	0.00002
SRR9677887_1_kneaddata_paired	Campylobacterota	8700	P	80	0	80	0.00001
SRR9677887_1_kneaddata_paired	Verrucomicrobiota	33333	P	36	0	36	0.00001
SRR9677887_1_kneaddata_paired	Firmicutes_C	17613	P	25	0	25	0.00000
SRR9677887_1_kneaddata_paired	Deferribacterota	10822	P	20	0	20	0.00000
SRR9677887_1_kneaddata_paired	Elusimicrobiota	11888	P	6	0	6	0.00000
SRR9677887_1_kneaddata_paired	Firmicutes_I	18140	P	4	0	4	0.00000
SRR9677887_1_kneaddata_paired	Thermotogota	33086	P	1	0	1	0.00000
SRR9677888_1_kneaddata_paired	Firmicutes_A	14608	P	3066872	22112	3088984	0.50157
SRR9677888_1_kneaddata_paired	Bacteroidota	4587	P	2925855	20954	2946809	0.47848
SRR9677888_1_kneaddata_paired	Firmicutes	12188	P	79947	1626	81573	0.01325
SRR9677888_1_kneaddata_paired	Proteobacteria	22518	P	14995	20	15015	0.00244
SRR9677888_1_kneaddata_paired	Deferribacterota	10822	P	14964	52	15016	0.00244
SRR9677888_1_kneaddata_paired	Desulfobacterota_A	11509	P	6144	57	6201	0.00101
SRR9677888_1_kneaddata_paired	Actinobacteriota	615	P	2984	17	3001	0.00049
SRR9677888_1_kneaddata_paired	Cyanobacteria	9876	P	1671	22	1693	0.00028
SRR9677888_1_kneaddata_paired	Firmicutes_B	17289	P	158	5	163	0.00003
SRR9677888_1_kneaddata_paired	Verrucomicrobiota	33333	P	72	2	74	0.00001
SRR9677888_1_kneaddata_paired	Campylobacterota	8700	P	46	0	46	0.00001
SRR9677888_1_kneaddata_paired	Spirochaetota	32587	P	28	0	28	0.00000
SRR9677888_1_kneaddata_paired	Thermotogota	33086	P	22	0	22	0.00000
SRR9677888_1_kneaddata_paired	Firmicutes_C	17613	P	16	0	16	0.00000
SRR9677888_1_kneaddata_paired	Firmicutes_I	18140	P	16	0	16	0.00000
SRR9677888_1_kneaddata_paired	Elusimicrobiota	11888	P	10	0	10	0.00000
SRR9677889_1_kneaddata_paired	Firmicutes_A	14608	P	3153734	19288	3173022	0.56755
SRR9677889_1_kneaddata_paired	Bacteroidota	4587	P	2279048	15471	2294519	0.41041
SRR9677889_1_kneaddata_paired	Desulfobacterota_A	11509	P	64150	69	64219	0.01149
SRR9677889_1_kneaddata_paired	Firmicutes	12188	P	41525	449	41974	0.00751
SRR9677889_1_kneaddata_paired	Proteobacteria	22518	P	6803	8	6811	0.00122
SRR9677889_1_kneaddata_paired	Actinobacteriota	615	P	6367	25	6392	0.00114
SRR9677889_1_kneaddata_paired	Deferribacterota	10822	P	2622	7	2629	0.00047
SRR9677889_1_kneaddata_paired	Cyanobacteria	9876	P	678	8	686	0.00012
SRR9677889_1_kneaddata_paired	Verrucomicrobiota	33333	P	173	5	178	0.00003
SRR9677889_1_kneaddata_paired	Firmicutes_B	17289	P	129	3	132	0.00002
SRR9677889_1_kneaddata_paired	Spirochaetota	32587	P	86	0	86	0.00002
SRR9677889_1_kneaddata_paired	Firmicutes_C	17613	P	38	0	38	0.00001
SRR9677889_1_kneaddata_paired	Campylobacterota	8700	P	35	0	35	0.00001
SRR9677889_1_kneaddata_paired	Firmicutes_I	18140	P	18	0	18	0.00000
SRR9677889_1_kneaddata_paired	Elusimicrobiota	11888	P	9	0	9	0.00000
SRR9677889_1_kneaddata_paired	Thermotogota	33086	P	1	0	1	0.00000
SRR9677890_1_kneaddata_paired	Bacteroidota	4587	P	2097275	16655	2113930	0.66575
SRR9677890_1_kneaddata_paired	Firmicutes_A	14608	P	723083	5412	728495	0.22943
SRR9677890_1_kneaddata_paired	Proteobacteria	22518	P	158429	601	159030	0.05008
SRR9677890_1_kneaddata_paired	Verrucomicrobiota	33333	P	99100	1589	100689	0.03171
SRR9677890_1_kneaddata_paired	Firmicutes	12188	P	53830	518	54348	0.01712
SRR9677890_1_kneaddata_paired	Desulfobacterota_A	11509	P	11403	79	11482	0.00362
SRR9677890_1_kneaddata_paired	Cyanobacteria	9876	P	3828	140	3968	0.00125
SRR9677890_1_kneaddata_paired	Deferribacterota	10822	P	1375	5	1380	0.00043
SRR9677890_1_kneaddata_paired	Actinobacteriota	615	P	1308	7	1315	0.00041
SRR9677890_1_kneaddata_paired	Firmicutes_B	17289	P	273	12	285	0.00009
SRR9677890_1_kneaddata_paired	Campylobacterota	8700	P	146	0	146	0.00005
SRR9677890_1_kneaddata_paired	Spirochaetota	32587	P	103	0	103	0.00003
SRR9677890_1_kneaddata_paired	Firmicutes_C	17613	P	49	0	49	0.00002
SRR9677890_1_kneaddata_paired	Firmicutes_I	18140	P	16	0	16	0.00001
SRR9677890_1_kneaddata_paired	Thermotogota	33086	P	8	0	8	0.00000
SRR9677890_1_kneaddata_paired	Elusimicrobiota	11888	P	4	0	4	0.00000
SRR9677891_1_kneaddata_paired	Bacteroidota	4587	P	2477946	24039	2501985	0.67634
SRR9677891_1_kneaddata_paired	Proteobacteria	22518	P	528049	2296	530345	0.14336
SRR9677891_1_kneaddata_paired	Firmicutes_A	14608	P	340887	2307	343194	0.09277
SRR9677891_1_kneaddata_paired	Verrucomicrobiota	33333	P	179081	2343	181424	0.04904
SRR9677891_1_kneaddata_paired	Firmicutes	12188	P	98477	962	99439	0.02688
SRR9677891_1_kneaddata_paired	Actinobacteriota	615	P	26137	82	26219	0.00709
SRR9677891_1_kneaddata_paired	Desulfobacterota_A	11509	P	13444	66	13510	0.00365
SRR9677891_1_kneaddata_paired	Cyanobacteria	9876	P	1379	54	1433	0.00039
SRR9677891_1_kneaddata_paired	Deferribacterota	10822	P	1283	3	1286	0.00035
SRR9677891_1_kneaddata_paired	Firmicutes_B	17289	P	306	10	316	0.00009
SRR9677891_1_kneaddata_paired	Campylobacterota	8700	P	84	0	84	0.00002
SRR9677891_1_kneaddata_paired	Spirochaetota	32587	P	43	0	43	0.00001
SRR9677891_1_kneaddata_paired	Firmicutes_I	18140	P	10	0	10	0.00000
SRR9677891_1_kneaddata_paired	Firmicutes_C	17613	P	9	0	9	0.00000
SRR9677891_1_kneaddata_paired	Elusimicrobiota	11888	P	3	0	3	0.00000
SRR9677891_1_kneaddata_paired	Thermotogota	33086	P	1	0	1	0.00000
SRR9677892_1_kneaddata_paired	Bacteroidota	4587	P	3713855	30421	3744276	0.72055
SRR9677892_1_kneaddata_paired	Firmicutes_A	14608	P	1255401	10144	1265545	0.24354
SRR9677892_1_kneaddata_paired	Firmicutes	12188	P	92387	965	93352	0.01796
SRR9677892_1_kneaddata_paired	Actinobacteriota	615	P	33380	206	33586	0.00646
SRR9677892_1_kneaddata_paired	Proteobacteria	22518	P	27014	177	27191	0.00523
SRR9677892_1_kneaddata_paired	Desulfobacterota_A	11509	P	25503	95	25598	0.00493
SRR9677892_1_kneaddata_paired	Cyanobacteria	9876	P	3500	201	3701	0.00071
SRR9677892_1_kneaddata_paired	Verrucomicrobiota	33333	P	2103	160	2263	0.00044
SRR9677892_1_kneaddata_paired	Deferribacterota	10822	P	373	1	374	0.00007
SRR9677892_1_kneaddata_paired	Firmicutes_B	17289	P	190	9	199	0.00004
SRR9677892_1_kneaddata_paired	Spirochaetota	32587	P	150	0	150	0.00003
SRR9677892_1_kneaddata_paired	Campylobacterota	8700	P	89	0	89	0.00002
SRR9677892_1_kneaddata_paired	Firmicutes_I	18140	P	53	0	53	0.00001
SRR9677892_1_kneaddata_paired	Firmicutes_C	17613	P	35	0	35	0.00001
SRR9677892_1_kneaddata_paired	Elusimicrobiota	11888	P	6	0	6	0.00000
SRR9677892_1_kneaddata_paired	Thermotogota	33086	P	2	0	2	0.00000
SRR9677893_1_kneaddata_paired	Bacteroidota	4587	P	4170882	28891	4199773	0.89570
SRR9677893_1_kneaddata_paired	Firmicutes_A	14608	P	414272	6375	420647	0.08971
SRR9677893_1_kneaddata_paired	Proteobacteria	22518	P	32220	47	32267	0.00688
SRR9677893_1_kneaddata_paired	Firmicutes	12188	P	28030	339	28369	0.00605
SRR9677893_1_kneaddata_paired	Desulfobacterota_A	11509	P	3948	28	3976	0.00085
SRR9677893_1_kneaddata_paired	Actinobacteriota	615	P	3222	21	3243	0.00069
SRR9677893_1_kneaddata_paired	Cyanobacteria	9876	P	344	22	366	0.00008
SRR9677893_1_kneaddata_paired	Campylobacterota	8700	P	51	0	51	0.00001
SRR9677893_1_kneaddata_paired	Firmicutes_B	17289	P	32	1	33	0.00001
SRR9677893_1_kneaddata_paired	Verrucomicrobiota	33333	P	29	0	29	0.00001
SRR9677893_1_kneaddata_paired	Spirochaetota	32587	P	16	0	16	0.00000
SRR9677893_1_kneaddata_paired	Deferribacterota	10822	P	14	0	14	0.00000
SRR9677893_1_kneaddata_paired	Firmicutes_C	17613	P	5	0	5	0.00000
SRR9677893_1_kneaddata_paired	Firmicutes_I	18140	P	5	0	5	0.00000
SRR9677894_1_kneaddata_paired	Bacteroidota	4587	P	3337476	22799	3360275	0.57441
SRR9677894_1_kneaddata_paired	Firmicutes_A	14608	P	2300999	19713	2320712	0.39671
SRR9677894_1_kneaddata_paired	Desulfobacterota_A	11509	P	78238	191	78429	0.01341
SRR9677894_1_kneaddata_paired	Firmicutes	12188	P	39886	772	40658	0.00695
SRR9677894_1_kneaddata_paired	Proteobacteria	22518	P	24900	98	24998	0.00427
SRR9677894_1_kneaddata_paired	Actinobacteriota	615	P	10994	59	11053	0.00189
SRR9677894_1_kneaddata_paired	Deferribacterota	10822	P	7624	32	7656	0.00131
SRR9677894_1_kneaddata_paired	Cyanobacteria	9876	P	2784	92	2876	0.00049
SRR9677894_1_kneaddata_paired	Verrucomicrobiota	33333	P	2392	162	2554	0.00044
SRR9677894_1_kneaddata_paired	Spirochaetota	32587	P	426	0	426	0.00007
SRR9677894_1_kneaddata_paired	Firmicutes_B	17289	P	150	6	156	0.00003
SRR9677894_1_kneaddata_paired	Campylobacterota	8700	P	59	0	59	0.00001
SRR9677894_1_kneaddata_paired	Firmicutes_C	17613	P	39	0	39	0.00001
SRR9677894_1_kneaddata_paired	Firmicutes_I	18140	P	18	0	18	0.00000
SRR9677894_1_kneaddata_paired	Thermotogota	33086	P	2	0	2	0.00000
SRR9677895_1_kneaddata_paired	Bacteroidota	4587	P	3182726	25069	3207795	0.59056
SRR9677895_1_kneaddata_paired	Firmicutes_A	14608	P	2059944	15029	2074973	0.38201
SRR9677895_1_kneaddata_paired	Desulfobacterota_A	11509	P	57153	137	57290	0.01055
SRR9677895_1_kneaddata_paired	Firmicutes	12188	P	45079	540	45619	0.00840
SRR9677895_1_kneaddata_paired	Proteobacteria	22518	P	22388	89	22477	0.00414
SRR9677895_1_kneaddata_paired	Actinobacteriota	615	P	14406	86	14492	0.00267
SRR9677895_1_kneaddata_paired	Verrucomicrobiota	33333	P	5204	348	5552	0.00102
SRR9677895_1_kneaddata_paired	Deferribacterota	10822	P	1512	6	1518	0.00028
SRR9677895_1_kneaddata_paired	Cyanobacteria	9876	P	1439	36	1475	0.00027
SRR9677895_1_kneaddata_paired	Spirochaetota	32587	P	296	0	296	0.00005
SRR9677895_1_kneaddata_paired	Firmicutes_B	17289	P	172	7	179	0.00003
SRR9677895_1_kneaddata_paired	Campylobacterota	8700	P	42	0	42	0.00001
SRR9677895_1_kneaddata_paired	Firmicutes_I	18140	P	38	0	38	0.00001
SRR9677895_1_kneaddata_paired	Firmicutes_C	17613	P	31	0	31	0.00001
SRR9677895_1_kneaddata_paired	Elusimicrobiota	11888	P	7	0	7	0.00000
SRR9677896_1_kneaddata_paired	Bacteroidota	4587	P	3608487	28041	3636528	0.65356
SRR9677896_1_kneaddata_paired	Firmicutes_A	14608	P	1755675	14658	1770333	0.31816
SRR9677896_1_kneaddata_paired	Firmicutes	12188	P	106900	768	107668	0.01935
SRR9677896_1_kneaddata_paired	Desulfobacterota_A	11509	P	20665	88	20753	0.00373
SRR9677896_1_kneaddata_paired	Proteobacteria	22518	P	14118	28	14146	0.00254
SRR9677896_1_kneaddata_paired	Actinobacteriota	615	P	7257	50	7307	0.00131
SRR9677896_1_kneaddata_paired	Deferribacterota	10822	P	4470	17	4487	0.00081
SRR9677896_1_kneaddata_paired	Cyanobacteria	9876	P	2479	31	2510	0.00045
SRR9677896_1_kneaddata_paired	Firmicutes_B	17289	P	158	6	164	0.00003
SRR9677896_1_kneaddata_paired	Verrucomicrobiota	33333	P	91	3	94	0.00002
SRR9677896_1_kneaddata_paired	Campylobacterota	8700	P	57	0	57	0.00001
SRR9677896_1_kneaddata_paired	Spirochaetota	32587	P	48	0	48	0.00001
SRR9677896_1_kneaddata_paired	Firmicutes_C	17613	P	41	0	41	0.00001
SRR9677896_1_kneaddata_paired	Firmicutes_I	18140	P	38	0	38	0.00001
SRR9677896_1_kneaddata_paired	Thermotogota	33086	P	36	0	36	0.00001
SRR9677896_1_kneaddata_paired	Elusimicrobiota	11888	P	4	0	4	0.00000
SRR9677897_1_kneaddata_paired	Bacteroidota	4587	P	3040096	26338	3066434	0.64222
SRR9677897_1_kneaddata_paired	Firmicutes_A	14608	P	1077752	6866	1084618	0.22716
SRR9677897_1_kneaddata_paired	Verrucomicrobiota	33333	P	482938	6683	489621	0.10254
SRR9677897_1_kneaddata_paired	Proteobacteria	22518	P	45188	242	45430	0.00951
SRR9677897_1_kneaddata_paired	Firmicutes	12188	P	42613	573	43186	0.00904
SRR9677897_1_kneaddata_paired	Desulfobacterota_A	11509	P	31265	116	31381	0.00657
SRR9677897_1_kneaddata_paired	Actinobacteriota	615	P	5070	24	5094	0.00107
SRR9677897_1_kneaddata_paired	Cyanobacteria	9876	P	4457	56	4513	0.00095
SRR9677897_1_kneaddata_paired	Deferribacterota	10822	P	3482	12	3494	0.00073
SRR9677897_1_kneaddata_paired	Firmicutes_B	17289	P	538	20	558	0.00012
SRR9677897_1_kneaddata_paired	Campylobacterota	8700	P	231	0	231	0.00005
SRR9677897_1_kneaddata_paired	Spirochaetota	32587	P	101	0	101	0.00002
SRR9677897_1_kneaddata_paired	Firmicutes_I	18140	P	59	0	59	0.00001
SRR9677897_1_kneaddata_paired	Firmicutes_C	17613	P	21	0	21	0.00000
SRR9677897_1_kneaddata_paired	Elusimicrobiota	11888	P	4	0	4	0.00000
SRR9677897_1_kneaddata_paired	Thermotogota	33086	P	1	0	1	0.00000
SRR9677898_1_kneaddata_paired	Bacteroidota	4587	P	2782450	23146	2805596	0.53526
SRR9677898_1_kneaddata_paired	Firmicutes_A	14608	P	2280219	18794	2299013	0.43861
SRR9677898_1_kneaddata_paired	Firmicutes	12188	P	78045	771	78816	0.01504
SRR9677898_1_kneaddata_paired	Proteobacteria	22518	P	25657	65	25722	0.00491
SRR9677898_1_kneaddata_paired	Desulfobacterota_A	11509	P	18490	52	18542	0.00354
SRR9677898_1_kneaddata_paired	Deferribacterota	10822	P	7451	26	7477	0.00143
SRR9677898_1_kneaddata_paired	Actinobacteriota	615	P	4717	22	4739	0.00090
SRR9677898_1_kneaddata_paired	Cyanobacteria	9876	P	1273	28	1301	0.00025
SRR9677898_1_kneaddata_paired	Firmicutes_B	17289	P	132	4	136	0.00003
SRR9677898_1_kneaddata_paired	Verrucomicrobiota	33333	P	74	3	77	0.00001
SRR9677898_1_kneaddata_paired	Spirochaetota	32587	P	46	0	46	0.00001
SRR9677898_1_kneaddata_paired	Campylobacterota	8700	P	45	0	45	0.00001
SRR9677898_1_kneaddata_paired	Firmicutes_I	18140	P	27	0	27	0.00001
SRR9677898_1_kneaddata_paired	Firmicutes_C	17613	P	21	0	21	0.00000
SRR9677898_1_kneaddata_paired	Elusimicrobiota	11888	P	6	0	6	0.00000
SRR9677899_1_kneaddata_paired	Bacteroidota	4587	P	4144092	31683	4175775	0.88229
SRR9677899_1_kneaddata_paired	Firmicutes_A	14608	P	434576	6798	441374	0.09326
SRR9677899_1_kneaddata_paired	Firmicutes	12188	P	85925	662	86587	0.01830
SRR9677899_1_kneaddata_paired	Proteobacteria	22518	P	14125	22	14147	0.00299
SRR9677899_1_kneaddata_paired	Desulfobacterota_A	11509	P	6888	19	6907	0.00146
SRR9677899_1_kneaddata_paired	Actinobacteriota	615	P	5750	30	5780	0.00122
SRR9677899_1_kneaddata_paired	Deferribacterota	10822	P	1279	4	1283	0.00027
SRR9677899_1_kneaddata_paired	Cyanobacteria	9876	P	790	28	818	0.00017
SRR9677899_1_kneaddata_paired	Campylobacterota	8700	P	60	0	60	0.00001
SRR9677899_1_kneaddata_paired	Verrucomicrobiota	33333	P	41	1	42	0.00001
SRR9677899_1_kneaddata_paired	Spirochaetota	32587	P	38	0	38	0.00001
SRR9677899_1_kneaddata_paired	Firmicutes_B	17289	P	30	1	31	0.00001
SRR9677899_1_kneaddata_paired	Firmicutes_I	18140	P	9	0	9	0.00000
SRR9677899_1_kneaddata_paired	Firmicutes_C	17613	P	5	0	5	0.00000
SRR9677899_1_kneaddata_paired	Elusimicrobiota	11888	P	1	0	1	0.00000
SRR9677900_1_kneaddata_paired	Proteobacteria	22518	P	1241850	1551	1243401	0.52824
SRR9677900_1_kneaddata_paired	Bacteroidota	4587	P	1004072	9386	1013458	0.43055
SRR9677900_1_kneaddata_paired	Firmicutes_A	14608	P	57499	366	57865	0.02458
SRR9677900_1_kneaddata_paired	Firmicutes	12188	P	24212	238	24450	0.01039
SRR9677900_1_kneaddata_paired	Actinobacteriota	615	P	8749	22	8771	0.00373
SRR9677900_1_kneaddata_paired	Desulfobacterota_A	11509	P	4005	10	4015	0.00171
SRR9677900_1_kneaddata_paired	Deferribacterota	10822	P	869	2	871	0.00037
SRR9677900_1_kneaddata_paired	Cyanobacteria	9876	P	496	16	512	0.00022
SRR9677900_1_kneaddata_paired	Verrucomicrobiota	33333	P	453	19	472	0.00020
SRR9677900_1_kneaddata_paired	Spirochaetota	32587	P	21	0	21	0.00001
SRR9677900_1_kneaddata_paired	Firmicutes_B	17289	P	18	0	18	0.00001
SRR9677900_1_kneaddata_paired	Campylobacterota	8700	P	7	0	7	0.00000
SRR9677900_1_kneaddata_paired	Firmicutes_I	18140	P	5	0	5	0.00000
SRR9677901_1_kneaddata_paired	Proteobacteria	22518	P	1123191	1348	1124539	0.57429
SRR9677901_1_kneaddata_paired	Bacteroidota	4587	P	740516	6179	746695	0.38133
SRR9677901_1_kneaddata_paired	Firmicutes_A	14608	P	40976	258	41234	0.02106
SRR9677901_1_kneaddata_paired	Firmicutes	12188	P	30136	137	30273	0.01546
SRR9677901_1_kneaddata_paired	Actinobacteriota	615	P	8267	24	8291	0.00423
SRR9677901_1_kneaddata_paired	Desulfobacterota_A	11509	P	5029	13	5042	0.00258
SRR9677901_1_kneaddata_paired	Cyanobacteria	9876	P	822	24	846	0.00043
SRR9677901_1_kneaddata_paired	Verrucomicrobiota	33333	P	635	25	660	0.00034
SRR9677901_1_kneaddata_paired	Deferribacterota	10822	P	483	1	484	0.00025
SRR9677901_1_kneaddata_paired	Spirochaetota	32587	P	22	0	22	0.00001
SRR9677901_1_kneaddata_paired	Campylobacterota	8700	P	21	0	21	0.00001
SRR9677901_1_kneaddata_paired	Firmicutes_B	17289	P	18	0	18	0.00001
SRR9677901_1_kneaddata_paired	Firmicutes_I	18140	P	5	0	5	0.00000
SRR9677901_1_kneaddata_paired	Firmicutes_C	17613	P	3	0	3	0.00000
SRR9677902_1_kneaddata_paired	Bacteroidota	4587	P	807718	6847	814565	0.45295
SRR9677902_1_kneaddata_paired	Proteobacteria	22518	P	697330	1070	698400	0.38835
SRR9677902_1_kneaddata_paired	Firmicutes_A	14608	P	177152	1170	178322	0.09916
SRR9677902_1_kneaddata_paired	Firmicutes	12188	P	58343	490	58833	0.03272
SRR9677902_1_kneaddata_paired	Desulfobacterota_A	11509	P	26892	104	26996	0.01501
SRR9677902_1_kneaddata_paired	Actinobacteriota	615	P	17038	81	17119	0.00952
SRR9677902_1_kneaddata_paired	Deferribacterota	10822	P	2698	10	2708	0.00151
SRR9677902_1_kneaddata_paired	Cyanobacteria	9876	P	989	18	1007	0.00056
SRR9677902_1_kneaddata_paired	Campylobacterota	8700	P	109	0	109	0.00006
SRR9677902_1_kneaddata_paired	Spirochaetota	32587	P	91	0	91	0.00005
SRR9677902_1_kneaddata_paired	Firmicutes_B	17289	P	72	2	74	0.00004
SRR9677902_1_kneaddata_paired	Verrucomicrobiota	33333	P	50	1	51	0.00003
SRR9677902_1_kneaddata_paired	Firmicutes_I	18140	P	44	0	44	0.00002
SRR9677902_1_kneaddata_paired	Firmicutes_C	17613	P	23	0	23	0.00001
SRR9677902_1_kneaddata_paired	Elusimicrobiota	11888	P	12	0	12	0.00001
SRR9677902_1_kneaddata_paired	Thermotogota	33086	P	2	0	2	0.00000
SRR9677903_1_kneaddata_paired	Bacteroidota	4587	P	804067	6772	810839	0.44538
SRR9677903_1_kneaddata_paired	Firmicutes_A	14608	P	735599	3441	739040	0.40594
SRR9677903_1_kneaddata_paired	Proteobacteria	22518	P	175688	309	175997	0.09667
SRR9677903_1_kneaddata_paired	Firmicutes	12188	P	73846	654	74500	0.04092
SRR9677903_1_kneaddata_paired	Desulfobacterota_A	11509	P	12267	28	12295	0.00675
SRR9677903_1_kneaddata_paired	Actinobacteriota	615	P	4465	30	4495	0.00247
SRR9677903_1_kneaddata_paired	Verrucomicrobiota	33333	P	1347	89	1436	0.00079
SRR9677903_1_kneaddata_paired	Cyanobacteria	9876	P	1163	25	1188	0.00065
SRR9677903_1_kneaddata_paired	Firmicutes_B	17289	P	422	18	440	0.00024
SRR9677903_1_kneaddata_paired	Deferribacterota	10822	P	141	0	141	0.00008
SRR9677903_1_kneaddata_paired	Spirochaetota	32587	P	71	0	71	0.00004
SRR9677903_1_kneaddata_paired	Campylobacterota	8700	P	62	0	62	0.00003
SRR9677903_1_kneaddata_paired	Firmicutes_I	18140	P	32	0	32	0.00002
SRR9677903_1_kneaddata_paired	Firmicutes_C	17613	P	19	0	19	0.00001
SRR9677903_1_kneaddata_paired	Elusimicrobiota	11888	P	3	0	3	0.00000
SRR9677903_1_kneaddata_paired	Thermotogota	33086	P	3	0	3	0.00000
SRR9677904_1_kneaddata_paired	Firmicutes_A	14608	P	1813675	9571	1823246	0.42503
SRR9677904_1_kneaddata_paired	Bacteroidota	4587	P	1236883	15965	1252848	0.29206
SRR9677904_1_kneaddata_paired	Proteobacteria	22518	P	1083964	1344	1085308	0.25300
SRR9677904_1_kneaddata_paired	Firmicutes	12188	P	99654	1268	100922	0.02353
SRR9677904_1_kneaddata_paired	Desulfobacterota_A	11509	P	18027	154	18181	0.00424
SRR9677904_1_kneaddata_paired	Cyanobacteria	9876	P	4551	239	4790	0.00112
SRR9677904_1_kneaddata_paired	Deferribacterota	10822	P	1957	9	1966	0.00046
SRR9677904_1_kneaddata_paired	Actinobacteriota	615	P	1074	5	1079	0.00025
SRR9677904_1_kneaddata_paired	Firmicutes_B	17289	P	579	28	607	0.00014
SRR9677904_1_kneaddata_paired	Verrucomicrobiota	33333	P	423	31	454	0.00011
SRR9677904_1_kneaddata_paired	Spirochaetota	32587	P	89	0	89	0.00002
SRR9677904_1_kneaddata_paired	Campylobacterota	8700	P	79	0	79	0.00002
SRR9677904_1_kneaddata_paired	Firmicutes_C	17613	P	54	0	54	0.00001
SRR9677904_1_kneaddata_paired	Firmicutes_I	18140	P	44	0	44	0.00001
SRR9677904_1_kneaddata_paired	Thermotogota	33086	P	8	0	8	0.00000
SRR9677904_1_kneaddata_paired	Elusimicrobiota	11888	P	3	0	3	0.00000
SRR9677905_1_kneaddata_paired	Firmicutes_A	14608	P	1988316	13288	2001604	0.41570
SRR9677905_1_kneaddata_paired	Proteobacteria	22518	P	1198345	2930	1201275	0.24949
SRR9677905_1_kneaddata_paired	Bacteroidota	4587	P	960862	11385	972247	0.20192
SRR9677905_1_kneaddata_paired	Firmicutes	12188	P	575351	6573	581924	0.12086
SRR9677905_1_kneaddata_paired	Desulfobacterota_A	11509	P	30082	156	30238	0.00628
SRR9677905_1_kneaddata_paired	Actinobacteriota	615	P	15627	159	15786	0.00328
SRR9677905_1_kneaddata_paired	Verrucomicrobiota	33333	P	6502	651	7153	0.00149
SRR9677905_1_kneaddata_paired	Cyanobacteria	9876	P	3128	139	3267	0.00068
SRR9677905_1_kneaddata_paired	Firmicutes_B	17289	P	648	42	690	0.00014
SRR9677905_1_kneaddata_paired	Campylobacterota	8700	P	285	0	285	0.00006
SRR9677905_1_kneaddata_paired	Deferribacterota	10822	P	285	1	286	0.00006
SRR9677905_1_kneaddata_paired	Spirochaetota	32587	P	142	0	142	0.00003
SRR9677905_1_kneaddata_paired	Firmicutes_I	18140	P	63	0	63	0.00001
SRR9677905_1_kneaddata_paired	Firmicutes_C	17613	P	45	0	45	0.00001
SRR9677905_1_kneaddata_paired	Elusimicrobiota	11888	P	3	0	3	0.00000
SRR9677905_1_kneaddata_paired	Thermotogota	33086	P	2	0	2	0.00000
SRR9677906_1_kneaddata_paired	Proteobacteria	22518	P	469026	255	469281	0.41749
SRR9677906_1_kneaddata_paired	Bacteroidota	4587	P	404236	2206	406442	0.36159
SRR9677906_1_kneaddata_paired	Firmicutes_A	14608	P	179101	582	179683	0.15985
SRR9677906_1_kneaddata_paired	Verrucomicrobiota	33333	P	38794	1593	40387	0.03593
SRR9677906_1_kneaddata_paired	Firmicutes	12188	P	12661	86	12747	0.01134
SRR9677906_1_kneaddata_paired	Desulfobacterota_A	11509	P	8997	10	9007	0.00801
SRR9677906_1_kneaddata_paired	Actinobacteriota	615	P	5498	44	5542	0.00493
SRR9677906_1_kneaddata_paired	Cyanobacteria	9876	P	646	9	655	0.00058
SRR9677906_1_kneaddata_paired	Firmicutes_B	17289	P	128	3	131	0.00012
SRR9677906_1_kneaddata_paired	Deferribacterota	10822	P	69	0	69	0.00006
SRR9677906_1_kneaddata_paired	Spirochaetota	32587	P	54	0	54	0.00005
SRR9677906_1_kneaddata_paired	Campylobacterota	8700	P	18	0	18	0.00002
SRR9677906_1_kneaddata_paired	Firmicutes_C	17613	P	17	0	17	0.00002
SRR9677906_1_kneaddata_paired	Firmicutes_I	18140	P	9	0	9	0.00001
SRR9677907_1_kneaddata_paired	Bacteroidota	4587	P	1797794	9090	1806884	0.49256
SRR9677907_1_kneaddata_paired	Firmicutes_A	14608	P	1730030	10959	1740989	0.47459
SRR9677907_1_kneaddata_paired	Firmicutes	12188	P	58837	518	59355	0.01618
SRR9677907_1_kneaddata_paired	Desulfobacterota_A	11509	P	45918	58	45976	0.01253
SRR9677907_1_kneaddata_paired	Proteobacteria	22518	P	7127	12	7139	0.00195
SRR9677907_1_kneaddata_paired	Actinobacteriota	615	P	6078	15	6093	0.00166
SRR9677907_1_kneaddata_paired	Cyanobacteria	9876	P	1083	13	1096	0.00030
SRR9677907_1_kneaddata_paired	Deferribacterota	10822	P	381	0	381	0.00010
SRR9677907_1_kneaddata_paired	Firmicutes_B	17289	P	124	3	127	0.00003
SRR9677907_1_kneaddata_paired	Spirochaetota	32587	P	107	0	107	0.00003
SRR9677907_1_kneaddata_paired	Verrucomicrobiota	33333	P	88	2	90	0.00002
SRR9677907_1_kneaddata_paired	Campylobacterota	8700	P	60	0	60	0.00002
SRR9677907_1_kneaddata_paired	Firmicutes_C	17613	P	37	0	37	0.00001
SRR9677907_1_kneaddata_paired	Firmicutes_I	18140	P	26	0	26	0.00001
SRR9677907_1_kneaddata_paired	Elusimicrobiota	11888	P	14	0	14	0.00000
SRR9677907_1_kneaddata_paired	Thermotogota	33086	P	1	0	1	0.00000
SRR9677908_1_kneaddata_paired	Bacteroidota	4587	P	1760739	9931	1770670	0.47442
SRR9677908_1_kneaddata_paired	Firmicutes_A	14608	P	1759449	10282	1769731	0.47417
SRR9677908_1_kneaddata_paired	Firmicutes	12188	P	94753	608	95361	0.02555
SRR9677908_1_kneaddata_paired	Desulfobacterota_A	11509	P	76524	91	76615	0.02053
SRR9677908_1_kneaddata_paired	Proteobacteria	22518	P	8905	11	8916	0.00239
SRR9677908_1_kneaddata_paired	Actinobacteriota	615	P	6867	25	6892	0.00185
SRR9677908_1_kneaddata_paired	Deferribacterota	10822	P	2075	5	2080	0.00056
SRR9677908_1_kneaddata_paired	Cyanobacteria	9876	P	1363	13	1376	0.00037
SRR9677908_1_kneaddata_paired	Spirochaetota	32587	P	170	0	170	0.00005
SRR9677908_1_kneaddata_paired	Firmicutes_B	17289	P	126	3	129	0.00003
SRR9677908_1_kneaddata_paired	Campylobacterota	8700	P	112	0	112	0.00003
SRR9677908_1_kneaddata_paired	Verrucomicrobiota	33333	P	86	1	87	0.00002
SRR9677908_1_kneaddata_paired	Firmicutes_I	18140	P	38	0	38	0.00001
SRR9677908_1_kneaddata_paired	Thermotogota	33086	P	33	0	33	0.00001
SRR9677908_1_kneaddata_paired	Firmicutes_C	17613	P	28	0	28	0.00001
SRR9677908_1_kneaddata_paired	Elusimicrobiota	11888	P	22	0	22	0.00001
SRR9677909_1_kneaddata_paired	Firmicutes_A	14608	P	1330922	7746	1338668	0.63863
SRR9677909_1_kneaddata_paired	Bacteroidota	4587	P	683314	3988	687302	0.32789
SRR9677909_1_kneaddata_paired	Desulfobacterota_A	11509	P	32271	51	32322	0.01542
SRR9677909_1_kneaddata_paired	Firmicutes	12188	P	28086	259	28345	0.01352
SRR9677909_1_kneaddata_paired	Actinobacteriota	615	P	3178	9	3187	0.00152
SRR9677909_1_kneaddata_paired	Proteobacteria	22518	P	2206	4	2210	0.00105
SRR9677909_1_kneaddata_paired	Deferribacterota	10822	P	2180	5	2185	0.00104
SRR9677909_1_kneaddata_paired	Cyanobacteria	9876	P	1593	9	1602	0.00076
SRR9677909_1_kneaddata_paired	Spirochaetota	32587	P	82	0	82	0.00004
SRR9677909_1_kneaddata_paired	Firmicutes_B	17289	P	80	2	82	0.00004
SRR9677909_1_kneaddata_paired	Verrucomicrobiota	33333	P	67	1	68	0.00003
SRR9677909_1_kneaddata_paired	Campylobacterota	8700	P	48	0	48	0.00002
SRR9677909_1_kneaddata_paired	Firmicutes_I	18140	P	27	0	27	0.00001
SRR9677909_1_kneaddata_paired	Elusimicrobiota	11888	P	21	0	21	0.00001
SRR9677909_1_kneaddata_paired	Firmicutes_C	17613	P	9	0	9	0.00000
SRR9677910_1_kneaddata_paired	Bacteroidota	4587	P	3749175	24638	3773813	0.83036
SRR9677910_1_kneaddata_paired	Firmicutes_A	14608	P	676059	9219	685278	0.15078
SRR9677910_1_kneaddata_paired	Firmicutes	12188	P	24160	430	24590	0.00541
SRR9677910_1_kneaddata_paired	Verrucomicrobiota	33333	P	20733	1786	22519	0.00496
SRR9677910_1_kneaddata_paired	Proteobacteria	22518	P	18594	51	18645	0.00410
SRR9677910_1_kneaddata_paired	Desulfobacterota_A	11509	P	13294	46	13340	0.00294
SRR9677910_1_kneaddata_paired	Actinobacteriota	615	P	5169	48	5217	0.00115
SRR9677910_1_kneaddata_paired	Cyanobacteria	9876	P	1150	26	1176	0.00026
SRR9677910_1_kneaddata_paired	Spirochaetota	32587	P	78	0	78	0.00002
SRR9677910_1_kneaddata_paired	Firmicutes_B	17289	P	40	2	42	0.00001
SRR9677910_1_kneaddata_paired	Campylobacterota	8700	P	36	0	36	0.00001
SRR9677910_1_kneaddata_paired	Deferribacterota	10822	P	21	0	21	0.00000
SRR9677910_1_kneaddata_paired	Firmicutes_C	17613	P	21	0	21	0.00000
SRR9677910_1_kneaddata_paired	Firmicutes_I	18140	P	9	0	9	0.00000
SRR9677910_1_kneaddata_paired	Elusimicrobiota	11888	P	3	0	3	0.00000
SRR9677910_1_kneaddata_paired	Thermotogota	33086	P	1	0	1	0.00000
SRR9677911_1_kneaddata_paired	Firmicutes_A	14608	P	3516234	27524	3543758	0.59906
SRR9677911_1_kneaddata_paired	Bacteroidota	4587	P	2200385	19331	2219716	0.37524
SRR9677911_1_kneaddata_paired	Desulfobacterota_A	11509	P	64874	422	65296	0.01104
SRR9677911_1_kneaddata_paired	Firmicutes	12188	P	61095	1197	62292	0.01053
SRR9677911_1_kneaddata_paired	Proteobacteria	22518	P	9332	37	9369	0.00158
SRR9677911_1_kneaddata_paired	Actinobacteriota	615	P	4811	52	4863	0.00082
SRR9677911_1_kneaddata_paired	Cyanobacteria	9876	P	4802	77	4879	0.00082
SRR9677911_1_kneaddata_paired	Verrucomicrobiota	33333	P	3158	285	3443	0.00058
SRR9677911_1_kneaddata_paired	Deferribacterota	10822	P	864	5	869	0.00015
SRR9677911_1_kneaddata_paired	Spirochaetota	32587	P	372	0	372	0.00006
SRR9677911_1_kneaddata_paired	Firmicutes_B	17289	P	362	23	385	0.00007
SRR9677911_1_kneaddata_paired	Campylobacterota	8700	P	110	0	110	0.00002
SRR9677911_1_kneaddata_paired	Firmicutes_C	17613	P	64	0	64	0.00001
SRR9677911_1_kneaddata_paired	Firmicutes_I	18140	P	61	0	61	0.00001
SRR9677911_1_kneaddata_paired	Elusimicrobiota	11888	P	9	0	9	0.00000
SRR9677911_1_kneaddata_paired	Thermotogota	33086	P	7	0	7	0.00000
SRR9677912_1_kneaddata_paired	Bacteroidota	4587	P	346492	3228	349720	0.46692
SRR9677912_1_kneaddata_paired	Proteobacteria	22518	P	202481	343	202824	0.27080
SRR9677912_1_kneaddata_paired	Firmicutes_A	14608	P	121411	901	122312	0.16330
SRR9677912_1_kneaddata_paired	Firmicutes	12188	P	46337	324	46661	0.06230
SRR9677912_1_kneaddata_paired	Actinobacteriota	615	P	17224	99	17323	0.02313
SRR9677912_1_kneaddata_paired	Desulfobacterota_A	11509	P	8647	33	8680	0.01159
SRR9677912_1_kneaddata_paired	Deferribacterota	10822	P	648	2	650	0.00087
SRR9677912_1_kneaddata_paired	Cyanobacteria	9876	P	578	16	594	0.00079
SRR9677912_1_kneaddata_paired	Campylobacterota	8700	P	73	0	73	0.00010
SRR9677912_1_kneaddata_paired	Firmicutes_B	17289	P	59	2	61	0.00008
SRR9677912_1_kneaddata_paired	Spirochaetota	32587	P	51	0	51	0.00007
SRR9677912_1_kneaddata_paired	Verrucomicrobiota	33333	P	21	0	21	0.00003
SRR9677912_1_kneaddata_paired	Firmicutes_I	18140	P	10	0	10	0.00001
SRR9677912_1_kneaddata_paired	Elusimicrobiota	11888	P	3	0	3	0.00000
SRR9677912_1_kneaddata_paired	Firmicutes_C	17613	P	3	0	3	0.00000
SRR9677912_1_kneaddata_paired	Thermotogota	33086	P	2	0	2	0.00000
SRR9677913_1_kneaddata_paired	Firmicutes	12188	P	2348284	27292	2375576	0.47965
SRR9677913_1_kneaddata_paired	Bacteroidota	4587	P	1586180	32238	1618418	0.32677
SRR9677913_1_kneaddata_paired	Firmicutes_A	14608	P	644982	13655	658637	0.13298
SRR9677913_1_kneaddata_paired	Proteobacteria	22518	P	242118	828	242946	0.04905
SRR9677913_1_kneaddata_paired	Actinobacteriota	615	P	30938	225	31163	0.00629
SRR9677913_1_kneaddata_paired	Verrucomicrobiota	33333	P	15440	2088	17528	0.00354
SRR9677913_1_kneaddata_paired	Desulfobacterota_A	11509	P	6251	71	6322	0.00128
SRR9677913_1_kneaddata_paired	Cyanobacteria	9876	P	1435	87	1522	0.00031
SRR9677913_1_kneaddata_paired	Campylobacterota	8700	P	389	1	390	0.00008
SRR9677913_1_kneaddata_paired	Deferribacterota	10822	P	144	1	145	0.00003
SRR9677913_1_kneaddata_paired	Firmicutes_B	17289	P	38	3	41	0.00001
SRR9677913_1_kneaddata_paired	Spirochaetota	32587	P	28	0	28	0.00001
SRR9677913_1_kneaddata_paired	Firmicutes_I	18140	P	19	0	19	0.00000
SRR9677913_1_kneaddata_paired	Firmicutes_C	17613	P	2	0	2	0.00000
SRR9677913_1_kneaddata_paired	Elusimicrobiota	11888	P	1	0	1	0.00000
SRR9677914_1_kneaddata_paired	Bacteroidota	4587	P	1074112	8927	1083039	0.54222
SRR9677914_1_kneaddata_paired	Firmicutes_A	14608	P	846226	6095	852321	0.42672
SRR9677914_1_kneaddata_paired	Firmicutes	12188	P	40312	348	40660	0.02036
SRR9677914_1_kneaddata_paired	Desulfobacterota_A	11509	P	9636	62	9698	0.00486
SRR9677914_1_kneaddata_paired	Deferribacterota	10822	P	3964	14	3978	0.00199
SRR9677914_1_kneaddata_paired	Proteobacteria	22518	P	3833	13	3846	0.00193
SRR9677914_1_kneaddata_paired	Actinobacteriota	615	P	1730	13	1743	0.00087
SRR9677914_1_kneaddata_paired	Cyanobacteria	9876	P	1572	40	1612	0.00081
SRR9677914_1_kneaddata_paired	Firmicutes_B	17289	P	204	7	211	0.00011
SRR9677914_1_kneaddata_paired	Verrucomicrobiota	33333	P	127	6	133	0.00007
SRR9677914_1_kneaddata_paired	Campylobacterota	8700	P	62	0	62	0.00003
SRR9677914_1_kneaddata_paired	Spirochaetota	32587	P	45	0	45	0.00002
SRR9677914_1_kneaddata_paired	Firmicutes_I	18140	P	26	0	26	0.00001
SRR9677914_1_kneaddata_paired	Firmicutes_C	17613	P	19	0	19	0.00001
SRR9677914_1_kneaddata_paired	Elusimicrobiota	11888	P	2	0	2	0.00000
SRR9677914_1_kneaddata_paired	Thermotogota	33086	P	2	0	2	0.00000
SRR9677915_1_kneaddata_paired	Bacteroidota	4587	P	2517733	20862	2538595	0.83248
SRR9677915_1_kneaddata_paired	Firmicutes_A	14608	P	363637	5923	369560	0.12119
SRR9677915_1_kneaddata_paired	Firmicutes	12188	P	73351	1489	74840	0.02454
SRR9677915_1_kneaddata_paired	Campylobacterota	8700	P	28205	1	28206	0.00925
SRR9677915_1_kneaddata_paired	Desulfobacterota_A	11509	P	12379	65	12444	0.00408
SRR9677915_1_kneaddata_paired	Proteobacteria	22518	P	11857	55	11912	0.00391
SRR9677915_1_kneaddata_paired	Actinobacteriota	615	P	9927	57	9984	0.00327
SRR9677915_1_kneaddata_paired	Deferribacterota	10822	P	2848	12	2860	0.00094
SRR9677915_1_kneaddata_paired	Cyanobacteria	9876	P	706	36	742	0.00024
SRR9677915_1_kneaddata_paired	Firmicutes_B	17289	P	93	4	97	0.00003
SRR9677915_1_kneaddata_paired	Verrucomicrobiota	33333	P	90	5	95	0.00003
SRR9677915_1_kneaddata_paired	Firmicutes_C	17613	P	46	0	46	0.00002
SRR9677915_1_kneaddata_paired	Spirochaetota	32587	P	23	0	23	0.00001
SRR9677915_1_kneaddata_paired	Elusimicrobiota	11888	P	6	0	6	0.00000
SRR9677915_1_kneaddata_paired	Firmicutes_I	18140	P	5	0	5	0.00000
SRR9677915_1_kneaddata_paired	Thermotogota	33086	P	3	0	3	0.00000
SRR9677916_1_kneaddata_paired	Bacteroidota	4587	P	3565363	30137	3595500	0.82343
SRR9677916_1_kneaddata_paired	Firmicutes	12188	P	331179	2385	333564	0.07639
SRR9677916_1_kneaddata_paired	Firmicutes_A	14608	P	320027	8209	328236	0.07517
SRR9677916_1_kneaddata_paired	Proteobacteria	22518	P	66096	190	66286	0.01518
SRR9677916_1_kneaddata_paired	Campylobacterota	8700	P	18798	0	18798	0.00431
SRR9677916_1_kneaddata_paired	Desulfobacterota_A	11509	P	12391	56	12447	0.00285
SRR9677916_1_kneaddata_paired	Actinobacteriota	615	P	8596	72	8668	0.00199
SRR9677916_1_kneaddata_paired	Cyanobacteria	9876	P	1308	81	1389	0.00032
SRR9677916_1_kneaddata_paired	Deferribacterota	10822	P	1261	6	1267	0.00029
SRR9677916_1_kneaddata_paired	Verrucomicrobiota	33333	P	122	7	129	0.00003
SRR9677916_1_kneaddata_paired	Firmicutes_B	17289	P	106	5	111	0.00003
SRR9677916_1_kneaddata_paired	Spirochaetota	32587	P	56	0	56	0.00001
SRR9677916_1_kneaddata_paired	Firmicutes_C	17613	P	38	0	38	0.00001
SRR9677916_1_kneaddata_paired	Firmicutes_I	18140	P	12	0	12	0.00000
SRR9677916_1_kneaddata_paired	Elusimicrobiota	11888	P	1	0	1	0.00000
SRR9677916_1_kneaddata_paired	Thermotogota	33086	P	1	0	1	0.00000
SRR9677917_1_kneaddata_paired	Bacteroidota	4587	P	333548	2736	336284	0.57024
SRR9677917_1_kneaddata_paired	Proteobacteria	22518	P	144045	225	144270	0.24464
SRR9677917_1_kneaddata_paired	Firmicutes_A	14608	P	58390	480	58870	0.09983
SRR9677917_1_kneaddata_paired	Firmicutes	12188	P	23048	180	23228	0.03939
SRR9677917_1_kneaddata_paired	Desulfobacterota_A	11509	P	13789	61	13850	0.02349
SRR9677917_1_kneaddata_paired	Actinobacteriota	615	P	12252	51	12303	0.02086
SRR9677917_1_kneaddata_paired	Deferribacterota	10822	P	473	1	474	0.00081
SRR9677917_1_kneaddata_paired	Cyanobacteria	9876	P	358	5	363	0.00062
SRR9677917_1_kneaddata_paired	Spirochaetota	32587	P	38	0	38	0.00006
SRR9677917_1_kneaddata_paired	Firmicutes_B	17289	P	13	0	13	0.00002
SRR9677917_1_kneaddata_paired	Verrucomicrobiota	33333	P	13	0	13	0.00002
SRR9677917_1_kneaddata_paired	Campylobacterota	8700	P	7	0	7	0.00001
SRR9677917_1_kneaddata_paired	Firmicutes_I	18140	P	2	0	2	0.00000
SRR9677918_1_kneaddata_paired	Bacteroidota	4587	P	200047	1419	201466	0.52143
SRR9677918_1_kneaddata_paired	Firmicutes_A	14608	P	129975	843	130818	0.33858
SRR9677918_1_kneaddata_paired	Actinobacteriota	615	P	14991	52	15043	0.03894
SRR9677918_1_kneaddata_paired	Proteobacteria	22518	P	14600	24	14624	0.03785
SRR9677918_1_kneaddata_paired	Desulfobacterota_A	11509	P	11497	35	11532	0.02985
SRR9677918_1_kneaddata_paired	Firmicutes	12188	P	10737	147	10884	0.02817
SRR9677918_1_kneaddata_paired	Deferribacterota	10822	P	1483	5	1488	0.00385
SRR9677918_1_kneaddata_paired	Cyanobacteria	9876	P	400	2	402	0.00104
SRR9677918_1_kneaddata_paired	Spirochaetota	32587	P	36	0	36	0.00009
SRR9677918_1_kneaddata_paired	Campylobacterota	8700	P	34	0	34	0.00009
SRR9677918_1_kneaddata_paired	Firmicutes_B	17289	P	20	0	20	0.00005
SRR9677918_1_kneaddata_paired	Verrucomicrobiota	33333	P	11	0	11	0.00003
SRR9677918_1_kneaddata_paired	Firmicutes_C	17613	P	5	0	5	0.00001
SRR9677918_1_kneaddata_paired	Firmicutes_I	18140	P	5	0	5	0.00001
SRR9677918_1_kneaddata_paired	Elusimicrobiota	11888	P	2	0	2	0.00001
SRR9677919_1_kneaddata_paired	Firmicutes_A	14608	P	2262778	17072	2279850	0.51890
SRR9677919_1_kneaddata_paired	Bacteroidota	4587	P	1946499	18812	1965311	0.44731
SRR9677919_1_kneaddata_paired	Deferribacterota	10822	P	59259	358	59617	0.01357
SRR9677919_1_kneaddata_paired	Firmicutes	12188	P	42590	921	43511	0.00990
SRR9677919_1_kneaddata_paired	Desulfobacterota_A	11509	P	26926	160	27086	0.00616
SRR9677919_1_kneaddata_paired	Proteobacteria	22518	P	8907	33	8940	0.00203
SRR9677919_1_kneaddata_paired	Cyanobacteria	9876	P	5856	70	5926	0.00135
SRR9677919_1_kneaddata_paired	Actinobacteriota	615	P	2359	32	2391	0.00054
SRR9677919_1_kneaddata_paired	Verrucomicrobiota	33333	P	300	9	309	0.00007
SRR9677919_1_kneaddata_paired	Spirochaetota	32587	P	290	0	290	0.00007
SRR9677919_1_kneaddata_paired	Firmicutes_B	17289	P	203	12	215	0.00005
SRR9677919_1_kneaddata_paired	Campylobacterota	8700	P	86	0	86	0.00002
SRR9677919_1_kneaddata_paired	Firmicutes_C	17613	P	46	0	46	0.00001
SRR9677919_1_kneaddata_paired	Firmicutes_I	18140	P	44	0	44	0.00001
SRR9677919_1_kneaddata_paired	Elusimicrobiota	11888	P	5	0	5	0.00000
SRR9677919_1_kneaddata_paired	Thermotogota	33086	P	2	0	2	0.00000
SRR9677920_1_kneaddata_paired	Bacteroidota	4587	P	3260885	22110	3282995	0.73332
SRR9677920_1_kneaddata_paired	Firmicutes_A	14608	P	1094458	9598	1104056	0.24661
SRR9677920_1_kneaddata_paired	Desulfobacterota_A	11509	P	42169	95	42264	0.00944
SRR9677920_1_kneaddata_paired	Firmicutes	12188	P	22582	333	22915	0.00512
SRR9677920_1_kneaddata_paired	Proteobacteria	22518	P	15981	48	16029	0.00358
SRR9677920_1_kneaddata_paired	Actinobacteriota	615	P	5212	54	5266	0.00118
SRR9677920_1_kneaddata_paired	Cyanobacteria	9876	P	1418	42	1460	0.00033
SRR9677920_1_kneaddata_paired	Deferribacterota	10822	P	1090	5	1095	0.00024
SRR9677920_1_kneaddata_paired	Verrucomicrobiota	33333	P	366	24	390	0.00009
SRR9677920_1_kneaddata_paired	Spirochaetota	32587	P	171	0	171	0.00004
SRR9677920_1_kneaddata_paired	Firmicutes_B	17289	P	117	5	122	0.00003
SRR9677920_1_kneaddata_paired	Campylobacterota	8700	P	53	0	53	0.00001
SRR9677920_1_kneaddata_paired	Firmicutes_C	17613	P	52	0	52	0.00001
SRR9677920_1_kneaddata_paired	Firmicutes_I	18140	P	26	0	26	0.00001
SRR9677920_1_kneaddata_paired	Elusimicrobiota	11888	P	4	0	4	0.00000
SRR9677921_1_kneaddata_paired	Bacteroidota	4587	P	2504440	22435	2526875	0.61950
SRR9677921_1_kneaddata_paired	Proteobacteria	22518	P	1344855	4774	1349629	0.33088
SRR9677921_1_kneaddata_paired	Firmicutes_A	14608	P	128982	1581	130563	0.03201
SRR9677921_1_kneaddata_paired	Firmicutes	12188	P	67041	1069	68110	0.01670
SRR9677921_1_kneaddata_paired	Desulfobacterota_A	11509	P	1233	10	1243	0.00030
SRR9677921_1_kneaddata_paired	Deferribacterota	10822	P	1146	4	1150	0.00028
SRR9677921_1_kneaddata_paired	Actinobacteriota	615	P	920	4	924	0.00023
SRR9677921_1_kneaddata_paired	Cyanobacteria	9876	P	321	6	327	0.00008
SRR9677921_1_kneaddata_paired	Firmicutes_B	17289	P	21	0	21	0.00001
SRR9677921_1_kneaddata_paired	Campylobacterota	8700	P	19	0	19	0.00000
SRR9677921_1_kneaddata_paired	Verrucomicrobiota	33333	P	16	0	16	0.00000
SRR9677921_1_kneaddata_paired	Spirochaetota	32587	P	9	0	9	0.00000
SRR9677921_1_kneaddata_paired	Firmicutes_I	18140	P	8	0	8	0.00000
SRR9677921_1_kneaddata_paired	Firmicutes_C	17613	P	5	0	5	0.00000
SRR9677922_1_kneaddata_paired	Firmicutes_A	14608	P	2983326	17452	3000778	0.65551
SRR9677922_1_kneaddata_paired	Bacteroidota	4587	P	1504896	12521	1517417	0.33147
SRR9677922_1_kneaddata_paired	Firmicutes	12188	P	25027	907	25934	0.00567
SRR9677922_1_kneaddata_paired	Desulfobacterota_A	11509	P	21712	156	21868	0.00478
SRR9677922_1_kneaddata_paired	Cyanobacteria	9876	P	4849	63	4912	0.00107
SRR9677922_1_kneaddata_paired	Proteobacteria	22518	P	4628	13	4641	0.00101
SRR9677922_1_kneaddata_paired	Actinobacteriota	615	P	1166	5	1171	0.00026
SRR9677922_1_kneaddata_paired	Deferribacterota	10822	P	388	0	388	0.00008
SRR9677922_1_kneaddata_paired	Firmicutes_B	17289	P	229	10	239	0.00005
SRR9677922_1_kneaddata_paired	Verrucomicrobiota	33333	P	145	5	150	0.00003
SRR9677922_1_kneaddata_paired	Spirochaetota	32587	P	141	0	141	0.00003
SRR9677922_1_kneaddata_paired	Campylobacterota	8700	P	66	0	66	0.00001
SRR9677922_1_kneaddata_paired	Firmicutes_I	18140	P	46	0	46	0.00001
SRR9677922_1_kneaddata_paired	Firmicutes_C	17613	P	32	0	32	0.00001
SRR9677922_1_kneaddata_paired	Elusimicrobiota	11888	P	9	0	9	0.00000
SRR9677922_1_kneaddata_paired	Thermotogota	33086	P	4	0	4	0.00000
SRR9677923_1_kneaddata_paired	Bacteroidota	4587	P	2790451	22695	2813146	0.71605
SRR9677923_1_kneaddata_paired	Firmicutes_A	14608	P	1037464	8614	1046078	0.26627
SRR9677923_1_kneaddata_paired	Firmicutes	12188	P	38066	384	38450	0.00979
SRR9677923_1_kneaddata_paired	Proteobacteria	22518	P	20694	21	20715	0.00527
SRR9677923_1_kneaddata_paired	Desulfobacterota_A	11509	P	4505	34	4539	0.00116
SRR9677923_1_kneaddata_paired	Deferribacterota	10822	P	1937	7	1944	0.00049
SRR9677923_1_kneaddata_paired	Cyanobacteria	9876	P	1767	29	1796	0.00046
SRR9677923_1_kneaddata_paired	Actinobacteriota	615	P	1766	7	1773	0.00045
SRR9677923_1_kneaddata_paired	Spirochaetota	32587	P	77	0	77	0.00002
SRR9677923_1_kneaddata_paired	Firmicutes_B	17289	P	73	2	75	0.00002
SRR9677923_1_kneaddata_paired	Verrucomicrobiota	33333	P	60	2	62	0.00002
SRR9677923_1_kneaddata_paired	Campylobacterota	8700	P	34	0	34	0.00001
SRR9677923_1_kneaddata_paired	Firmicutes_I	18140	P	9	0	9	0.00000
SRR9677923_1_kneaddata_paired	Firmicutes_C	17613	P	4	0	4	0.00000
SRR9677923_1_kneaddata_paired	Elusimicrobiota	11888	P	3	0	3	0.00000
SRR9677923_1_kneaddata_paired	Thermotogota	33086	P	1	0	1	0.00000
SRR9677924_1_kneaddata_paired	Firmicutes_A	14608	P	3525853	21362	3547215	0.78879
SRR9677924_1_kneaddata_paired	Bacteroidota	4587	P	808022	5996	814018	0.18101
SRR9677924_1_kneaddata_paired	Desulfobacterota_A	11509	P	45771	128	45899	0.01021
SRR9677924_1_kneaddata_paired	Deferribacterota	10822	P	41798	157	41955	0.00933
SRR9677924_1_kneaddata_paired	Firmicutes	12188	P	38805	1588	40393	0.00898
SRR9677924_1_kneaddata_paired	Proteobacteria	22518	P	2708	5	2713	0.00060
SRR9677924_1_kneaddata_paired	Cyanobacteria	9876	P	2472	15	2487	0.00055
SRR9677924_1_kneaddata_paired	Actinobacteriota	615	P	1428	5	1433	0.00032
SRR9677924_1_kneaddata_paired	Spirochaetota	32587	P	337	0	337	0.00008
SRR9677924_1_kneaddata_paired	Firmicutes_B	17289	P	200	7	207	0.00005
SRR9677924_1_kneaddata_paired	Verrucomicrobiota	33333	P	141	4	145	0.00003
SRR9677924_1_kneaddata_paired	Thermotogota	33086	P	70	0	70	0.00002
SRR9677924_1_kneaddata_paired	Campylobacterota	8700	P	53	0	53	0.00001
SRR9677924_1_kneaddata_paired	Firmicutes_C	17613	P	39	0	39	0.00001
SRR9677924_1_kneaddata_paired	Firmicutes_I	18140	P	37	0	37	0.00001
SRR9677924_1_kneaddata_paired	Elusimicrobiota	11888	P	2	0	2	0.00000
SRR9677925_1_kneaddata_paired	Bacteroidota	4587	P	2406640	25749	2432389	0.71052
SRR9677925_1_kneaddata_paired	Firmicutes_A	14608	P	487980	4591	492571	0.14388
SRR9677925_1_kneaddata_paired	Firmicutes	12188	P	263673	2034	265707	0.07762
SRR9677925_1_kneaddata_paired	Proteobacteria	22518	P	167686	473	168159	0.04912
SRR9677925_1_kneaddata_paired	Actinobacteriota	615	P	40189	119	40308	0.01177
SRR9677925_1_kneaddata_paired	Desulfobacterota_A	11509	P	17385	133	17518	0.00512
SRR9677925_1_kneaddata_paired	Verrucomicrobiota	33333	P	3506	285	3791	0.00111
SRR9677925_1_kneaddata_paired	Cyanobacteria	9876	P	1588	59	1647	0.00048
SRR9677925_1_kneaddata_paired	Deferribacterota	10822	P	801	3	804	0.00024
SRR9677925_1_kneaddata_paired	Firmicutes_B	17289	P	173	9	182	0.00005
SRR9677925_1_kneaddata_paired	Campylobacterota	8700	P	135	0	135	0.00004
SRR9677925_1_kneaddata_paired	Spirochaetota	32587	P	92	0	92	0.00003
SRR9677925_1_kneaddata_paired	Firmicutes_C	17613	P	32	0	32	0.00001
SRR9677925_1_kneaddata_paired	Firmicutes_I	18140	P	26	0	26	0.00001
SRR9677925_1_kneaddata_paired	Thermotogota	33086	P	5	0	5	0.00000
SRR9677925_1_kneaddata_paired	Elusimicrobiota	11888	P	3	0	3	0.00000
SRR9677926_1_kneaddata_paired	Bacteroidota	4587	P	2278986	21059	2300045	0.80787
SRR9677926_1_kneaddata_paired	Firmicutes_A	14608	P	430909	4564	435473	0.15296
SRR9677926_1_kneaddata_paired	Proteobacteria	22518	P	39437	438	39875	0.01401
SRR9677926_1_kneaddata_paired	Firmicutes	12188	P	31898	475	32373	0.01137
SRR9677926_1_kneaddata_paired	Desulfobacterota_A	11509	P	18973	105	19078	0.00670
SRR9677926_1_kneaddata_paired	Actinobacteriota	615	P	18642	139	18781	0.00660
SRR9677926_1_kneaddata_paired	Cyanobacteria	9876	P	851	28	879	0.00031
SRR9677926_1_kneaddata_paired	Deferribacterota	10822	P	250	0	250	0.00009
SRR9677926_1_kneaddata_paired	Firmicutes_B	17289	P	120	5	125	0.00004
SRR9677926_1_kneaddata_paired	Spirochaetota	32587	P	50	0	50	0.00002
SRR9677926_1_kneaddata_paired	Campylobacterota	8700	P	45	0	45	0.00002
SRR9677926_1_kneaddata_paired	Verrucomicrobiota	33333	P	31	1	32	0.00001
SRR9677926_1_kneaddata_paired	Firmicutes_C	17613	P	24	0	24	0.00001
SRR9677926_1_kneaddata_paired	Firmicutes_I	18140	P	16	0	16	0.00001
SRR9677926_1_kneaddata_paired	Elusimicrobiota	11888	P	4	0	4	0.00000
SRR9677926_1_kneaddata_paired	Thermotogota	33086	P	3	0	3	0.00000
SRR9677927_1_kneaddata_paired	Bacteroidota	4587	P	1371894	11331	1383225	0.62806
SRR9677927_1_kneaddata_paired	Proteobacteria	22518	P	669737	2701	672438	0.30532
SRR9677927_1_kneaddata_paired	Firmicutes_A	14608	P	111340	965	112305	0.05099
SRR9677927_1_kneaddata_paired	Firmicutes	12188	P	23358	211	23569	0.01070
SRR9677927_1_kneaddata_paired	Deferribacterota	10822	P	5828	23	5851	0.00266
SRR9677927_1_kneaddata_paired	Desulfobacterota_A	11509	P	3530	21	3551	0.00161
SRR9677927_1_kneaddata_paired	Actinobacteriota	615	P	1096	4	1100	0.00050
SRR9677927_1_kneaddata_paired	Cyanobacteria	9876	P	276	4	280	0.00013
SRR9677927_1_kneaddata_paired	Verrucomicrobiota	33333	P	33	0	33	0.00002
SRR9677927_1_kneaddata_paired	Spirochaetota	32587	P	18	0	18	0.00001
SRR9677927_1_kneaddata_paired	Campylobacterota	8700	P	9	0	9	0.00000
SRR9677927_1_kneaddata_paired	Firmicutes_I	18140	P	3	0	3	0.00000
SRR9677927_1_kneaddata_paired	Elusimicrobiota	11888	P	1	0	1	0.00000
SRR9677927_1_kneaddata_paired	Firmicutes_B	17289	P	1	0	1	0.00000
SRR9677928_1_kneaddata_paired	Bacteroidota	4587	P	1982830	16994	1999824	0.59303
SRR9677928_1_kneaddata_paired	Proteobacteria	22518	P	691937	2422	694359	0.20590
SRR9677928_1_kneaddata_paired	Firmicutes_A	14608	P	493408	4015	497423	0.14751
SRR9677928_1_kneaddata_paired	Firmicutes	12188	P	153764	632	154396	0.04578
SRR9677928_1_kneaddata_paired	Cyanobacteria	9876	P	14161	66	14227	0.00422
SRR9677928_1_kneaddata_paired	Deferribacterota	10822	P	7999	29	8028	0.00238
SRR9677928_1_kneaddata_paired	Desulfobacterota_A	11509	P	2502	21	2523	0.00075
SRR9677928_1_kneaddata_paired	Actinobacteriota	615	P	1203	4	1207	0.00036
SRR9677928_1_kneaddata_paired	Campylobacterota	8700	P	100	0	100	0.00003
SRR9677928_1_kneaddata_paired	Firmicutes_B	17289	P	50	1	51	0.00002
SRR9677928_1_kneaddata_paired	Verrucomicrobiota	33333	P	40	1	41	0.00001
SRR9677928_1_kneaddata_paired	Spirochaetota	32587	P	31	0	31	0.00001
SRR9677928_1_kneaddata_paired	Firmicutes_I	18140	P	11	0	11	0.00000
SRR9677928_1_kneaddata_paired	Firmicutes_C	17613	P	10	0	10	0.00000
SRR9677928_1_kneaddata_paired	Thermotogota	33086	P	1	0	1	0.00000
SRR9677929_1_kneaddata_paired	Firmicutes_A	14608	P	2462977	16084	2479061	0.49434
SRR9677929_1_kneaddata_paired	Bacteroidota	4587	P	2438371	19191	2457562	0.49005
SRR9677929_1_kneaddata_paired	Firmicutes	12188	P	44524	511	45035	0.00898
SRR9677929_1_kneaddata_paired	Desulfobacterota_A	11509	P	13508	35	13543	0.00270
SRR9677929_1_kneaddata_paired	Proteobacteria	22518	P	12687	18	12705	0.00253
SRR9677929_1_kneaddata_paired	Deferribacterota	10822	P	3093	10	3103	0.00062
SRR9677929_1_kneaddata_paired	Actinobacteriota	615	P	2869	12	2881	0.00057
SRR9677929_1_kneaddata_paired	Cyanobacteria	9876	P	688	14	702	0.00014
SRR9677929_1_kneaddata_paired	Verrucomicrobiota	33333	P	84	2	86	0.00002
SRR9677929_1_kneaddata_paired	Firmicutes_B	17289	P	83	2	85	0.00002
SRR9677929_1_kneaddata_paired	Campylobacterota	8700	P	59	0	59	0.00001
SRR9677929_1_kneaddata_paired	Spirochaetota	32587	P	27	0	27	0.00001
SRR9677929_1_kneaddata_paired	Firmicutes_C	17613	P	25	0	25	0.00000
SRR9677929_1_kneaddata_paired	Firmicutes_I	18140	P	9	0	9	0.00000
SRR9677929_1_kneaddata_paired	Elusimicrobiota	11888	P	3	0	3	0.00000
SRR9677929_1_kneaddata_paired	Thermotogota	33086	P	3	0	3	0.00000
SRR9677930_1_kneaddata_paired	Firmicutes_A	14608	P	2456847	16192	2473039	0.51691
SRR9677930_1_kneaddata_paired	Bacteroidota	4587	P	2228686	17823	2246509	0.46956
SRR9677930_1_kneaddata_paired	Firmicutes	12188	P	29336	435	29771	0.00622
SRR9677930_1_kneaddata_paired	Desulfobacterota_A	11509	P	13583	60	13643	0.00285
SRR9677930_1_kneaddata_paired	Proteobacteria	22518	P	11944	14	11958	0.00250
SRR9677930_1_kneaddata_paired	Deferribacterota	10822	P	5571	20	5591	0.00117
SRR9677930_1_kneaddata_paired	Actinobacteriota	615	P	2568	10	2578	0.00054
SRR9677930_1_kneaddata_paired	Cyanobacteria	9876	P	810	13	823	0.00017
SRR9677930_1_kneaddata_paired	Firmicutes_B	17289	P	124	4	128	0.00003
SRR9677930_1_kneaddata_paired	Verrucomicrobiota	33333	P	94	3	97	0.00002
SRR9677930_1_kneaddata_paired	Campylobacterota	8700	P	49	0	49	0.00001
SRR9677930_1_kneaddata_paired	Spirochaetota	32587	P	42	0	42	0.00001
SRR9677930_1_kneaddata_paired	Firmicutes_C	17613	P	19	0	19	0.00000
SRR9677930_1_kneaddata_paired	Firmicutes_I	18140	P	17	0	17	0.00000
SRR9677930_1_kneaddata_paired	Thermotogota	33086	P	3	0	3	0.00000
SRR9677931_1_kneaddata_paired	Bacteroidota	4587	P	4454587	31352	4485939	0.88830
SRR9677931_1_kneaddata_paired	Firmicutes_A	14608	P	412401	5285	417686	0.08271
SRR9677931_1_kneaddata_paired	Firmicutes	12188	P	105928	1062	106990	0.02119
SRR9677931_1_kneaddata_paired	Proteobacteria	22518	P	20639	80	20719	0.00410
SRR9677931_1_kneaddata_paired	Actinobacteriota	615	P	9201	76	9277	0.00184
SRR9677931_1_kneaddata_paired	Desulfobacterota_A	11509	P	3653	43	3696	0.00073
SRR9677931_1_kneaddata_paired	Cyanobacteria	9876	P	2778	159	2937	0.00058
SRR9677931_1_kneaddata_paired	Deferribacterota	10822	P	1782	9	1791	0.00035
SRR9677931_1_kneaddata_paired	Verrucomicrobiota	33333	P	487	37	524	0.00010
SRR9677931_1_kneaddata_paired	Campylobacterota	8700	P	196	0	196	0.00004
SRR9677931_1_kneaddata_paired	Firmicutes_B	17289	P	126	6	132	0.00003
SRR9677931_1_kneaddata_paired	Spirochaetota	32587	P	74	0	74	0.00001
SRR9677931_1_kneaddata_paired	Firmicutes_I	18140	P	35	0	35	0.00001
SRR9677931_1_kneaddata_paired	Firmicutes_C	17613	P	13	0	13	0.00000
SRR9677931_1_kneaddata_paired	Elusimicrobiota	11888	P	3	0	3	0.00000
SRR9677931_1_kneaddata_paired	Thermotogota	33086	P	2	0	2	0.00000
SRR9677932_1_kneaddata_paired	Bacteroidota	4587	P	2605053	21178	2626231	0.74014
SRR9677932_1_kneaddata_paired	Firmicutes_A	14608	P	779774	6854	786628	0.22169
SRR9677932_1_kneaddata_paired	Firmicutes	12188	P	101870	1203	103073	0.02905
SRR9677932_1_kneaddata_paired	Cyanobacteria	9876	P	8279	712	8991	0.00253
SRR9677932_1_kneaddata_paired	Desulfobacterota_A	11509	P	7926	119	8045	0.00227
SRR9677932_1_kneaddata_paired	Proteobacteria	22518	P	6710	38	6748	0.00190
SRR9677932_1_kneaddata_paired	Actinobacteriota	615	P	3928	50	3978	0.00112
SRR9677932_1_kneaddata_paired	Deferribacterota	10822	P	2502	15	2517	0.00071
SRR9677932_1_kneaddata_paired	Verrucomicrobiota	33333	P	1066	100	1166	0.00033
SRR9677932_1_kneaddata_paired	Firmicutes_B	17289	P	335	21	356	0.00010
SRR9677932_1_kneaddata_paired	Campylobacterota	8700	P	258	0	258	0.00007
SRR9677932_1_kneaddata_paired	Spirochaetota	32587	P	158	0	158	0.00004
SRR9677932_1_kneaddata_paired	Firmicutes_I	18140	P	69	0	69	0.00002
SRR9677932_1_kneaddata_paired	Firmicutes_C	17613	P	31	0	31	0.00001
SRR9677932_1_kneaddata_paired	Thermotogota	33086	P	8	0	8	0.00000
SRR9677932_1_kneaddata_paired	Elusimicrobiota	11888	P	4	0	4	0.00000
SRR9677933_1_kneaddata_paired	Firmicutes_A	14608	P	2950917	19389	2970306	0.47664
SRR9677933_1_kneaddata_paired	Bacteroidota	4587	P	2809643	16748	2826391	0.45354
SRR9677933_1_kneaddata_paired	Firmicutes	12188	P	189577	3981	193558	0.03106
SRR9677933_1_kneaddata_paired	Desulfobacterota_A	11509	P	177234	189	177423	0.02847
SRR9677933_1_kneaddata_paired	Actinobacteriota	615	P	37619	117	37736	0.00606
SRR9677933_1_kneaddata_paired	Proteobacteria	22518	P	12098	15	12113	0.00194
SRR9677933_1_kneaddata_paired	Deferribacterota	10822	P	11519	39	11558	0.00185
SRR9677933_1_kneaddata_paired	Cyanobacteria	9876	P	1832	30	1862	0.00030
SRR9677933_1_kneaddata_paired	Spirochaetota	32587	P	302	0	302	0.00005
SRR9677933_1_kneaddata_paired	Verrucomicrobiota	33333	P	191	9	200	0.00003
SRR9677933_1_kneaddata_paired	Firmicutes_B	17289	P	178	5	183	0.00003
SRR9677933_1_kneaddata_paired	Campylobacterota	8700	P	111	0	111	0.00002
SRR9677933_1_kneaddata_paired	Firmicutes_I	18140	P	36	0	36	0.00001
SRR9677933_1_kneaddata_paired	Firmicutes_C	17613	P	34	0	34	0.00001
SRR9677933_1_kneaddata_paired	Elusimicrobiota	11888	P	7	0	7	0.00000
SRR9677933_1_kneaddata_paired	Thermotogota	33086	P	1	0	1	0.00000
SRR9677934_1_kneaddata_paired	Bacteroidota	4587	P	3496411	27124	3523535	0.88696
SRR9677934_1_kneaddata_paired	Firmicutes_A	14608	P	377749	5240	382989	0.09641
SRR9677934_1_kneaddata_paired	Firmicutes	12188	P	27742	461	28203	0.00710
SRR9677934_1_kneaddata_paired	Proteobacteria	22518	P	23454	68	23522	0.00592
SRR9677934_1_kneaddata_paired	Desulfobacterota_A	11509	P	7223	18	7241	0.00182
SRR9677934_1_kneaddata_paired	Actinobacteriota	615	P	3454	18	3472	0.00087
SRR9677934_1_kneaddata_paired	Cyanobacteria	9876	P	2810	133	2943	0.00074
SRR9677934_1_kneaddata_paired	Deferribacterota	10822	P	448	2	450	0.00011
SRR9677934_1_kneaddata_paired	Spirochaetota	32587	P	87	0	87	0.00002
SRR9677934_1_kneaddata_paired	Firmicutes_B	17289	P	36	1	37	0.00001
SRR9677934_1_kneaddata_paired	Campylobacterota	8700	P	34	0	34	0.00001
SRR9677934_1_kneaddata_paired	Verrucomicrobiota	33333	P	26	0	26	0.00001
SRR9677934_1_kneaddata_paired	Firmicutes_I	18140	P	19	0	19	0.00000
SRR9677934_1_kneaddata_paired	Firmicutes_C	17613	P	17	0	17	0.00000
SRR9677934_1_kneaddata_paired	Thermotogota	33086	P	3	0	3	0.00000
SRR9677934_1_kneaddata_paired	Elusimicrobiota	11888	P	2	0	2	0.00000
SRR9677935_1_kneaddata_paired	Bacteroidota	4587	P	2339657	11774	2351431	0.61503
SRR9677935_1_kneaddata_paired	Firmicutes_A	14608	P	1264357	8664	1273021	0.33297
SRR9677935_1_kneaddata_paired	Firmicutes	12188	P	112109	1347	113456	0.02968
SRR9677935_1_kneaddata_paired	Desulfobacterota_A	11509	P	48723	97	48820	0.01277
SRR9677935_1_kneaddata_paired	Deferribacterota	10822	P	19695	69	19764	0.00517
SRR9677935_1_kneaddata_paired	Actinobacteriota	615	P	9422	48	9470	0.00248
SRR9677935_1_kneaddata_paired	Proteobacteria	22518	P	5448	16	5464	0.00143
SRR9677935_1_kneaddata_paired	Cyanobacteria	9876	P	1356	18	1374	0.00036
SRR9677935_1_kneaddata_paired	Spirochaetota	32587	P	126	0	126	0.00003
SRR9677935_1_kneaddata_paired	Campylobacterota	8700	P	123	0	123	0.00003
SRR9677935_1_kneaddata_paired	Verrucomicrobiota	33333	P	61	2	63	0.00002
SRR9677935_1_kneaddata_paired	Firmicutes_B	17289	P	57	1	58	0.00002
SRR9677935_1_kneaddata_paired	Thermotogota	33086	P	32	0	32	0.00001
SRR9677935_1_kneaddata_paired	Firmicutes_C	17613	P	22	0	22	0.00001
SRR9677935_1_kneaddata_paired	Firmicutes_I	18140	P	20	0	20	0.00001
SRR9677935_1_kneaddata_paired	Elusimicrobiota	11888	P	6	0	6	0.00000
SRR9677936_1_kneaddata_paired	Bacteroidota	4587	P	3977471	24027	4001498	0.90132
SRR9677936_1_kneaddata_paired	Firmicutes_A	14608	P	368206	6160	374366	0.08432
SRR9677936_1_kneaddata_paired	Firmicutes	12188	P	31696	510	32206	0.00725
SRR9677936_1_kneaddata_paired	Proteobacteria	22518	P	22578	36	22614	0.00509
SRR9677936_1_kneaddata_paired	Desulfobacterota_A	11509	P	3908	25	3933	0.00089
SRR9677936_1_kneaddata_paired	Actinobacteriota	615	P	2778	15	2793	0.00063
SRR9677936_1_kneaddata_paired	Cyanobacteria	9876	P	1477	24	1501	0.00034
SRR9677936_1_kneaddata_paired	Deferribacterota	10822	P	538	2	540	0.00012
SRR9677936_1_kneaddata_paired	Spirochaetota	32587	P	49	0	49	0.00001
SRR9677936_1_kneaddata_paired	Firmicutes_B	17289	P	46	2	48	0.00001
SRR9677936_1_kneaddata_paired	Verrucomicrobiota	33333	P	23	0	23	0.00001
SRR9677936_1_kneaddata_paired	Campylobacterota	8700	P	22	0	22	0.00000
SRR9677936_1_kneaddata_paired	Firmicutes_I	18140	P	8	0	8	0.00000
SRR9677936_1_kneaddata_paired	Firmicutes_C	17613	P	6	0	6	0.00000
SRR9677936_1_kneaddata_paired	Thermotogota	33086	P	1	0	1	0.00000
SRR9677937_1_kneaddata_paired	Firmicutes_A	14608	P	2994455	18215	3012670	0.54372
SRR9677937_1_kneaddata_paired	Bacteroidota	4587	P	2376706	13337	2390043	0.43135
SRR9677937_1_kneaddata_paired	Desulfobacterota_A	11509	P	59500	141	59641	0.01076
SRR9677937_1_kneaddata_paired	Firmicutes	12188	P	50947	756	51703	0.00933
SRR9677937_1_kneaddata_paired	Proteobacteria	22518	P	8852	16	8868	0.00160
SRR9677937_1_kneaddata_paired	Verrucomicrobiota	33333	P	7282	427	7709	0.00139
SRR9677937_1_kneaddata_paired	Cyanobacteria	9876	P	4621	261	4882	0.00088
SRR9677937_1_kneaddata_paired	Actinobacteriota	615	P	4181	24	4205	0.00076
SRR9677937_1_kneaddata_paired	Spirochaetota	32587	P	472	0	472	0.00009
SRR9677937_1_kneaddata_paired	Firmicutes_B	17289	P	261	9	270	0.00005
SRR9677937_1_kneaddata_paired	Campylobacterota	8700	P	118	0	118	0.00002
SRR9677937_1_kneaddata_paired	Deferribacterota	10822	P	81	0	81	0.00001
SRR9677937_1_kneaddata_paired	Firmicutes_I	18140	P	64	0	64	0.00001
SRR9677937_1_kneaddata_paired	Firmicutes_C	17613	P	62	0	62	0.00001
SRR9677937_1_kneaddata_paired	Thermotogota	33086	P	4	0	4	0.00000
SRR9677937_1_kneaddata_paired	Elusimicrobiota	11888	P	3	0	3	0.00000
SRR9677938_1_kneaddata_paired	Bacteroidota	4587	P	3179656	19734	3199390	0.74346
SRR9677938_1_kneaddata_paired	Firmicutes_A	14608	P	933163	8047	941210	0.21872
SRR9677938_1_kneaddata_paired	Firmicutes	12188	P	59824	673	60497	0.01406
SRR9677938_1_kneaddata_paired	Desulfobacterota_A	11509	P	57377	79	57456	0.01335
SRR9677938_1_kneaddata_paired	Actinobacteriota	615	P	14205	194	14399	0.00335
SRR9677938_1_kneaddata_paired	Proteobacteria	22518	P	12438	20	12458	0.00290
SRR9677938_1_kneaddata_paired	Verrucomicrobiota	33333	P	9720	620	10340	0.00240
SRR9677938_1_kneaddata_paired	Cyanobacteria	9876	P	6435	413	6848	0.00159
SRR9677938_1_kneaddata_paired	Spirochaetota	32587	P	465	0	465	0.00011
SRR9677938_1_kneaddata_paired	Campylobacterota	8700	P	110	0	110	0.00003
SRR9677938_1_kneaddata_paired	Deferribacterota	10822	P	60	0	60	0.00001
SRR9677938_1_kneaddata_paired	Firmicutes_B	17289	P	47	1	48	0.00001
SRR9677938_1_kneaddata_paired	Firmicutes_C	17613	P	42	0	42	0.00001
SRR9677938_1_kneaddata_paired	Firmicutes_I	18140	P	20	0	20	0.00000
SRR9677938_1_kneaddata_paired	Elusimicrobiota	11888	P	3	0	3	0.00000
SRR9677938_1_kneaddata_paired	Thermotogota	33086	P	3	0	3	0.00000
SRR9677939_1_kneaddata_paired	Bacteroidota	4587	P	3340185	25666	3365851	0.61698
SRR9677939_1_kneaddata_paired	Firmicutes_A	14608	P	1991624	16802	2008426	0.36815
SRR9677939_1_kneaddata_paired	Desulfobacterota_A	11509	P	38330	112	38442	0.00705
SRR9677939_1_kneaddata_paired	Firmicutes	12188	P	22883	421	23304	0.00427
SRR9677939_1_kneaddata_paired	Proteobacteria	22518	P	12849	25	12874	0.00236
SRR9677939_1_kneaddata_paired	Actinobacteriota	615	P	3792	23	3815	0.00070
SRR9677939_1_kneaddata_paired	Deferribacterota	10822	P	1170	5	1175	0.00022
SRR9677939_1_kneaddata_paired	Cyanobacteria	9876	P	910	15	925	0.00017
SRR9677939_1_kneaddata_paired	Spirochaetota	32587	P	259	0	259	0.00005
SRR9677939_1_kneaddata_paired	Verrucomicrobiota	33333	P	125	5	130	0.00002
SRR9677939_1_kneaddata_paired	Firmicutes_B	17289	P	107	5	112	0.00002
SRR9677939_1_kneaddata_paired	Firmicutes_C	17613	P	32	0	32	0.00001
SRR9677939_1_kneaddata_paired	Campylobacterota	8700	P	27	0	27	0.00000
SRR9677939_1_kneaddata_paired	Firmicutes_I	18140	P	20	0	20	0.00000
SRR9677940_1_kneaddata_paired	Firmicutes_A	14608	P	1935630	16882	1952512	0.51549
SRR9677940_1_kneaddata_paired	Bacteroidota	4587	P	1751663	14758	1766421	0.46636
SRR9677940_1_kneaddata_paired	Firmicutes	12188	P	26302	454	26756	0.00706
SRR9677940_1_kneaddata_paired	Proteobacteria	22518	P	23914	40	23954	0.00632
SRR9677940_1_kneaddata_paired	Desulfobacterota_A	11509	P	7999	87	8086	0.00214
SRR9677940_1_kneaddata_paired	Cyanobacteria	9876	P	5695	47	5742	0.00152
SRR9677940_1_kneaddata_paired	Actinobacteriota	615	P	2063	15	2078	0.00055
SRR9677940_1_kneaddata_paired	Deferribacterota	10822	P	1738	7	1745	0.00046
SRR9677940_1_kneaddata_paired	Firmicutes_B	17289	P	163	7	170	0.00004
SRR9677940_1_kneaddata_paired	Verrucomicrobiota	33333	P	74	4	78	0.00002
SRR9677940_1_kneaddata_paired	Spirochaetota	32587	P	51	0	51	0.00001
SRR9677940_1_kneaddata_paired	Campylobacterota	8700	P	32	0	32	0.00001
SRR9677940_1_kneaddata_paired	Firmicutes_C	17613	P	27	0	27	0.00001
SRR9677940_1_kneaddata_paired	Firmicutes_I	18140	P	14	0	14	0.00000
SRR9677940_1_kneaddata_paired	Elusimicrobiota	11888	P	2	0	2	0.00000
SRR9677940_1_kneaddata_paired	Thermotogota	33086	P	1	0	1	0.00000
SRR9677941_1_kneaddata_paired	Bacteroidota	4587	P	4079845	32100	4111945	0.67403
SRR9677941_1_kneaddata_paired	Firmicutes_A	14608	P	1817102	14870	1831972	0.30030
SRR9677941_1_kneaddata_paired	Desulfobacterota_A	11509	P	71080	240	71320	0.01169
SRR9677941_1_kneaddata_paired	Firmicutes	12188	P	45426	1106	46532	0.00763
SRR9677941_1_kneaddata_paired	Proteobacteria	22518	P	20209	167	20376	0.00334
SRR9677941_1_kneaddata_paired	Actinobacteriota	615	P	8554	68	8622	0.00141
SRR9677941_1_kneaddata_paired	Verrucomicrobiota	33333	P	4720	453	5173	0.00085
SRR9677941_1_kneaddata_paired	Cyanobacteria	9876	P	3666	119	3785	0.00062
SRR9677941_1_kneaddata_paired	Spirochaetota	32587	P	333	0	333	0.00005
SRR9677941_1_kneaddata_paired	Firmicutes_B	17289	P	233	14	247	0.00004
SRR9677941_1_kneaddata_paired	Campylobacterota	8700	P	89	0	89	0.00001
SRR9677941_1_kneaddata_paired	Deferribacterota	10822	P	85	0	85	0.00001
SRR9677941_1_kneaddata_paired	Firmicutes_C	17613	P	44	0	44	0.00001
SRR9677941_1_kneaddata_paired	Firmicutes_I	18140	P	29	0	29	0.00000
SRR9677941_1_kneaddata_paired	Thermotogota	33086	P	7	0	7	0.00000
SRR9677941_1_kneaddata_paired	Elusimicrobiota	11888	P	1	0	1	0.00000
SRR9677942_1_kneaddata_paired	Bacteroidota	4587	P	2800191	17906	2818097	0.51890
SRR9677942_1_kneaddata_paired	Firmicutes_A	14608	P	2381338	20687	2402025	0.44229
SRR9677942_1_kneaddata_paired	Desulfobacterota_A	11509	P	92161	178	92339	0.01700
SRR9677942_1_kneaddata_paired	Verrucomicrobiota	33333	P	49860	3511	53371	0.00983
SRR9677942_1_kneaddata_paired	Firmicutes	12188	P	33996	1130	35126	0.00647
SRR9677942_1_kneaddata_paired	Proteobacteria	22518	P	17528	36	17564	0.00323
SRR9677942_1_kneaddata_paired	Actinobacteriota	615	P	9753	62	9815	0.00181
SRR9677942_1_kneaddata_paired	Cyanobacteria	9876	P	1394	38	1432	0.00026
SRR9677942_1_kneaddata_paired	Spirochaetota	32587	P	645	0	645	0.00012
SRR9677942_1_kneaddata_paired	Firmicutes_B	17289	P	230	10	240	0.00004
SRR9677942_1_kneaddata_paired	Campylobacterota	8700	P	106	0	106	0.00002
SRR9677942_1_kneaddata_paired	Firmicutes_C	17613	P	37	0	37	0.00001
SRR9677942_1_kneaddata_paired	Firmicutes_I	18140	P	32	0	32	0.00001
SRR9677942_1_kneaddata_paired	Thermotogota	33086	P	22	0	22	0.00000
SRR9677942_1_kneaddata_paired	Deferribacterota	10822	P	18	0	18	0.00000
SRR9677942_1_kneaddata_paired	Elusimicrobiota	11888	P	2	0	2	0.00000
SRR9677943_1_kneaddata_paired	Bacteroidota	4587	P	2093284	16529	2109813	0.48968
SRR9677943_1_kneaddata_paired	Firmicutes_A	14608	P	2006875	12608	2019483	0.46872
SRR9677943_1_kneaddata_paired	Desulfobacterota_A	11509	P	53709	216	53925	0.01252
SRR9677943_1_kneaddata_paired	Verrucomicrobiota	33333	P	46932	3421	50353	0.01169
SRR9677943_1_kneaddata_paired	Firmicutes	12188	P	38940	868	39808	0.00924
SRR9677943_1_kneaddata_paired	Proteobacteria	22518	P	12798	48	12846	0.00298
SRR9677943_1_kneaddata_paired	Cyanobacteria	9876	P	12333	137	12470	0.00289
SRR9677943_1_kneaddata_paired	Deferribacterota	10822	P	6825	32	6857	0.00159
SRR9677943_1_kneaddata_paired	Actinobacteriota	615	P	2359	15	2374	0.00055
SRR9677943_1_kneaddata_paired	Firmicutes_B	17289	P	217	10	227	0.00005
SRR9677943_1_kneaddata_paired	Spirochaetota	32587	P	187	0	187	0.00004
SRR9677943_1_kneaddata_paired	Campylobacterota	8700	P	105	0	105	0.00002
SRR9677943_1_kneaddata_paired	Firmicutes_I	18140	P	52	0	52	0.00001
SRR9677943_1_kneaddata_paired	Firmicutes_C	17613	P	36	0	36	0.00001
SRR9677943_1_kneaddata_paired	Elusimicrobiota	11888	P	8	0	8	0.00000
SRR9677943_1_kneaddata_paired	Thermotogota	33086	P	4	0	4	0.00000
SRR9677944_1_kneaddata_paired	Bacteroidota	4587	P	3418583	23923	3442506	0.77908
SRR9677944_1_kneaddata_paired	Firmicutes_A	14608	P	798859	7827	806686	0.18256
SRR9677944_1_kneaddata_paired	Firmicutes	12188	P	91066	824	91890	0.02080
SRR9677944_1_kneaddata_paired	Proteobacteria	22518	P	36862	209	37071	0.00839
SRR9677944_1_kneaddata_paired	Verrucomicrobiota	33333	P	24917	2162	27079	0.00613
SRR9677944_1_kneaddata_paired	Actinobacteriota	615	P	5063	43	5106	0.00116
SRR9677944_1_kneaddata_paired	Desulfobacterota_A	11509	P	3920	44	3964	0.00090
SRR9677944_1_kneaddata_paired	Cyanobacteria	9876	P	3510	142	3652	0.00083
SRR9677944_1_kneaddata_paired	Firmicutes_B	17289	P	234	13	247	0.00006
SRR9677944_1_kneaddata_paired	Campylobacterota	8700	P	150	0	150	0.00003
SRR9677944_1_kneaddata_paired	Spirochaetota	32587	P	129	0	129	0.00003
SRR9677944_1_kneaddata_paired	Deferribacterota	10822	P	89	0	89	0.00002
SRR9677944_1_kneaddata_paired	Firmicutes_I	18140	P	63	0	63	0.00001
SRR9677944_1_kneaddata_paired	Firmicutes_C	17613	P	42	0	42	0.00001
SRR9677944_1_kneaddata_paired	Thermotogota	33086	P	7	0	7	0.00000
SRR9677944_1_kneaddata_paired	Elusimicrobiota	11888	P	2	0	2	0.00000
SRR9677945_1_kneaddata_paired	Bacteroidota	4587	P	3130419	24974	3155393	0.51071
SRR9677945_1_kneaddata_paired	Firmicutes_A	14608	P	2902987	17229	2920216	0.47265
SRR9677945_1_kneaddata_paired	Desulfobacterota_A	11509	P	38926	69	38995	0.00631
SRR9677945_1_kneaddata_paired	Firmicutes	12188	P	32246	372	32618	0.00528
SRR9677945_1_kneaddata_paired	Proteobacteria	22518	P	14743	16	14759	0.00239
SRR9677945_1_kneaddata_paired	Actinobacteriota	615	P	8464	47	8511	0.00138
SRR9677945_1_kneaddata_paired	Deferribacterota	10822	P	3948	13	3961	0.00064
SRR9677945_1_kneaddata_paired	Verrucomicrobiota	33333	P	2779	42	2821	0.00046
SRR9677945_1_kneaddata_paired	Cyanobacteria	9876	P	740	13	753	0.00012
SRR9677945_1_kneaddata_paired	Firmicutes_B	17289	P	180	6	186	0.00003
SRR9677945_1_kneaddata_paired	Spirochaetota	32587	P	69	0	69	0.00001
SRR9677945_1_kneaddata_paired	Firmicutes_C	17613	P	45	0	45	0.00001
SRR9677945_1_kneaddata_paired	Campylobacterota	8700	P	33	0	33	0.00001
SRR9677945_1_kneaddata_paired	Firmicutes_I	18140	P	26	0	26	0.00000
SRR9677945_1_kneaddata_paired	Thermotogota	33086	P	6	0	6	0.00000
SRR9677945_1_kneaddata_paired	Elusimicrobiota	11888	P	1	0	1	0.00000
SRR9677946_1_kneaddata_paired	Bacteroidota	4587	P	3807424	31375	3838799	0.76724
SRR9677946_1_kneaddata_paired	Firmicutes_A	14608	P	1002516	10109	1012625	0.20239
SRR9677946_1_kneaddata_paired	Desulfobacterota_A	11509	P	82238	210	82448	0.01648
SRR9677946_1_kneaddata_paired	Firmicutes	12188	P	29847	518	30365	0.00607
SRR9677946_1_kneaddata_paired	Proteobacteria	22518	P	18094	57	18151	0.00363
SRR9677946_1_kneaddata_paired	Verrucomicrobiota	33333	P	11625	1028	12653	0.00253
SRR9677946_1_kneaddata_paired	Actinobacteriota	615	P	5191	50	5241	0.00105
SRR9677946_1_kneaddata_paired	Cyanobacteria	9876	P	1734	117	1851	0.00037
SRR9677946_1_kneaddata_paired	Deferribacterota	10822	P	469	2	471	0.00009
SRR9677946_1_kneaddata_paired	Spirochaetota	32587	P	469	0	469	0.00009
SRR9677946_1_kneaddata_paired	Firmicutes_B	17289	P	96	5	101	0.00002
SRR9677946_1_kneaddata_paired	Campylobacterota	8700	P	90	0	90	0.00002
SRR9677946_1_kneaddata_paired	Firmicutes_C	17613	P	52	0	52	0.00001
SRR9677946_1_kneaddata_paired	Firmicutes_I	18140	P	33	0	33	0.00001
SRR9677946_1_kneaddata_paired	Elusimicrobiota	11888	P	2	0	2	0.00000
SRR9677947_1_kneaddata_paired	Firmicutes_A	14608	P	2516067	18019	2534086	0.54642
SRR9677947_1_kneaddata_paired	Bacteroidota	4587	P	2020180	13057	2033237	0.43842
SRR9677947_1_kneaddata_paired	Firmicutes	12188	P	34226	406	34632	0.00747
SRR9677947_1_kneaddata_paired	Desulfobacterota_A	11509	P	17972	56	18028	0.00389
SRR9677947_1_kneaddata_paired	Proteobacteria	22518	P	7300	11	7311	0.00158
SRR9677947_1_kneaddata_paired	Deferribacterota	10822	P	6204	21	6225	0.00134
SRR9677947_1_kneaddata_paired	Cyanobacteria	9876	P	1908	33	1941	0.00042
SRR9677947_1_kneaddata_paired	Actinobacteriota	615	P	1835	8	1843	0.00040
SRR9677947_1_kneaddata_paired	Firmicutes_B	17289	P	140	4	144	0.00003
SRR9677947_1_kneaddata_paired	Verrucomicrobiota	33333	P	61	2	63	0.00001
SRR9677947_1_kneaddata_paired	Spirochaetota	32587	P	37	0	37	0.00001
SRR9677947_1_kneaddata_paired	Firmicutes_C	17613	P	36	0	36	0.00001
SRR9677947_1_kneaddata_paired	Campylobacterota	8700	P	34	0	34	0.00001
SRR9677947_1_kneaddata_paired	Firmicutes_I	18140	P	23	0	23	0.00000
SRR9677947_1_kneaddata_paired	Elusimicrobiota	11888	P	11	0	11	0.00000
SRR9677948_1_kneaddata_paired	Proteobacteria	22518	P	3355018	5098	3360116	0.86537
SRR9677948_1_kneaddata_paired	Bacteroidota	4587	P	475109	5434	480543	0.12376
SRR9677948_1_kneaddata_paired	Firmicutes	12188	P	24714	136	24850	0.00640
SRR9677948_1_kneaddata_paired	Firmicutes_A	14608	P	15807	133	15940	0.00411
SRR9677948_1_kneaddata_paired	Desulfobacterota_A	11509	P	679	1	680	0.00018
SRR9677948_1_kneaddata_paired	Actinobacteriota	615	P	432	0	432	0.00011
SRR9677948_1_kneaddata_paired	Cyanobacteria	9876	P	202	11	213	0.00005
SRR9677948_1_kneaddata_paired	Verrucomicrobiota	33333	P	85	0	85	0.00002
SRR9677948_1_kneaddata_paired	Campylobacterota	8700	P	11	0	11	0.00000
SRR9677948_1_kneaddata_paired	Deferribacterota	10822	P	5	0	5	0.00000
SRR9677948_1_kneaddata_paired	Spirochaetota	32587	P	1	0	1	0.00000
SRR9677949_1_kneaddata_paired	Bacteroidota	4587	P	3632054	40146	3672200	0.75412
SRR9677949_1_kneaddata_paired	Firmicutes_A	14608	P	908124	7714	915838	0.18808
SRR9677949_1_kneaddata_paired	Firmicutes	12188	P	158665	1709	160374	0.03293
SRR9677949_1_kneaddata_paired	Proteobacteria	22518	P	72104	195	72299	0.01485
SRR9677949_1_kneaddata_paired	Desulfobacterota_A	11509	P	34718	232	34950	0.00718
SRR9677949_1_kneaddata_paired	Actinobacteriota	615	P	8416	48	8464	0.00174
SRR9677949_1_kneaddata_paired	Cyanobacteria	9876	P	4638	80	4718	0.00097
SRR9677949_1_kneaddata_paired	Firmicutes_B	17289	P	185	9	194	0.00004
SRR9677949_1_kneaddata_paired	Deferribacterota	10822	P	127	0	127	0.00003
SRR9677949_1_kneaddata_paired	Campylobacterota	8700	P	112	0	112	0.00002
SRR9677949_1_kneaddata_paired	Spirochaetota	32587	P	95	0	95	0.00002
SRR9677949_1_kneaddata_paired	Verrucomicrobiota	33333	P	63	3	66	0.00001
SRR9677949_1_kneaddata_paired	Firmicutes_C	17613	P	37	0	37	0.00001
SRR9677949_1_kneaddata_paired	Firmicutes_I	18140	P	30	0	30	0.00001
SRR9677949_1_kneaddata_paired	Thermotogota	33086	P	5	0	5	0.00000
SRR9677949_1_kneaddata_paired	Elusimicrobiota	11888	P	2	0	2	0.00000
SRR9677950_1_kneaddata_paired	Bacteroidota	4587	P	2305866	32732	2338598	0.57620
SRR9677950_1_kneaddata_paired	Firmicutes_A	14608	P	942294	6327	948621	0.23373
SRR9677950_1_kneaddata_paired	Firmicutes	12188	P	426267	3118	429385	0.10580
SRR9677950_1_kneaddata_paired	Proteobacteria	22518	P	310215	578	310793	0.07658
SRR9677950_1_kneaddata_paired	Actinobacteriota	615	P	19004	44	19048	0.00469
SRR9677950_1_kneaddata_paired	Deferribacterota	10822	P	7701	35	7736	0.00191
SRR9677950_1_kneaddata_paired	Desulfobacterota_A	11509	P	2633	36	2669	0.00066
SRR9677950_1_kneaddata_paired	Cyanobacteria	9876	P	1372	64	1436	0.00035
SRR9677950_1_kneaddata_paired	Campylobacterota	8700	P	111	0	111	0.00003
SRR9677950_1_kneaddata_paired	Firmicutes_B	17289	P	94	4	98	0.00002
SRR9677950_1_kneaddata_paired	Spirochaetota	32587	P	55	0	55	0.00001
SRR9677950_1_kneaddata_paired	Verrucomicrobiota	33333	P	35	1	36	0.00001
SRR9677950_1_kneaddata_paired	Firmicutes_I	18140	P	24	0	24	0.00001
SRR9677950_1_kneaddata_paired	Firmicutes_C	17613	P	10	0	10	0.00000
SRR9677950_1_kneaddata_paired	Elusimicrobiota	11888	P	6	0	6	0.00000
SRR9677950_1_kneaddata_paired	Thermotogota	33086	P	1	0	1	0.00000
SRR9677951_1_kneaddata_paired	Firmicutes_A	14608	P	3747380	28671	3776051	0.58258
SRR9677951_1_kneaddata_paired	Bacteroidota	4587	P	2525667	16310	2541977	0.39218
SRR9677951_1_kneaddata_paired	Firmicutes	12188	P	120985	1192	122177	0.01885
SRR9677951_1_kneaddata_paired	Desulfobacterota_A	11509	P	18787	184	18971	0.00293
SRR9677951_1_kneaddata_paired	Proteobacteria	22518	P	13450	19	13469	0.00208
SRR9677951_1_kneaddata_paired	Actinobacteriota	615	P	5273	34	5307	0.00082
SRR9677951_1_kneaddata_paired	Cyanobacteria	9876	P	1430	32	1462	0.00023
SRR9677951_1_kneaddata_paired	Deferribacterota	10822	P	1113	4	1117	0.00017
SRR9677951_1_kneaddata_paired	Verrucomicrobiota	33333	P	440	13	453	0.00007
SRR9677951_1_kneaddata_paired	Firmicutes_B	17289	P	329	13	342	0.00005
SRR9677951_1_kneaddata_paired	Spirochaetota	32587	P	105	0	105	0.00002
SRR9677951_1_kneaddata_paired	Thermotogota	33086	P	71	0	71	0.00001
SRR9677951_1_kneaddata_paired	Campylobacterota	8700	P	60	0	60	0.00001
SRR9677951_1_kneaddata_paired	Firmicutes_C	17613	P	49	0	49	0.00001
SRR9677951_1_kneaddata_paired	Firmicutes_I	18140	P	16	0	16	0.00000
SRR9677951_1_kneaddata_paired	Elusimicrobiota	11888	P	9	0	9	0.00000
SRR9677952_1_kneaddata_paired	Bacteroidota	4587	P	1957974	18434	1976408	0.59444
SRR9677952_1_kneaddata_paired	Proteobacteria	22518	P	1214445	3481	1217926	0.36632
SRR9677952_1_kneaddata_paired	Firmicutes_A	14608	P	48009	695	48704	0.01465
SRR9677952_1_kneaddata_paired	Firmicutes	12188	P	43352	481	43833	0.01318
SRR9677952_1_kneaddata_paired	Verrucomicrobiota	33333	P	28199	336	28535	0.00858
SRR9677952_1_kneaddata_paired	Actinobacteriota	615	P	4953	5	4958	0.00149
SRR9677952_1_kneaddata_paired	Desulfobacterota_A	11509	P	2063	9	2072	0.00062
SRR9677952_1_kneaddata_paired	Cyanobacteria	9876	P	1360	52	1412	0.00042
SRR9677952_1_kneaddata_paired	Deferribacterota	10822	P	882	2	884	0.00027
SRR9677952_1_kneaddata_paired	Campylobacterota	8700	P	39	0	39	0.00001
SRR9677952_1_kneaddata_paired	Spirochaetota	32587	P	13	0	13	0.00000
SRR9677952_1_kneaddata_paired	Firmicutes_I	18140	P	5	0	5	0.00000
SRR9677952_1_kneaddata_paired	Firmicutes_B	17289	P	3	0	3	0.00000
SRR9677953_1_kneaddata_paired	Bacteroidota	4587	P	3003774	22886	3026660	0.54599
SRR9677953_1_kneaddata_paired	Proteobacteria	22518	P	2132561	7687	2140248	0.38608
SRR9677953_1_kneaddata_paired	Firmicutes_A	14608	P	313138	2997	316135	0.05703
SRR9677953_1_kneaddata_paired	Firmicutes	12188	P	49066	490	49556	0.00894
SRR9677953_1_kneaddata_paired	Desulfobacterota_A	11509	P	6334	38	6372	0.00115
SRR9677953_1_kneaddata_paired	Actinobacteriota	615	P	3120	9	3129	0.00056
SRR9677953_1_kneaddata_paired	Cyanobacteria	9876	P	661	14	675	0.00012
SRR9677953_1_kneaddata_paired	Deferribacterota	10822	P	372	1	373	0.00007
SRR9677953_1_kneaddata_paired	Verrucomicrobiota	33333	P	154	3	157	0.00003
SRR9677953_1_kneaddata_paired	Campylobacterota	8700	P	55	0	55	0.00001
SRR9677953_1_kneaddata_paired	Firmicutes_B	17289	P	44	1	45	0.00001
SRR9677953_1_kneaddata_paired	Spirochaetota	32587	P	22	0	22	0.00000
SRR9677953_1_kneaddata_paired	Firmicutes_I	18140	P	17	0	17	0.00000
SRR9677953_1_kneaddata_paired	Firmicutes_C	17613	P	13	0	13	0.00000
SRR9677953_1_kneaddata_paired	Elusimicrobiota	11888	P	3	0	3	0.00000
SRR9677953_1_kneaddata_paired	Thermotogota	33086	P	1	0	1	0.00000
SRR9677954_1_kneaddata_paired	Bacteroidota	4587	P	1052484	10308	1062792	0.60901
SRR9677954_1_kneaddata_paired	Proteobacteria	22518	P	522217	2026	524243	0.30041
SRR9677954_1_kneaddata_paired	Firmicutes_A	14608	P	113088	994	114082	0.06537
SRR9677954_1_kneaddata_paired	Firmicutes	12188	P	40185	281	40466	0.02319
SRR9677954_1_kneaddata_paired	Actinobacteriota	615	P	2479	4	2483	0.00142
SRR9677954_1_kneaddata_paired	Desulfobacterota_A	11509	P	488	8	496	0.00028
SRR9677954_1_kneaddata_paired	Deferribacterota	10822	P	247	1	248	0.00014
SRR9677954_1_kneaddata_paired	Cyanobacteria	9876	P	216	4	220	0.00013
SRR9677954_1_kneaddata_paired	Verrucomicrobiota	33333	P	58	0	58	0.00003
SRR9677954_1_kneaddata_paired	Campylobacterota	8700	P	9	0	9	0.00001
SRR9677954_1_kneaddata_paired	Spirochaetota	32587	P	8	0	8	0.00000
SRR9677954_1_kneaddata_paired	Firmicutes_I	18140	P	5	0	5	0.00000
SRR9677954_1_kneaddata_paired	Firmicutes_B	17289	P	4	0	4	0.00000
SRR9677954_1_kneaddata_paired	Firmicutes_C	17613	P	1	0	1	0.00000
SRR9677955_1_kneaddata_paired	Firmicutes_A	14608	P	3261322	21281	3282603	0.64564
SRR9677955_1_kneaddata_paired	Bacteroidota	4587	P	1694869	15556	1710425	0.33642
SRR9677955_1_kneaddata_paired	Desulfobacterota_A	11509	P	40735	263	40998	0.00806
SRR9677955_1_kneaddata_paired	Firmicutes	12188	P	32292	432	32724	0.00644
SRR9677955_1_kneaddata_paired	Proteobacteria	22518	P	11471	15	11486	0.00226
SRR9677955_1_kneaddata_paired	Actinobacteriota	615	P	3865	26	3891	0.00077
SRR9677955_1_kneaddata_paired	Cyanobacteria	9876	P	803	15	818	0.00016
SRR9677955_1_kneaddata_paired	Deferribacterota	10822	P	417	1	418	0.00008
SRR9677955_1_kneaddata_paired	Firmicutes_B	17289	P	330	13	343	0.00007
SRR9677955_1_kneaddata_paired	Verrucomicrobiota	33333	P	263	10	273	0.00005
SRR9677955_1_kneaddata_paired	Spirochaetota	32587	P	97	0	97	0.00002
SRR9677955_1_kneaddata_paired	Firmicutes_C	17613	P	56	0	56	0.00001
SRR9677955_1_kneaddata_paired	Campylobacterota	8700	P	48	0	48	0.00001
SRR9677955_1_kneaddata_paired	Thermotogota	33086	P	25	0	25	0.00000
SRR9677955_1_kneaddata_paired	Firmicutes_I	18140	P	21	0	21	0.00000
SRR9677955_1_kneaddata_paired	Elusimicrobiota	11888	P	7	0	7	0.00000
SRR9677956_1_kneaddata_paired	Firmicutes_A	14608	P	4090500	25333	4115833	0.84015
SRR9677956_1_kneaddata_paired	Bacteroidota	4587	P	638666	4120	642786	0.13121
SRR9677956_1_kneaddata_paired	Deferribacterota	10822	P	56076	229	56305	0.01149
SRR9677956_1_kneaddata_paired	Firmicutes	12188	P	43144	699	43843	0.00895
SRR9677956_1_kneaddata_paired	Desulfobacterota_A	11509	P	22508	215	22723	0.00464
SRR9677956_1_kneaddata_paired	Proteobacteria	22518	P	11987	20	12007	0.00245
SRR9677956_1_kneaddata_paired	Cyanobacteria	9876	P	2881	28	2909	0.00059
SRR9677956_1_kneaddata_paired	Actinobacteriota	615	P	1553	9	1562	0.00032
SRR9677956_1_kneaddata_paired	Verrucomicrobiota	33333	P	321	19	340	0.00007
SRR9677956_1_kneaddata_paired	Firmicutes_B	17289	P	291	11	302	0.00006
SRR9677956_1_kneaddata_paired	Spirochaetota	32587	P	133	0	133	0.00003
SRR9677956_1_kneaddata_paired	Campylobacterota	8700	P	58	0	58	0.00001
SRR9677956_1_kneaddata_paired	Firmicutes_C	17613	P	58	0	58	0.00001
SRR9677956_1_kneaddata_paired	Firmicutes_I	18140	P	44	0	44	0.00001
SRR9677956_1_kneaddata_paired	Thermotogota	33086	P	8	0	8	0.00000
SRR9677956_1_kneaddata_paired	Elusimicrobiota	11888	P	4	0	4	0.00000
SRR9677957_1_kneaddata_paired	Bacteroidota	4587	P	2851958	19953	2871911	0.65625
SRR9677957_1_kneaddata_paired	Firmicutes_A	14608	P	1266557	9951	1276508	0.29169
SRR9677957_1_kneaddata_paired	Firmicutes	12188	P	175457	1835	177292	0.04051
SRR9677957_1_kneaddata_paired	Proteobacteria	22518	P	21833	42	21875	0.00500
SRR9677957_1_kneaddata_paired	Cyanobacteria	9876	P	15959	148	16107	0.00368
SRR9677957_1_kneaddata_paired	Desulfobacterota_A	11509	P	6087	77	6164	0.00141
SRR9677957_1_kneaddata_paired	Actinobacteriota	615	P	3029	23	3052	0.00070
SRR9677957_1_kneaddata_paired	Deferribacterota	10822	P	2709	13	2722	0.00062
SRR9677957_1_kneaddata_paired	Spirochaetota	32587	P	164	0	164	0.00004
SRR9677957_1_kneaddata_paired	Firmicutes_B	17289	P	146	7	153	0.00003
SRR9677957_1_kneaddata_paired	Campylobacterota	8700	P	125	0	125	0.00003
SRR9677957_1_kneaddata_paired	Verrucomicrobiota	33333	P	61	2	63	0.00001
SRR9677957_1_kneaddata_paired	Firmicutes_I	18140	P	58	0	58	0.00001
SRR9677957_1_kneaddata_paired	Firmicutes_C	17613	P	46	0	46	0.00001
SRR9677957_1_kneaddata_paired	Thermotogota	33086	P	6	0	6	0.00000
SRR9677957_1_kneaddata_paired	Elusimicrobiota	11888	P	1	0	1	0.00000
SRR9677958_1_kneaddata_paired	Bacteroidota	4587	P	2974480	28109	3002589	0.74593
SRR9677958_1_kneaddata_paired	Firmicutes_A	14608	P	940284	8001	948285	0.23558
SRR9677958_1_kneaddata_paired	Firmicutes	12188	P	30881	385	31266	0.00777
SRR9677958_1_kneaddata_paired	Proteobacteria	22518	P	28512	56	28568	0.00710
SRR9677958_1_kneaddata_paired	Deferribacterota	10822	P	6703	26	6729	0.00167
SRR9677958_1_kneaddata_paired	Actinobacteriota	615	P	2652	14	2666	0.00066
SRR9677958_1_kneaddata_paired	Desulfobacterota_A	11509	P	2346	43	2389	0.00059
SRR9677958_1_kneaddata_paired	Cyanobacteria	9876	P	2216	24	2240	0.00056
SRR9677958_1_kneaddata_paired	Verrucomicrobiota	33333	P	331	5	336	0.00008
SRR9677958_1_kneaddata_paired	Firmicutes_B	17289	P	116	4	120	0.00003
SRR9677958_1_kneaddata_paired	Campylobacterota	8700	P	37	0	37	0.00001
SRR9677958_1_kneaddata_paired	Spirochaetota	32587	P	27	0	27	0.00001
SRR9677958_1_kneaddata_paired	Firmicutes_C	17613	P	18	0	18	0.00000
SRR9677958_1_kneaddata_paired	Firmicutes_I	18140	P	12	0	12	0.00000
SRR9677958_1_kneaddata_paired	Thermotogota	33086	P	2	0	2	0.00000
SRR9677959_1_kneaddata_paired	Firmicutes_A	14608	P	2705182	21662	2726844	0.61088
SRR9677959_1_kneaddata_paired	Bacteroidota	4587	P	1649730	10615	1660345	0.37196
SRR9677959_1_kneaddata_paired	Desulfobacterota_A	11509	P	53157	147	53304	0.01194
SRR9677959_1_kneaddata_paired	Firmicutes	12188	P	10744	222	10966	0.00246
SRR9677959_1_kneaddata_paired	Proteobacteria	22518	P	5307	14	5321	0.00119
SRR9677959_1_kneaddata_paired	Actinobacteriota	615	P	4869	38	4907	0.00110
SRR9677959_1_kneaddata_paired	Deferribacterota	10822	P	1083	5	1088	0.00024
SRR9677959_1_kneaddata_paired	Cyanobacteria	9876	P	636	12	648	0.00015
SRR9677959_1_kneaddata_paired	Spirochaetota	32587	P	190	0	190	0.00004
SRR9677959_1_kneaddata_paired	Verrucomicrobiota	33333	P	94	6	100	0.00002
SRR9677959_1_kneaddata_paired	Firmicutes_B	17289	P	32	1	33	0.00001
SRR9677959_1_kneaddata_paired	Campylobacterota	8700	P	21	0	21	0.00000
SRR9677959_1_kneaddata_paired	Firmicutes_C	17613	P	14	0	14	0.00000
SRR9677959_1_kneaddata_paired	Firmicutes_I	18140	P	12	0	12	0.00000
SRR9677959_1_kneaddata_paired	Thermotogota	33086	P	5	0	5	0.00000
SRR9677960_1_kneaddata_paired	Proteobacteria	22518	P	1979321	6707	1986028	0.56862
SRR9677960_1_kneaddata_paired	Bacteroidota	4587	P	1359655	9119	1368774	0.39189
SRR9677960_1_kneaddata_paired	Firmicutes_A	14608	P	112458	1211	113669	0.03254
SRR9677960_1_kneaddata_paired	Firmicutes	12188	P	18549	169	18718	0.00536
SRR9677960_1_kneaddata_paired	Desulfobacterota_A	11509	P	2980	15	2995	0.00086
SRR9677960_1_kneaddata_paired	Actinobacteriota	615	P	1840	8	1848	0.00053
SRR9677960_1_kneaddata_paired	Cyanobacteria	9876	P	335	4	339	0.00010
SRR9677960_1_kneaddata_paired	Verrucomicrobiota	33333	P	188	2	190	0.00005
SRR9677960_1_kneaddata_paired	Deferribacterota	10822	P	119	0	119	0.00003
SRR9677960_1_kneaddata_paired	Firmicutes_B	17289	P	16	0	16	0.00000
SRR9677960_1_kneaddata_paired	Campylobacterota	8700	P	15	0	15	0.00000
SRR9677960_1_kneaddata_paired	Spirochaetota	32587	P	15	0	15	0.00000
SRR9677960_1_kneaddata_paired	Firmicutes_I	18140	P	8	0	8	0.00000
SRR9677960_1_kneaddata_paired	Elusimicrobiota	11888	P	1	0	1	0.00000
SRR9677960_1_kneaddata_paired	Firmicutes_C	17613	P	1	0	1	0.00000
SRR9677961_1_kneaddata_paired	Bacteroidota	4587	P	4377744	41779	4419523	0.92276
SRR9677961_1_kneaddata_paired	Firmicutes_A	14608	P	285443	5692	291135	0.06079
SRR9677961_1_kneaddata_paired	Firmicutes	12188	P	25940	336	26276	0.00549
SRR9677961_1_kneaddata_paired	Verrucomicrobiota	33333	P	24105	404	24509	0.00512
SRR9677961_1_kneaddata_paired	Proteobacteria	22518	P	23000	54	23054	0.00481
SRR9677961_1_kneaddata_paired	Desulfobacterota_A	11509	P	2002	22	2024	0.00042
SRR9677961_1_kneaddata_paired	Actinobacteriota	615	P	1342	7	1349	0.00028
SRR9677961_1_kneaddata_paired	Deferribacterota	10822	P	968	4	972	0.00020
SRR9677961_1_kneaddata_paired	Cyanobacteria	9876	P	460	25	485	0.00010
SRR9677961_1_kneaddata_paired	Campylobacterota	8700	P	53	0	53	0.00001
SRR9677961_1_kneaddata_paired	Firmicutes_B	17289	P	24	1	25	0.00001
SRR9677961_1_kneaddata_paired	Firmicutes_I	18140	P	16	0	16	0.00000
SRR9677961_1_kneaddata_paired	Spirochaetota	32587	P	14	0	14	0.00000
SRR9677961_1_kneaddata_paired	Firmicutes_C	17613	P	8	0	8	0.00000
SRR9677962_1_kneaddata_paired	Bacteroidota	4587	P	3652111	29451	3681562	0.86694
SRR9677962_1_kneaddata_paired	Firmicutes_A	14608	P	353891	5578	359469	0.08465
SRR9677962_1_kneaddata_paired	Verrucomicrobiota	33333	P	148038	2420	150458	0.03543
SRR9677962_1_kneaddata_paired	Firmicutes	12188	P	28232	313	28545	0.00672
SRR9677962_1_kneaddata_paired	Proteobacteria	22518	P	18310	29	18339	0.00432
SRR9677962_1_kneaddata_paired	Desulfobacterota_A	11509	P	2860	20	2880	0.00068
SRR9677962_1_kneaddata_paired	Actinobacteriota	615	P	2437	17	2454	0.00058
SRR9677962_1_kneaddata_paired	Deferribacterota	10822	P	2358	10	2368	0.00056
SRR9677962_1_kneaddata_paired	Cyanobacteria	9876	P	367	11	378	0.00009
SRR9677962_1_kneaddata_paired	Campylobacterota	8700	P	94	0	94	0.00002
SRR9677962_1_kneaddata_paired	Firmicutes_B	17289	P	39	1	40	0.00001
SRR9677962_1_kneaddata_paired	Spirochaetota	32587	P	15	0	15	0.00000
SRR9677962_1_kneaddata_paired	Firmicutes_I	18140	P	14	0	14	0.00000
SRR9677962_1_kneaddata_paired	Firmicutes_C	17613	P	8	0	8	0.00000
SRR9677963_1_kneaddata_paired	Bacteroidota	4587	P	3030315	25055	3055370	0.51620
SRR9677963_1_kneaddata_paired	Firmicutes_A	14608	P	2740709	18055	2758764	0.46608
SRR9677963_1_kneaddata_paired	Verrucomicrobiota	33333	P	30323	389	30712	0.00519
SRR9677963_1_kneaddata_paired	Desulfobacterota_A	11509	P	25303	59	25362	0.00428
SRR9677963_1_kneaddata_paired	Deferribacterota	10822	P	18203	64	18267	0.00309
SRR9677963_1_kneaddata_paired	Firmicutes	12188	P	16212	227	16439	0.00278
SRR9677963_1_kneaddata_paired	Proteobacteria	22518	P	10028	18	10046	0.00170
SRR9677963_1_kneaddata_paired	Actinobacteriota	615	P	2790	13	2803	0.00047
SRR9677963_1_kneaddata_paired	Cyanobacteria	9876	P	971	17	988	0.00017
SRR9677963_1_kneaddata_paired	Firmicutes_B	17289	P	110	3	113	0.00002
SRR9677963_1_kneaddata_paired	Spirochaetota	32587	P	62	0	62	0.00001
SRR9677963_1_kneaddata_paired	Campylobacterota	8700	P	50	0	50	0.00001
SRR9677963_1_kneaddata_paired	Firmicutes_C	17613	P	21	0	21	0.00000
SRR9677963_1_kneaddata_paired	Firmicutes_I	18140	P	13	0	13	0.00000
SRR9677963_1_kneaddata_paired	Elusimicrobiota	11888	P	5	0	5	0.00000
SRR9677964_1_kneaddata_paired	Bacteroidota	4587	P	4150318	32140	4182458	0.86659
SRR9677964_1_kneaddata_paired	Firmicutes_A	14608	P	472725	6057	478782	0.09920
SRR9677964_1_kneaddata_paired	Verrucomicrobiota	33333	P	115799	1781	117580	0.02436
SRR9677964_1_kneaddata_paired	Firmicutes	12188	P	23048	271	23319	0.00483
SRR9677964_1_kneaddata_paired	Proteobacteria	22518	P	17548	29	17577	0.00364
SRR9677964_1_kneaddata_paired	Desulfobacterota_A	11509	P	2562	22	2584	0.00054
SRR9677964_1_kneaddata_paired	Actinobacteriota	615	P	2040	11	2051	0.00043
SRR9677964_1_kneaddata_paired	Deferribacterota	10822	P	1411	5	1416	0.00029
SRR9677964_1_kneaddata_paired	Cyanobacteria	9876	P	416	13	429	0.00009
SRR9677964_1_kneaddata_paired	Campylobacterota	8700	P	80	0	80	0.00002
SRR9677964_1_kneaddata_paired	Firmicutes_B	17289	P	34	1	35	0.00001
SRR9677964_1_kneaddata_paired	Spirochaetota	32587	P	12	0	12	0.00000
SRR9677964_1_kneaddata_paired	Firmicutes_I	18140	P	5	0	5	0.00000
SRR9677964_1_kneaddata_paired	Firmicutes_C	17613	P	4	0	4	0.00000
SRR9677964_1_kneaddata_paired	Thermotogota	33086	P	1	0	1	0.00000
SRR9677965_1_kneaddata_paired	Bacteroidota	4587	P	2699290	15671	2714961	0.64487
SRR9677965_1_kneaddata_paired	Firmicutes_A	14608	P	1395993	11281	1407274	0.33426
SRR9677965_1_kneaddata_paired	Firmicutes	12188	P	43427	556	43983	0.01045
SRR9677965_1_kneaddata_paired	Desulfobacterota_A	11509	P	20716	69	20785	0.00494
SRR9677965_1_kneaddata_paired	Proteobacteria	22518	P	15673	48	15721	0.00373
SRR9677965_1_kneaddata_paired	Cyanobacteria	9876	P	4597	246	4843	0.00115
SRR9677965_1_kneaddata_paired	Actinobacteriota	615	P	1862	10	1872	0.00044
SRR9677965_1_kneaddata_paired	Spirochaetota	32587	P	197	0	197	0.00005
SRR9677965_1_kneaddata_paired	Deferribacterota	10822	P	162	0	162	0.00004
SRR9677965_1_kneaddata_paired	Firmicutes_B	17289	P	113	4	117	0.00003
SRR9677965_1_kneaddata_paired	Verrucomicrobiota	33333	P	89	4	93	0.00002
SRR9677965_1_kneaddata_paired	Campylobacterota	8700	P	42	0	42	0.00001
SRR9677965_1_kneaddata_paired	Firmicutes_C	17613	P	25	0	25	0.00001
SRR9677965_1_kneaddata_paired	Firmicutes_I	18140	P	23	0	23	0.00001
SRR9677965_1_kneaddata_paired	Thermotogota	33086	P	3	0	3	0.00000
SRR9677965_1_kneaddata_paired	Elusimicrobiota	11888	P	1	0	1	0.00000
SRR9677966_1_kneaddata_paired	Firmicutes_A	14608	P	3703483	26527	3730010	0.55905
SRR9677966_1_kneaddata_paired	Bacteroidota	4587	P	2689314	17035	2706349	0.40562
SRR9677966_1_kneaddata_paired	Firmicutes	12188	P	104814	1495	106309	0.01593
SRR9677966_1_kneaddata_paired	Desulfobacterota_A	11509	P	74624	168	74792	0.01121
SRR9677966_1_kneaddata_paired	Deferribacterota	10822	P	37495	142	37637	0.00564
SRR9677966_1_kneaddata_paired	Actinobacteriota	615	P	8483	38	8521	0.00128
SRR9677966_1_kneaddata_paired	Proteobacteria	22518	P	5098	10	5108	0.00077
SRR9677966_1_kneaddata_paired	Cyanobacteria	9876	P	2579	32	2611	0.00039
SRR9677966_1_kneaddata_paired	Firmicutes_B	17289	P	203	7	210	0.00003
SRR9677966_1_kneaddata_paired	Spirochaetota	32587	P	192	0	192	0.00003
SRR9677966_1_kneaddata_paired	Verrucomicrobiota	33333	P	117	4	121	0.00002
SRR9677966_1_kneaddata_paired	Campylobacterota	8700	P	73	0	73	0.00001
SRR9677966_1_kneaddata_paired	Firmicutes_I	18140	P	55	0	55	0.00001
SRR9677966_1_kneaddata_paired	Firmicutes_C	17613	P	40	0	40	0.00001
SRR9677966_1_kneaddata_paired	Elusimicrobiota	11888	P	17	0	17	0.00000
SRR9677966_1_kneaddata_paired	Thermotogota	33086	P	2	0	2	0.00000
SRR9677967_1_kneaddata_paired	Bacteroidota	4587	P	3824373	27323	3851696	0.70453
SRR9677967_1_kneaddata_paired	Firmicutes_A	14608	P	1456265	14980	1471245	0.26911
SRR9677967_1_kneaddata_paired	Firmicutes	12188	P	83722	1344	85066	0.01556
SRR9677967_1_kneaddata_paired	Desulfobacterota_A	11509	P	27756	96	27852	0.00509
SRR9677967_1_kneaddata_paired	Proteobacteria	22518	P	16636	40	16676	0.00305
SRR9677967_1_kneaddata_paired	Actinobacteriota	615	P	7923	58	7981	0.00146
SRR9677967_1_kneaddata_paired	Deferribacterota	10822	P	3080	16	3096	0.00057
SRR9677967_1_kneaddata_paired	Cyanobacteria	9876	P	2585	94	2679	0.00049
SRR9677967_1_kneaddata_paired	Spirochaetota	32587	P	252	0	252	0.00005
SRR9677967_1_kneaddata_paired	Firmicutes_B	17289	P	204	10	214	0.00004
SRR9677967_1_kneaddata_paired	Verrucomicrobiota	33333	P	102	6	108	0.00002
SRR9677967_1_kneaddata_paired	Campylobacterota	8700	P	74	0	74	0.00001
SRR9677967_1_kneaddata_paired	Firmicutes_C	17613	P	46	0	46	0.00001
SRR9677967_1_kneaddata_paired	Firmicutes_I	18140	P	36	0	36	0.00001
SRR9677967_1_kneaddata_paired	Elusimicrobiota	11888	P	4	0	4	0.00000
SRR9677967_1_kneaddata_paired	Thermotogota	33086	P	3	0	3	0.00000
SRR9677968_1_kneaddata_paired	Bacteroidota	4587	P	3713999	22851	3736850	0.83063
SRR9677968_1_kneaddata_paired	Firmicutes_A	14608	P	352891	4979	357870	0.07955
SRR9677968_1_kneaddata_paired	Firmicutes	12188	P	349211	4301	353512	0.07858
SRR9677968_1_kneaddata_paired	Desulfobacterota_A	11509	P	22176	25	22201	0.00493
SRR9677968_1_kneaddata_paired	Actinobacteriota	615	P	19223	87	19310	0.00429
SRR9677968_1_kneaddata_paired	Proteobacteria	22518	P	7772	17	7789	0.00173
SRR9677968_1_kneaddata_paired	Cyanobacteria	9876	P	585	13	598	0.00013
SRR9677968_1_kneaddata_paired	Deferribacterota	10822	P	196	0	196	0.00004
SRR9677968_1_kneaddata_paired	Campylobacterota	8700	P	194	0	194	0.00004
SRR9677968_1_kneaddata_paired	Verrucomicrobiota	33333	P	103	3	106	0.00002
SRR9677968_1_kneaddata_paired	Spirochaetota	32587	P	89	0	89	0.00002
SRR9677968_1_kneaddata_paired	Firmicutes_B	17289	P	41	1	42	0.00001
SRR9677968_1_kneaddata_paired	Firmicutes_I	18140	P	26	0	26	0.00001
SRR9677968_1_kneaddata_paired	Elusimicrobiota	11888	P	11	0	11	0.00000
SRR9677968_1_kneaddata_paired	Firmicutes_C	17613	P	3	0	3	0.00000
SRR9677969_1_kneaddata_paired	Bacteroidota	4587	P	3567069	33844	3600913	0.84731
SRR9677969_1_kneaddata_paired	Firmicutes_A	14608	P	530065	7796	537861	0.12656
SRR9677969_1_kneaddata_paired	Firmicutes	12188	P	63220	808	64028	0.01507
SRR9677969_1_kneaddata_paired	Proteobacteria	22518	P	25536	61	25597	0.00602
SRR9677969_1_kneaddata_paired	Cyanobacteria	9876	P	9390	604	9994	0.00235
SRR9677969_1_kneaddata_paired	Desulfobacterota_A	11509	P	5959	40	5999	0.00141
SRR9677969_1_kneaddata_paired	Actinobacteriota	615	P	3625	32	3657	0.00086
SRR9677969_1_kneaddata_paired	Deferribacterota	10822	P	1148	3	1151	0.00027
SRR9677969_1_kneaddata_paired	Verrucomicrobiota	33333	P	302	6	308	0.00007
SRR9677969_1_kneaddata_paired	Firmicutes_B	17289	P	115	5	120	0.00003
SRR9677969_1_kneaddata_paired	Campylobacterota	8700	P	73	0	73	0.00002
SRR9677969_1_kneaddata_paired	Spirochaetota	32587	P	56	0	56	0.00001
SRR9677969_1_kneaddata_paired	Firmicutes_I	18140	P	24	0	24	0.00001
SRR9677969_1_kneaddata_paired	Firmicutes_C	17613	P	18	0	18	0.00000
SRR9677969_1_kneaddata_paired	Elusimicrobiota	11888	P	5	0	5	0.00000
SRR9677969_1_kneaddata_paired	Thermotogota	33086	P	2	0	2	0.00000
SRR9677970_1_kneaddata_paired	Bacteroidota	4587	P	2583617	18469	2602086	0.62018
SRR9677970_1_kneaddata_paired	Firmicutes_A	14608	P	1512372	12883	1525255	0.36353
SRR9677970_1_kneaddata_paired	Firmicutes	12188	P	39347	547	39894	0.00951
SRR9677970_1_kneaddata_paired	Proteobacteria	22518	P	18783	24	18807	0.00448
SRR9677970_1_kneaddata_paired	Desulfobacterota_A	11509	P	4871	47	4918	0.00117
SRR9677970_1_kneaddata_paired	Actinobacteriota	615	P	2529	19	2548	0.00061
SRR9677970_1_kneaddata_paired	Deferribacterota	10822	P	1307	5	1312	0.00031
SRR9677970_1_kneaddata_paired	Cyanobacteria	9876	P	584	12	596	0.00014
SRR9677970_1_kneaddata_paired	Firmicutes_B	17289	P	117	4	121	0.00003
SRR9677970_1_kneaddata_paired	Spirochaetota	32587	P	60	0	60	0.00001
SRR9677970_1_kneaddata_paired	Verrucomicrobiota	33333	P	49	1	50	0.00001
SRR9677970_1_kneaddata_paired	Campylobacterota	8700	P	27	0	27	0.00001
SRR9677970_1_kneaddata_paired	Firmicutes_C	17613	P	23	0	23	0.00001
SRR9677970_1_kneaddata_paired	Firmicutes_I	18140	P	13	0	13	0.00000
SRR9677970_1_kneaddata_paired	Elusimicrobiota	11888	P	3	0	3	0.00000
SRR9677970_1_kneaddata_paired	Thermotogota	33086	P	1	0	1	0.00000
SRR9677971_1_kneaddata_paired	Bacteroidota	4587	P	1454878	12111	1466989	0.62971
SRR9677971_1_kneaddata_paired	Firmicutes_A	14608	P	767472	6698	774170	0.33231
SRR9677971_1_kneaddata_paired	Firmicutes	12188	P	44531	846	45377	0.01948
SRR9677971_1_kneaddata_paired	Desulfobacterota_A	11509	P	19690	59	19749	0.00848
SRR9677971_1_kneaddata_paired	Actinobacteriota	615	P	8875	125	9000	0.00386
SRR9677971_1_kneaddata_paired	Verrucomicrobiota	33333	P	7256	607	7863	0.00338
SRR9677971_1_kneaddata_paired	Proteobacteria	22518	P	5201	11	5212	0.00224
SRR9677971_1_kneaddata_paired	Cyanobacteria	9876	P	815	74	889	0.00038
SRR9677971_1_kneaddata_paired	Spirochaetota	32587	P	164	0	164	0.00007
SRR9677971_1_kneaddata_paired	Firmicutes_B	17289	P	95	5	100	0.00004
SRR9677971_1_kneaddata_paired	Deferribacterota	10822	P	37	0	37	0.00002
SRR9677971_1_kneaddata_paired	Campylobacterota	8700	P	34	0	34	0.00001
SRR9677971_1_kneaddata_paired	Firmicutes_I	18140	P	21	0	21	0.00001
SRR9677971_1_kneaddata_paired	Firmicutes_C	17613	P	19	0	19	0.00001
SRR9677971_1_kneaddata_paired	Elusimicrobiota	11888	P	4	0	4	0.00000
SRR9677971_1_kneaddata_paired	Thermotogota	33086	P	3	0	3	0.00000
SRR9677972_1_kneaddata_paired	Bacteroidota	4587	P	2513795	19286	2533081	0.82854
SRR9677972_1_kneaddata_paired	Firmicutes_A	14608	P	417274	5162	422436	0.13817
SRR9677972_1_kneaddata_paired	Firmicutes	12188	P	67437	665	68102	0.02228
SRR9677972_1_kneaddata_paired	Proteobacteria	22518	P	12541	16	12557	0.00411
SRR9677972_1_kneaddata_paired	Actinobacteriota	615	P	8114	72	8186	0.00268
SRR9677972_1_kneaddata_paired	Desulfobacterota_A	11509	P	5149	15	5164	0.00169
SRR9677972_1_kneaddata_paired	Verrucomicrobiota	33333	P	3610	228	3838	0.00126
SRR9677972_1_kneaddata_paired	Cyanobacteria	9876	P	3467	224	3691	0.00121
SRR9677972_1_kneaddata_paired	Spirochaetota	32587	P	82	0	82	0.00003
SRR9677972_1_kneaddata_paired	Deferribacterota	10822	P	44	0	44	0.00001
SRR9677972_1_kneaddata_paired	Firmicutes_B	17289	P	35	1	36	0.00001
SRR9677972_1_kneaddata_paired	Campylobacterota	8700	P	33	0	33	0.00001
SRR9677972_1_kneaddata_paired	Firmicutes_C	17613	P	15	0	15	0.00000
SRR9677972_1_kneaddata_paired	Firmicutes_I	18140	P	8	0	8	0.00000
SRR9677972_1_kneaddata_paired	Thermotogota	33086	P	5	0	5	0.00000
SRR9677972_1_kneaddata_paired	Elusimicrobiota	11888	P	1	0	1	0.00000
SRR9677973_1_kneaddata_paired	Firmicutes_A	14608	P	3374353	24483	3398836	0.60302
SRR9677973_1_kneaddata_paired	Bacteroidota	4587	P	2133281	15642	2148923	0.38126
SRR9677973_1_kneaddata_paired	Desulfobacterota_A	11509	P	30076	96	30172	0.00535
SRR9677973_1_kneaddata_paired	Firmicutes	12188	P	25156	398	25554	0.00453
SRR9677973_1_kneaddata_paired	Proteobacteria	22518	P	12813	20	12833	0.00228
SRR9677973_1_kneaddata_paired	Verrucomicrobiota	33333	P	8029	122	8151	0.00145
SRR9677973_1_kneaddata_paired	Deferribacterota	10822	P	6875	27	6902	0.00122
SRR9677973_1_kneaddata_paired	Actinobacteriota	615	P	2932	17	2949	0.00052
SRR9677973_1_kneaddata_paired	Cyanobacteria	9876	P	1549	46	1595	0.00028
SRR9677973_1_kneaddata_paired	Firmicutes_B	17289	P	172	6	178	0.00003
SRR9677973_1_kneaddata_paired	Spirochaetota	32587	P	141	0	141	0.00003
SRR9677973_1_kneaddata_paired	Firmicutes_C	17613	P	39	0	39	0.00001
SRR9677973_1_kneaddata_paired	Campylobacterota	8700	P	32	0	32	0.00001
SRR9677973_1_kneaddata_paired	Firmicutes_I	18140	P	25	0	25	0.00000
SRR9677973_1_kneaddata_paired	Elusimicrobiota	11888	P	5	0	5	0.00000
SRR9677973_1_kneaddata_paired	Thermotogota	33086	P	4	0	4	0.00000
SRR9677974_1_kneaddata_paired	Firmicutes_A	14608	P	3155509	32798	3188307	0.75720
SRR9677974_1_kneaddata_paired	Bacteroidota	4587	P	952162	8167	960329	0.22807
SRR9677974_1_kneaddata_paired	Firmicutes	12188	P	24132	694	24826	0.00590
SRR9677974_1_kneaddata_paired	Desulfobacterota_A	11509	P	21162	183	21345	0.00507
SRR9677974_1_kneaddata_paired	Proteobacteria	22518	P	7060	31	7091	0.00168
SRR9677974_1_kneaddata_paired	Cyanobacteria	9876	P	4631	49	4680	0.00111
SRR9677974_1_kneaddata_paired	Deferribacterota	10822	P	2021	10	2031	0.00048
SRR9677974_1_kneaddata_paired	Actinobacteriota	615	P	1225	10	1235	0.00029
SRR9677974_1_kneaddata_paired	Firmicutes_B	17289	P	298	15	313	0.00007
SRR9677974_1_kneaddata_paired	Verrucomicrobiota	33333	P	288	22	310	0.00007
SRR9677974_1_kneaddata_paired	Spirochaetota	32587	P	64	0	64	0.00002
SRR9677974_1_kneaddata_paired	Firmicutes_C	17613	P	48	0	48	0.00001
SRR9677974_1_kneaddata_paired	Campylobacterota	8700	P	44	0	44	0.00001
SRR9677974_1_kneaddata_paired	Firmicutes_I	18140	P	32	0	32	0.00001
SRR9677974_1_kneaddata_paired	Elusimicrobiota	11888	P	11	0	11	0.00000
SRR9677974_1_kneaddata_paired	Thermotogota	33086	P	5	0	5	0.00000
SRR9677975_1_kneaddata_paired	Bacteroidota	4587	P	3021583	19252	3040835	0.64497
SRR9677975_1_kneaddata_paired	Firmicutes_A	14608	P	1263718	9906	1273624	0.27014
SRR9677975_1_kneaddata_paired	Verrucomicrobiota	33333	P	261452	4432	265884	0.05640
SRR9677975_1_kneaddata_paired	Desulfobacterota_A	11509	P	51191	92	51283	0.01088
SRR9677975_1_kneaddata_paired	Firmicutes	12188	P	48960	1247	50207	0.01065
SRR9677975_1_kneaddata_paired	Proteobacteria	22518	P	14118	49	14167	0.00301
SRR9677975_1_kneaddata_paired	Actinobacteriota	615	P	10550	36	10586	0.00225
SRR9677975_1_kneaddata_paired	Deferribacterota	10822	P	5941	27	5968	0.00127
SRR9677975_1_kneaddata_paired	Cyanobacteria	9876	P	1571	29	1600	0.00034
SRR9677975_1_kneaddata_paired	Firmicutes_B	17289	P	165	7	172	0.00004
SRR9677975_1_kneaddata_paired	Spirochaetota	32587	P	138	0	138	0.00003
SRR9677975_1_kneaddata_paired	Campylobacterota	8700	P	133	0	133	0.00003
SRR9677975_1_kneaddata_paired	Firmicutes_C	17613	P	33	0	33	0.00001
SRR9677975_1_kneaddata_paired	Firmicutes_I	18140	P	25	0	25	0.00001
SRR9677975_1_kneaddata_paired	Thermotogota	33086	P	9	0	9	0.00000
SRR9677975_1_kneaddata_paired	Elusimicrobiota	11888	P	2	0	2	0.00000
SRR9677976_1_kneaddata_paired	Bacteroidota	4587	P	3545816	29033	3574849	0.68158
SRR9677976_1_kneaddata_paired	Firmicutes_A	14608	P	1522404	14814	1537218	0.29309
SRR9677976_1_kneaddata_paired	Verrucomicrobiota	33333	P	53406	895	54301	0.01035
SRR9677976_1_kneaddata_paired	Firmicutes	12188	P	29707	584	30291	0.00578
SRR9677976_1_kneaddata_paired	Desulfobacterota_A	11509	P	23365	77	23442	0.00447
SRR9677976_1_kneaddata_paired	Proteobacteria	22518	P	17419	39	17458	0.00333
SRR9677976_1_kneaddata_paired	Actinobacteriota	615	P	3740	28	3768	0.00072
SRR9677976_1_kneaddata_paired	Cyanobacteria	9876	P	3026	177	3203	0.00061
SRR9677976_1_kneaddata_paired	Firmicutes_B	17289	P	119	5	124	0.00002
SRR9677976_1_kneaddata_paired	Deferribacterota	10822	P	115	0	115	0.00002
SRR9677976_1_kneaddata_paired	Spirochaetota	32587	P	66	0	66	0.00001
SRR9677976_1_kneaddata_paired	Campylobacterota	8700	P	53	0	53	0.00001
SRR9677976_1_kneaddata_paired	Firmicutes_C	17613	P	18	0	18	0.00000
SRR9677976_1_kneaddata_paired	Firmicutes_I	18140	P	16	0	16	0.00000
SRR9677976_1_kneaddata_paired	Elusimicrobiota	11888	P	1	0	1	0.00000
SRR9677976_1_kneaddata_paired	Thermotogota	33086	P	1	0	1	0.00000
SRR9677977_1_kneaddata_paired	Bacteroidota	4587	P	3027257	22378	3049635	0.65681
SRR9677977_1_kneaddata_paired	Firmicutes_A	14608	P	1464809	11372	1476181	0.31793
SRR9677977_1_kneaddata_paired	Desulfobacterota_A	11509	P	36619	72	36691	0.00790
SRR9677977_1_kneaddata_paired	Firmicutes	12188	P	32978	336	33314	0.00718
SRR9677977_1_kneaddata_paired	Verrucomicrobiota	33333	P	25926	375	26301	0.00566
SRR9677977_1_kneaddata_paired	Proteobacteria	22518	P	11333	19	11352	0.00244
SRR9677977_1_kneaddata_paired	Actinobacteriota	615	P	4586	27	4613	0.00099
SRR9677977_1_kneaddata_paired	Deferribacterota	10822	P	3854	15	3869	0.00083
SRR9677977_1_kneaddata_paired	Cyanobacteria	9876	P	839	11	850	0.00018
SRR9677977_1_kneaddata_paired	Firmicutes_B	17289	P	113	4	117	0.00003
SRR9677977_1_kneaddata_paired	Spirochaetota	32587	P	93	0	93	0.00002
SRR9677977_1_kneaddata_paired	Campylobacterota	8700	P	36	0	36	0.00001
SRR9677977_1_kneaddata_paired	Firmicutes_C	17613	P	18	0	18	0.00000
SRR9677977_1_kneaddata_paired	Firmicutes_I	18140	P	17	0	17	0.00000
SRR9677977_1_kneaddata_paired	Elusimicrobiota	11888	P	3	0	3	0.00000
SRR9677977_1_kneaddata_paired	Thermotogota	33086	P	2	0	2	0.00000
SRR9677978_1_kneaddata_paired	Bacteroidota	4587	P	3791040	30671	3821711	0.81691
SRR9677978_1_kneaddata_paired	Firmicutes_A	14608	P	671545	10186	681731	0.14572
SRR9677978_1_kneaddata_paired	Firmicutes	12188	P	108202	1136	109338	0.02337
SRR9677978_1_kneaddata_paired	Proteobacteria	22518	P	25979	78	26057	0.00557
SRR9677978_1_kneaddata_paired	Verrucomicrobiota	33333	P	10189	185	10374	0.00222
SRR9677978_1_kneaddata_paired	Desulfobacterota_A	11509	P	8673	37	8710	0.00186
SRR9677978_1_kneaddata_paired	Actinobacteriota	615	P	7114	63	7177	0.00153
SRR9677978_1_kneaddata_paired	Cyanobacteria	9876	P	6950	227	7177	0.00153
SRR9677978_1_kneaddata_paired	Deferribacterota	10822	P	5637	29	5666	0.00121
SRR9677978_1_kneaddata_paired	Firmicutes_B	17289	P	104	5	109	0.00002
SRR9677978_1_kneaddata_paired	Campylobacterota	8700	P	80	0	80	0.00002
SRR9677978_1_kneaddata_paired	Spirochaetota	32587	P	72	0	72	0.00002
SRR9677978_1_kneaddata_paired	Firmicutes_C	17613	P	31	0	31	0.00001
SRR9677978_1_kneaddata_paired	Firmicutes_I	18140	P	20	0	20	0.00000
SRR9677978_1_kneaddata_paired	Thermotogota	33086	P	7	0	7	0.00000
SRR9677978_1_kneaddata_paired	Elusimicrobiota	11888	P	2	0	2	0.00000
SRR9677979_1_kneaddata_paired	Bacteroidota	4587	P	1944200	14621	1958821	0.72303
SRR9677979_1_kneaddata_paired	Firmicutes_A	14608	P	691077	6117	697194	0.25735
SRR9677979_1_kneaddata_paired	Firmicutes	12188	P	33529	415	33944	0.01253
SRR9677979_1_kneaddata_paired	Proteobacteria	22518	P	11839	13	11852	0.00437
SRR9677979_1_kneaddata_paired	Deferribacterota	10822	P	2189	7	2196	0.00081
SRR9677979_1_kneaddata_paired	Actinobacteriota	615	P	2181	10	2191	0.00081
SRR9677979_1_kneaddata_paired	Desulfobacterota_A	11509	P	1248	12	1260	0.00047
SRR9677979_1_kneaddata_paired	Verrucomicrobiota	33333	P	1124	15	1139	0.00042
SRR9677979_1_kneaddata_paired	Cyanobacteria	9876	P	476	7	483	0.00018
SRR9677979_1_kneaddata_paired	Campylobacterota	8700	P	31	0	31	0.00001
SRR9677979_1_kneaddata_paired	Firmicutes_B	17289	P	31	1	32	0.00001
SRR9677979_1_kneaddata_paired	Spirochaetota	32587	P	16	0	16	0.00001
SRR9677979_1_kneaddata_paired	Firmicutes_I	18140	P	11	0	11	0.00000
SRR9677979_1_kneaddata_paired	Elusimicrobiota	11888	P	3	0	3	0.00000
SRR9677979_1_kneaddata_paired	Firmicutes_C	17613	P	2	0	2	0.00000
SRR9677979_1_kneaddata_paired	Thermotogota	33086	P	1	0	1	0.00000
SRR9677980_1_kneaddata_paired	Bacteroidota	4587	P	3150785	26182	3176967	0.64885
SRR9677980_1_kneaddata_paired	Firmicutes_A	14608	P	1606806	14416	1621222	0.33111
SRR9677980_1_kneaddata_paired	Firmicutes	12188	P	44468	551	45019	0.00919
SRR9677980_1_kneaddata_paired	Desulfobacterota_A	11509	P	20559	67	20626	0.00421
SRR9677980_1_kneaddata_paired	Proteobacteria	22518	P	17920	35	17955	0.00367
SRR9677980_1_kneaddata_paired	Verrucomicrobiota	33333	P	5648	97	5745	0.00117
SRR9677980_1_kneaddata_paired	Cyanobacteria	9876	P	4104	244	4348	0.00089
SRR9677980_1_kneaddata_paired	Actinobacteriota	615	P	3822	27	3849	0.00079
SRR9677980_1_kneaddata_paired	Deferribacterota	10822	P	167	0	167	0.00003
SRR9677980_1_kneaddata_paired	Firmicutes_B	17289	P	153	6	159	0.00003
SRR9677980_1_kneaddata_paired	Spirochaetota	32587	P	116	0	116	0.00002
SRR9677980_1_kneaddata_paired	Campylobacterota	8700	P	67	0	67	0.00001
SRR9677980_1_kneaddata_paired	Firmicutes_C	17613	P	23	0	23	0.00000
SRR9677980_1_kneaddata_paired	Firmicutes_I	18140	P	21	0	21	0.00000
SRR9677980_1_kneaddata_paired	Elusimicrobiota	11888	P	2	0	2	0.00000
SRR9677980_1_kneaddata_paired	Thermotogota	33086	P	2	0	2	0.00000
SRR9677981_1_kneaddata_paired	Bacteroidota	4587	P	2975954	24061	3000015	0.65649
SRR9677981_1_kneaddata_paired	Firmicutes_A	14608	P	1330094	11560	1341654	0.29359
SRR9677981_1_kneaddata_paired	Verrucomicrobiota	33333	P	89543	1372	90915	0.01990
SRR9677981_1_kneaddata_paired	Deferribacterota	10822	P	60217	256	60473	0.01323
SRR9677981_1_kneaddata_paired	Desulfobacterota_A	11509	P	37552	77	37629	0.00823
SRR9677981_1_kneaddata_paired	Firmicutes	12188	P	18646	227	18873	0.00413
SRR9677981_1_kneaddata_paired	Proteobacteria	22518	P	14862	27	14889	0.00326
SRR9677981_1_kneaddata_paired	Actinobacteriota	615	P	4439	26	4465	0.00098
SRR9677981_1_kneaddata_paired	Cyanobacteria	9876	P	412	12	424	0.00009
SRR9677981_1_kneaddata_paired	Firmicutes_B	17289	P	186	7	193	0.00004
SRR9677981_1_kneaddata_paired	Spirochaetota	32587	P	108	0	108	0.00002
SRR9677981_1_kneaddata_paired	Campylobacterota	8700	P	86	0	86	0.00002
SRR9677981_1_kneaddata_paired	Firmicutes_C	17613	P	25	0	25	0.00001
SRR9677981_1_kneaddata_paired	Firmicutes_I	18140	P	11	0	11	0.00000
SRR9677981_1_kneaddata_paired	Elusimicrobiota	11888	P	2	0	2	0.00000
SRR9677981_1_kneaddata_paired	Thermotogota	33086	P	2	0	2	0.00000
SRR9677982_1_kneaddata_paired	Bacteroidota	4587	P	2790604	21526	2812130	0.53790
SRR9677982_1_kneaddata_paired	Firmicutes_A	14608	P	2315160	15202	2330362	0.44575
SRR9677982_1_kneaddata_paired	Firmicutes	12188	P	45379	456	45835	0.00877
SRR9677982_1_kneaddata_paired	Desulfobacterota_A	11509	P	13778	39	13817	0.00264
SRR9677982_1_kneaddata_paired	Proteobacteria	22518	P	11492	15	11507	0.00220
SRR9677982_1_kneaddata_paired	Deferribacterota	10822	P	5182	17	5199	0.00099
SRR9677982_1_kneaddata_paired	Verrucomicrobiota	33333	P	4791	61	4852	0.00093
SRR9677982_1_kneaddata_paired	Actinobacteriota	615	P	2902	15	2917	0.00056
SRR9677982_1_kneaddata_paired	Cyanobacteria	9876	P	1138	13	1151	0.00022
SRR9677982_1_kneaddata_paired	Firmicutes_B	17289	P	70	2	72	0.00001
SRR9677982_1_kneaddata_paired	Campylobacterota	8700	P	40	0	40	0.00001
SRR9677982_1_kneaddata_paired	Spirochaetota	32587	P	35	0	35	0.00001
SRR9677982_1_kneaddata_paired	Firmicutes_C	17613	P	15	0	15	0.00000
SRR9677982_1_kneaddata_paired	Firmicutes_I	18140	P	7	0	7	0.00000
SRR9677982_1_kneaddata_paired	Elusimicrobiota	11888	P	5	0	5	0.00000
SRR9677982_1_kneaddata_paired	Thermotogota	33086	P	1	0	1	0.00000
SRR9677983_1_kneaddata_paired	Bacteroidota	4587	P	3295669	19930	3315599	0.58902
SRR9677983_1_kneaddata_paired	Firmicutes_A	14608	P	2209071	22025	2231096	0.39636
SRR9677983_1_kneaddata_paired	Desulfobacterota_A	11509	P	38099	126	38225	0.00679
SRR9677983_1_kneaddata_paired	Firmicutes	12188	P	20065	372	20437	0.00363
SRR9677983_1_kneaddata_paired	Proteobacteria	22518	P	12898	39	12937	0.00230
SRR9677983_1_kneaddata_paired	Actinobacteriota	615	P	4747	44	4791	0.00085
SRR9677983_1_kneaddata_paired	Deferribacterota	10822	P	4434	21	4455	0.00079
SRR9677983_1_kneaddata_paired	Cyanobacteria	9876	P	886	27	913	0.00016
SRR9677983_1_kneaddata_paired	Spirochaetota	32587	P	278	0	278	0.00005
SRR9677983_1_kneaddata_paired	Verrucomicrobiota	33333	P	82	4	86	0.00002
SRR9677983_1_kneaddata_paired	Firmicutes_B	17289	P	73	3	76	0.00001
SRR9677983_1_kneaddata_paired	Campylobacterota	8700	P	46	0	46	0.00001
SRR9677983_1_kneaddata_paired	Firmicutes_C	17613	P	38	0	38	0.00001
SRR9677983_1_kneaddata_paired	Firmicutes_I	18140	P	18	0	18	0.00000
SRR9677983_1_kneaddata_paired	Elusimicrobiota	11888	P	8	0	8	0.00000
SRR9677984_1_kneaddata_paired	Bacteroidota	4587	P	2560693	17985	2578678	0.78115
SRR9677984_1_kneaddata_paired	Firmicutes_A	14608	P	561132	9855	570987	0.17297
SRR9677984_1_kneaddata_paired	Firmicutes	12188	P	113583	1399	114982	0.03483
SRR9677984_1_kneaddata_paired	Actinobacteriota	615	P	20856	138	20994	0.00636
SRR9677984_1_kneaddata_paired	Proteobacteria	22518	P	8680	21	8701	0.00264
SRR9677984_1_kneaddata_paired	Desulfobacterota_A	11509	P	5515	28	5543	0.00168
SRR9677984_1_kneaddata_paired	Cyanobacteria	9876	P	736	53	789	0.00024
SRR9677984_1_kneaddata_paired	Verrucomicrobiota	33333	P	154	13	167	0.00005
SRR9677984_1_kneaddata_paired	Spirochaetota	32587	P	93	0	93	0.00003
SRR9677984_1_kneaddata_paired	Campylobacterota	8700	P	60	0	60	0.00002
SRR9677984_1_kneaddata_paired	Deferribacterota	10822	P	42	0	42	0.00001
SRR9677984_1_kneaddata_paired	Firmicutes_C	17613	P	26	0	26	0.00001
SRR9677984_1_kneaddata_paired	Firmicutes_B	17289	P	25	1	26	0.00001
SRR9677984_1_kneaddata_paired	Firmicutes_I	18140	P	15	0	15	0.00000
SRR9677984_1_kneaddata_paired	Elusimicrobiota	11888	P	4	0	4	0.00000
SRR9677984_1_kneaddata_paired	Thermotogota	33086	P	3	0	3	0.00000
SRR9677985_1_kneaddata_paired	Firmicutes_A	14608	P	2099080	16542	2115622	0.61068
SRR9677985_1_kneaddata_paired	Bacteroidota	4587	P	1207076	5242	1212318	0.34994
SRR9677985_1_kneaddata_paired	Firmicutes	12188	P	63914	807	64721	0.01868
SRR9677985_1_kneaddata_paired	Desulfobacterota_A	11509	P	54588	108	54696	0.01579
SRR9677985_1_kneaddata_paired	Actinobacteriota	615	P	10273	57	10330	0.00298
SRR9677985_1_kneaddata_paired	Proteobacteria	22518	P	3407	7	3414	0.00099
SRR9677985_1_kneaddata_paired	Cyanobacteria	9876	P	2491	130	2621	0.00076
SRR9677985_1_kneaddata_paired	Spirochaetota	32587	P	419	0	419	0.00012
SRR9677985_1_kneaddata_paired	Verrucomicrobiota	33333	P	64	3	67	0.00002
SRR9677985_1_kneaddata_paired	Campylobacterota	8700	P	36	0	36	0.00001
SRR9677985_1_kneaddata_paired	Firmicutes_B	17289	P	30	1	31	0.00001
SRR9677985_1_kneaddata_paired	Firmicutes_C	17613	P	28	0	28	0.00001
SRR9677985_1_kneaddata_paired	Deferribacterota	10822	P	21	0	21	0.00001
SRR9677985_1_kneaddata_paired	Elusimicrobiota	11888	P	16	0	16	0.00000
SRR9677985_1_kneaddata_paired	Thermotogota	33086	P	12	0	12	0.00000
SRR9677985_1_kneaddata_paired	Firmicutes_I	18140	P	4	0	4	0.00000
SRR9677986_1_kneaddata_paired	Bacteroidota	4587	P	1615480	8147	1623627	0.79588
SRR9677986_1_kneaddata_paired	Firmicutes_A	14608	P	370068	3072	373140	0.18291
SRR9677986_1_kneaddata_paired	Firmicutes	12188	P	32271	320	32591	0.01598
SRR9677986_1_kneaddata_paired	Proteobacteria	22518	P	3197	11	3208	0.00157
SRR9677986_1_kneaddata_paired	Desulfobacterota_A	11509	P	3169	16	3185	0.00156
SRR9677986_1_kneaddata_paired	Actinobacteriota	615	P	2550	17	2567	0.00126
SRR9677986_1_kneaddata_paired	Deferribacterota	10822	P	773	3	776	0.00038
SRR9677986_1_kneaddata_paired	Cyanobacteria	9876	P	708	33	741	0.00036
SRR9677986_1_kneaddata_paired	Verrucomicrobiota	33333	P	62	3	65	0.00003
SRR9677986_1_kneaddata_paired	Campylobacterota	8700	P	55	0	55	0.00003
SRR9677986_1_kneaddata_paired	Spirochaetota	32587	P	32	0	32	0.00002
SRR9677986_1_kneaddata_paired	Firmicutes_B	17289	P	29	1	30	0.00001
SRR9677986_1_kneaddata_paired	Firmicutes_I	18140	P	11	0	11	0.00001
SRR9677986_1_kneaddata_paired	Thermotogota	33086	P	8	0	8	0.00000
SRR9677986_1_kneaddata_paired	Firmicutes_C	17613	P	7	0	7	0.00000
SRR9677986_1_kneaddata_paired	Elusimicrobiota	11888	P	2	0	2	0.00000
SRR9677987_1_kneaddata_paired	Bacteroidota	4587	P	2170724	12652	2183376	0.71486
SRR9677987_1_kneaddata_paired	Firmicutes_A	14608	P	785555	6091	791646	0.25919
SRR9677987_1_kneaddata_paired	Firmicutes	12188	P	60611	459	61070	0.02000
SRR9677987_1_kneaddata_paired	Desulfobacterota_A	11509	P	5712	33	5745	0.00188
SRR9677987_1_kneaddata_paired	Cyanobacteria	9876	P	4250	99	4349	0.00142
SRR9677987_1_kneaddata_paired	Proteobacteria	22518	P	3590	18	3608	0.00118
SRR9677987_1_kneaddata_paired	Actinobacteriota	615	P	2840	22	2862	0.00094
SRR9677987_1_kneaddata_paired	Deferribacterota	10822	P	1215	4	1219	0.00040
SRR9677987_1_kneaddata_paired	Firmicutes_B	17289	P	121	4	125	0.00004
SRR9677987_1_kneaddata_paired	Campylobacterota	8700	P	81	0	81	0.00003
SRR9677987_1_kneaddata_paired	Verrucomicrobiota	33333	P	81	3	84	0.00003
SRR9677987_1_kneaddata_paired	Spirochaetota	32587	P	39	0	39	0.00001
SRR9677987_1_kneaddata_paired	Firmicutes_I	18140	P	25	0	25	0.00001
SRR9677987_1_kneaddata_paired	Firmicutes_C	17613	P	20	0	20	0.00001
SRR9677987_1_kneaddata_paired	Thermotogota	33086	P	3	0	3	0.00000
SRR9677987_1_kneaddata_paired	Elusimicrobiota	11888	P	1	0	1	0.00000
SRR9677988_1_kneaddata_paired	Bacteroidota	4587	P	2045508	12176	2057684	0.66272
SRR9677988_1_kneaddata_paired	Firmicutes_A	14608	P	933205	7371	940576	0.30293
SRR9677988_1_kneaddata_paired	Firmicutes	12188	P	68302	795	69097	0.02225
SRR9677988_1_kneaddata_paired	Desulfobacterota_A	11509	P	21836	67	21903	0.00705
SRR9677988_1_kneaddata_paired	Deferribacterota	10822	P	5066	21	5087	0.00164
SRR9677988_1_kneaddata_paired	Proteobacteria	22518	P	4644	15	4659	0.00150
SRR9677988_1_kneaddata_paired	Actinobacteriota	615	P	3987	32	4019	0.00129
SRR9677988_1_kneaddata_paired	Cyanobacteria	9876	P	1375	33	1408	0.00045
SRR9677988_1_kneaddata_paired	Firmicutes_B	17289	P	127	5	132	0.00004
SRR9677988_1_kneaddata_paired	Campylobacterota	8700	P	104	0	104	0.00003
SRR9677988_1_kneaddata_paired	Spirochaetota	32587	P	95	0	95	0.00003
SRR9677988_1_kneaddata_paired	Verrucomicrobiota	33333	P	60	2	62	0.00002
SRR9677988_1_kneaddata_paired	Firmicutes_C	17613	P	24	0	24	0.00001
SRR9677988_1_kneaddata_paired	Firmicutes_I	18140	P	24	0	24	0.00001
SRR9677988_1_kneaddata_paired	Elusimicrobiota	11888	P	4	0	4	0.00000
SRR9677988_1_kneaddata_paired	Thermotogota	33086	P	4	0	4	0.00000
SRR9677989_1_kneaddata_paired	Bacteroidota	4587	P	2026094	12594	2038688	0.55664
SRR9677989_1_kneaddata_paired	Firmicutes_A	14608	P	1455553	9168	1464721	0.39992
SRR9677989_1_kneaddata_paired	Firmicutes	12188	P	91071	735	91806	0.02507
SRR9677989_1_kneaddata_paired	Desulfobacterota_A	11509	P	54717	87	54804	0.01496
SRR9677989_1_kneaddata_paired	Actinobacteriota	615	P	7200	47	7247	0.00198
SRR9677989_1_kneaddata_paired	Proteobacteria	22518	P	3099	13	3112	0.00085
SRR9677989_1_kneaddata_paired	Deferribacterota	10822	P	723	2	725	0.00020
SRR9677989_1_kneaddata_paired	Cyanobacteria	9876	P	651	20	671	0.00018
SRR9677989_1_kneaddata_paired	Spirochaetota	32587	P	176	0	176	0.00005
SRR9677989_1_kneaddata_paired	Firmicutes_B	17289	P	163	6	169	0.00005
SRR9677989_1_kneaddata_paired	Campylobacterota	8700	P	148	0	148	0.00004
SRR9677989_1_kneaddata_paired	Verrucomicrobiota	33333	P	120	4	124	0.00003
SRR9677989_1_kneaddata_paired	Firmicutes_I	18140	P	55	0	55	0.00002
SRR9677989_1_kneaddata_paired	Firmicutes_C	17613	P	49	0	49	0.00001
SRR9677989_1_kneaddata_paired	Thermotogota	33086	P	4	0	4	0.00000
SRR9677989_1_kneaddata_paired	Elusimicrobiota	11888	P	3	0	3	0.00000
SRR9677990_1_kneaddata_paired	Bacteroidota	4587	P	2622508	20313	2642821	0.47724
SRR9677990_1_kneaddata_paired	Firmicutes_A	14608	P	2608742	14750	2623492	0.47375
SRR9677990_1_kneaddata_paired	Firmicutes	12188	P	143574	2290	145864	0.02634
SRR9677990_1_kneaddata_paired	Desulfobacterota_A	11509	P	75703	210	75913	0.01371
SRR9677990_1_kneaddata_paired	Deferribacterota	10822	P	27370	153	27523	0.00497
SRR9677990_1_kneaddata_paired	Actinobacteriota	615	P	10149	109	10258	0.00185
SRR9677990_1_kneaddata_paired	Proteobacteria	22518	P	7680	34	7714	0.00139
SRR9677990_1_kneaddata_paired	Cyanobacteria	9876	P	2151	67	2218	0.00040
SRR9677990_1_kneaddata_paired	Verrucomicrobiota	33333	P	792	65	857	0.00015
SRR9677990_1_kneaddata_paired	Campylobacterota	8700	P	335	0	335	0.00006
SRR9677990_1_kneaddata_paired	Spirochaetota	32587	P	307	0	307	0.00006
SRR9677990_1_kneaddata_paired	Firmicutes_B	17289	P	215	11	226	0.00004
SRR9677990_1_kneaddata_paired	Firmicutes_C	17613	P	70	0	70	0.00001
SRR9677990_1_kneaddata_paired	Firmicutes_I	18140	P	70	0	70	0.00001
SRR9677990_1_kneaddata_paired	Thermotogota	33086	P	17	0	17	0.00000
SRR9677990_1_kneaddata_paired	Elusimicrobiota	11888	P	7	0	7	0.00000
SRR9677991_1_kneaddata_paired	Bacteroidota	4587	P	2619090	18510	2637600	0.58570
SRR9677991_1_kneaddata_paired	Firmicutes_A	14608	P	1648018	12516	1660534	0.36873
SRR9677991_1_kneaddata_paired	Firmicutes	12188	P	122943	1509	124452	0.02764
SRR9677991_1_kneaddata_paired	Desulfobacterota_A	11509	P	49052	148	49200	0.01093
SRR9677991_1_kneaddata_paired	Proteobacteria	22518	P	8781	36	8817	0.00196
SRR9677991_1_kneaddata_paired	Cyanobacteria	9876	P	8619	440	9059	0.00201
SRR9677991_1_kneaddata_paired	Deferribacterota	10822	P	7749	36	7785	0.00173
SRR9677991_1_kneaddata_paired	Actinobacteriota	615	P	4440	36	4476	0.00099
SRR9677991_1_kneaddata_paired	Firmicutes_B	17289	P	382	17	399	0.00009
SRR9677991_1_kneaddata_paired	Campylobacterota	8700	P	381	0	381	0.00008
SRR9677991_1_kneaddata_paired	Spirochaetota	32587	P	305	0	305	0.00007
SRR9677991_1_kneaddata_paired	Verrucomicrobiota	33333	P	180	10	190	0.00004
SRR9677991_1_kneaddata_paired	Firmicutes_I	18140	P	62	0	62	0.00001
SRR9677991_1_kneaddata_paired	Firmicutes_C	17613	P	45	0	45	0.00001
SRR9677991_1_kneaddata_paired	Thermotogota	33086	P	38	0	38	0.00001
SRR9677991_1_kneaddata_paired	Elusimicrobiota	11888	P	11	0	11	0.00000
SRR9677992_1_kneaddata_paired	Bacteroidota	4587	P	2016310	10083	2026393	0.52056
SRR9677992_1_kneaddata_paired	Firmicutes_A	14608	P	1761482	15540	1777022	0.45650
SRR9677992_1_kneaddata_paired	Firmicutes	12188	P	37318	507	37825	0.00972
SRR9677992_1_kneaddata_paired	Desulfobacterota_A	11509	P	35515	71	35586	0.00914
SRR9677992_1_kneaddata_paired	Actinobacteriota	615	P	7315	39	7354	0.00189
SRR9677992_1_kneaddata_paired	Proteobacteria	22518	P	5273	13	5286	0.00136
SRR9677992_1_kneaddata_paired	Cyanobacteria	9876	P	2477	152	2629	0.00068
SRR9677992_1_kneaddata_paired	Spirochaetota	32587	P	277	0	277	0.00007
SRR9677992_1_kneaddata_paired	Verrucomicrobiota	33333	P	165	10	175	0.00005
SRR9677992_1_kneaddata_paired	Firmicutes_C	17613	P	33	0	33	0.00001
SRR9677992_1_kneaddata_paired	Campylobacterota	8700	P	31	0	31	0.00001
SRR9677992_1_kneaddata_paired	Deferribacterota	10822	P	31	0	31	0.00001
SRR9677992_1_kneaddata_paired	Firmicutes_B	17289	P	20	0	20	0.00001
SRR9677992_1_kneaddata_paired	Firmicutes_I	18140	P	10	0	10	0.00000
SRR9677992_1_kneaddata_paired	Thermotogota	33086	P	10	0	10	0.00000
SRR9677992_1_kneaddata_paired	Elusimicrobiota	11888	P	3	0	3	0.00000
SRR9677993_1_kneaddata_paired	Firmicutes_A	14608	P	2866731	21555	2888286	0.59909
SRR9677993_1_kneaddata_paired	Bacteroidota	4587	P	1765095	6960	1772055	0.36756
SRR9677993_1_kneaddata_paired	Desulfobacterota_A	11509	P	84643	114	84757	0.01758
SRR9677993_1_kneaddata_paired	Firmicutes	12188	P	61556	650	62206	0.01290
SRR9677993_1_kneaddata_paired	Actinobacteriota	615	P	7724	26	7750	0.00161
SRR9677993_1_kneaddata_paired	Proteobacteria	22518	P	3646	7	3653	0.00076
SRR9677993_1_kneaddata_paired	Cyanobacteria	9876	P	1344	34	1378	0.00029
SRR9677993_1_kneaddata_paired	Spirochaetota	32587	P	585	0	585	0.00012
SRR9677993_1_kneaddata_paired	Verrucomicrobiota	33333	P	251	12	263	0.00005
SRR9677993_1_kneaddata_paired	Firmicutes_B	17289	P	52	1	53	0.00001
SRR9677993_1_kneaddata_paired	Campylobacterota	8700	P	46	0	46	0.00001
SRR9677993_1_kneaddata_paired	Firmicutes_C	17613	P	35	0	35	0.00001
SRR9677993_1_kneaddata_paired	Deferribacterota	10822	P	31	0	31	0.00001
SRR9677993_1_kneaddata_paired	Thermotogota	33086	P	17	0	17	0.00000
SRR9677993_1_kneaddata_paired	Elusimicrobiota	11888	P	13	0	13	0.00000
SRR9677993_1_kneaddata_paired	Firmicutes_I	18140	P	1	0	1	0.00000
SRR9677994_1_kneaddata_paired	Bacteroidota	4587	P	3206957	21477	3228434	0.75381
SRR9677994_1_kneaddata_paired	Firmicutes_A	14608	P	954652	10011	964663	0.22524
SRR9677994_1_kneaddata_paired	Firmicutes	12188	P	43412	625	44037	0.01028
SRR9677994_1_kneaddata_paired	Proteobacteria	22518	P	30160	108	30268	0.00707
SRR9677994_1_kneaddata_paired	Desulfobacterota_A	11509	P	5428	47	5475	0.00128
SRR9677994_1_kneaddata_paired	Actinobacteriota	615	P	3941	37	3978	0.00093
SRR9677994_1_kneaddata_paired	Deferribacterota	10822	P	3192	17	3209	0.00075
SRR9677994_1_kneaddata_paired	Cyanobacteria	9876	P	2326	93	2419	0.00056
SRR9677994_1_kneaddata_paired	Spirochaetota	32587	P	105	0	105	0.00002
SRR9677994_1_kneaddata_paired	Firmicutes_B	17289	P	73	3	76	0.00002
SRR9677994_1_kneaddata_paired	Campylobacterota	8700	P	60	0	60	0.00001
SRR9677994_1_kneaddata_paired	Verrucomicrobiota	33333	P	40	1	41	0.00001
SRR9677994_1_kneaddata_paired	Firmicutes_I	18140	P	25	0	25	0.00001
SRR9677994_1_kneaddata_paired	Firmicutes_C	17613	P	14	0	14	0.00000
SRR9677994_1_kneaddata_paired	Thermotogota	33086	P	4	0	4	0.00000
SRR9677994_1_kneaddata_paired	Elusimicrobiota	11888	P	1	0	1	0.00000
SRR9677995_1_kneaddata_paired	Bacteroidota	4587	P	2667647	18838	2686485	0.70722
SRR9677995_1_kneaddata_paired	Firmicutes_A	14608	P	1020325	10421	1030746	0.27135
SRR9677995_1_kneaddata_paired	Firmicutes	12188	P	42253	611	42864	0.01128
SRR9677995_1_kneaddata_paired	Proteobacteria	22518	P	20481	50	20531	0.00540
SRR9677995_1_kneaddata_paired	Cyanobacteria	9876	P	8076	103	8179	0.00215
SRR9677995_1_kneaddata_paired	Desulfobacterota_A	11509	P	5423	49	5472	0.00144
SRR9677995_1_kneaddata_paired	Actinobacteriota	615	P	2331	20	2351	0.00062
SRR9677995_1_kneaddata_paired	Deferribacterota	10822	P	1667	8	1675	0.00044
SRR9677995_1_kneaddata_paired	Firmicutes_B	17289	P	123	6	129	0.00003
SRR9677995_1_kneaddata_paired	Spirochaetota	32587	P	69	0	69	0.00002
SRR9677995_1_kneaddata_paired	Campylobacterota	8700	P	57	0	57	0.00002
SRR9677995_1_kneaddata_paired	Verrucomicrobiota	33333	P	42	2	44	0.00001
SRR9677995_1_kneaddata_paired	Firmicutes_I	18140	P	29	0	29	0.00001
SRR9677995_1_kneaddata_paired	Firmicutes_C	17613	P	12	0	12	0.00000
SRR9677995_1_kneaddata_paired	Elusimicrobiota	11888	P	1	0	1	0.00000
SRR9677995_1_kneaddata_paired	Thermotogota	33086	P	1	0	1	0.00000
SRR9677996_1_kneaddata_paired	Proteobacteria	22518	P	1469370	3305	1472675	0.50447
SRR9677996_1_kneaddata_paired	Verrucomicrobiota	33333	P	731406	6040	737446	0.25261
SRR9677996_1_kneaddata_paired	Bacteroidota	4587	P	645173	4806	649979	0.22265
SRR9677996_1_kneaddata_paired	Firmicutes_A	14608	P	37678	174	37852	0.01297
SRR9677996_1_kneaddata_paired	Firmicutes	12188	P	17931	61	17992	0.00616
SRR9677996_1_kneaddata_paired	Cyanobacteria	9876	P	1205	13	1218	0.00042
SRR9677996_1_kneaddata_paired	Desulfobacterota_A	11509	P	764	3	767	0.00026
SRR9677996_1_kneaddata_paired	Actinobacteriota	615	P	592	0	592	0.00020
SRR9677996_1_kneaddata_paired	Deferribacterota	10822	P	513	0	513	0.00018
SRR9677996_1_kneaddata_paired	Campylobacterota	8700	P	226	0	226	0.00008
SRR9677996_1_kneaddata_paired	Spirochaetota	32587	P	12	0	12	0.00000
SRR9677996_1_kneaddata_paired	Firmicutes_B	17289	P	1	0	1	0.00000
SRR9677996_1_kneaddata_paired	Firmicutes_I	18140	P	1	0	1	0.00000
SRR9677997_1_kneaddata_paired	Bacteroidota	4587	P	2181561	24792	2206353	0.49787
SRR9677997_1_kneaddata_paired	Proteobacteria	22518	P	1954991	6287	1961278	0.44257
SRR9677997_1_kneaddata_paired	Firmicutes_A	14608	P	133334	807	134141	0.03027
SRR9677997_1_kneaddata_paired	Firmicutes	12188	P	66868	499	67367	0.01520
SRR9677997_1_kneaddata_paired	Verrucomicrobiota	33333	P	56684	662	57346	0.01294
SRR9677997_1_kneaddata_paired	Actinobacteriota	615	P	1550	2	1552	0.00035
SRR9677997_1_kneaddata_paired	Deferribacterota	10822	P	1394	4	1398	0.00032
SRR9677997_1_kneaddata_paired	Desulfobacterota_A	11509	P	1043	4	1047	0.00024
SRR9677997_1_kneaddata_paired	Cyanobacteria	9876	P	992	35	1027	0.00023
SRR9677997_1_kneaddata_paired	Campylobacterota	8700	P	33	0	33	0.00001
SRR9677997_1_kneaddata_paired	Firmicutes_B	17289	P	13	0	13	0.00000
SRR9677997_1_kneaddata_paired	Spirochaetota	32587	P	9	0	9	0.00000
SRR9677997_1_kneaddata_paired	Firmicutes_I	18140	P	6	0	6	0.00000
SRR9677998_1_kneaddata_paired	Bacteroidota	4587	P	1902621	21743	1924364	0.51976
SRR9677998_1_kneaddata_paired	Firmicutes_A	14608	P	1506977	12044	1519021	0.41028
SRR9677998_1_kneaddata_paired	Proteobacteria	22518	P	119217	280	119497	0.03228
SRR9677998_1_kneaddata_paired	Firmicutes	12188	P	118369	800	119169	0.03219
SRR9677998_1_kneaddata_paired	Desulfobacterota_A	11509	P	13262	78	13340	0.00360
SRR9677998_1_kneaddata_paired	Verrucomicrobiota	33333	P	2716	44	2760	0.00075
SRR9677998_1_kneaddata_paired	Actinobacteriota	615	P	1745	16	1761	0.00048
SRR9677998_1_kneaddata_paired	Cyanobacteria	9876	P	1471	61	1532	0.00041
SRR9677998_1_kneaddata_paired	Deferribacterota	10822	P	597	2	599	0.00016
SRR9677998_1_kneaddata_paired	Firmicutes_B	17289	P	164	7	171	0.00005
SRR9677998_1_kneaddata_paired	Spirochaetota	32587	P	81	0	81	0.00002
SRR9677998_1_kneaddata_paired	Campylobacterota	8700	P	62	0	62	0.00002
SRR9677998_1_kneaddata_paired	Firmicutes_C	17613	P	15	0	15	0.00000
SRR9677998_1_kneaddata_paired	Firmicutes_I	18140	P	10	0	10	0.00000
SRR9677998_1_kneaddata_paired	Elusimicrobiota	11888	P	2	0	2	0.00000
SRR9677998_1_kneaddata_paired	Thermotogota	33086	P	2	0	2	0.00000
SRR9677999_1_kneaddata_paired	Bacteroidota	4587	P	2518734	25774	2544508	0.71789
SRR9677999_1_kneaddata_paired	Firmicutes_A	14608	P	764004	7082	771086	0.21755
SRR9677999_1_kneaddata_paired	Firmicutes	12188	P	125096	981	126077	0.03557
SRR9677999_1_kneaddata_paired	Verrucomicrobiota	33333	P	46596	868	47464	0.01339
SRR9677999_1_kneaddata_paired	Proteobacteria	22518	P	42660	123	42783	0.01207
SRR9677999_1_kneaddata_paired	Desulfobacterota_A	11509	P	5001	47	5048	0.00142
SRR9677999_1_kneaddata_paired	Cyanobacteria	9876	P	2937	87	3024	0.00085
SRR9677999_1_kneaddata_paired	Actinobacteriota	615	P	1922	17	1939	0.00055
SRR9677999_1_kneaddata_paired	Deferribacterota	10822	P	1715	7	1722	0.00049
SRR9677999_1_kneaddata_paired	Firmicutes_B	17289	P	454	23	477	0.00013
SRR9677999_1_kneaddata_paired	Campylobacterota	8700	P	120	0	120	0.00003
SRR9677999_1_kneaddata_paired	Spirochaetota	32587	P	114	0	114	0.00003
SRR9677999_1_kneaddata_paired	Firmicutes_I	18140	P	31	0	31	0.00001
SRR9677999_1_kneaddata_paired	Firmicutes_C	17613	P	26	0	26	0.00001
SRR9677999_1_kneaddata_paired	Thermotogota	33086	P	12	0	12	0.00000
SRR9677999_1_kneaddata_paired	Elusimicrobiota	11888	P	2	0	2	0.00000
SRR9678000_1_kneaddata_paired	Bacteroidota	4587	P	2380493	25567	2406060	0.64054
SRR9678000_1_kneaddata_paired	Firmicutes_A	14608	P	896498	7000	903498	0.24053
SRR9678000_1_kneaddata_paired	Firmicutes	12188	P	223082	1307	224389	0.05974
SRR9678000_1_kneaddata_paired	Proteobacteria	22518	P	176584	597	177181	0.04717
SRR9678000_1_kneaddata_paired	Desulfobacterota_A	11509	P	30800	199	30999	0.00825
SRR9678000_1_kneaddata_paired	Actinobacteriota	615	P	12066	65	12131	0.00323
SRR9678000_1_kneaddata_paired	Cyanobacteria	9876	P	1152	34	1186	0.00032
SRR9678000_1_kneaddata_paired	Verrucomicrobiota	33333	P	326	20	346	0.00009
SRR9678000_1_kneaddata_paired	Firmicutes_B	17289	P	214	9	223	0.00006
SRR9678000_1_kneaddata_paired	Spirochaetota	32587	P	79	0	79	0.00002
SRR9678000_1_kneaddata_paired	Campylobacterota	8700	P	76	0	76	0.00002
SRR9678000_1_kneaddata_paired	Deferribacterota	10822	P	67	0	67	0.00002
SRR9678000_1_kneaddata_paired	Firmicutes_I	18140	P	23	0	23	0.00001
SRR9678000_1_kneaddata_paired	Firmicutes_C	17613	P	22	0	22	0.00001
SRR9678000_1_kneaddata_paired	Elusimicrobiota	11888	P	4	0	4	0.00000
SRR9678000_1_kneaddata_paired	Thermotogota	33086	P	3	0	3	0.00000
SRR9678001_1_kneaddata_paired	Proteobacteria	22518	P	1895537	6522	1902059	0.50813
SRR9678001_1_kneaddata_paired	Bacteroidota	4587	P	1538616	11321	1549937	0.41406
SRR9678001_1_kneaddata_paired	Firmicutes_A	14608	P	222869	1902	224771	0.06005
SRR9678001_1_kneaddata_paired	Firmicutes	12188	P	59487	395	59882	0.01600
SRR9678001_1_kneaddata_paired	Desulfobacterota_A	11509	P	3676	23	3699	0.00099
SRR9678001_1_kneaddata_paired	Actinobacteriota	615	P	1344	6	1350	0.00036
SRR9678001_1_kneaddata_paired	Verrucomicrobiota	33333	P	716	10	726	0.00019
SRR9678001_1_kneaddata_paired	Cyanobacteria	9876	P	598	13	611	0.00016
SRR9678001_1_kneaddata_paired	Deferribacterota	10822	P	115	0	115	0.00003
SRR9678001_1_kneaddata_paired	Firmicutes_B	17289	P	30	1	31	0.00001
SRR9678001_1_kneaddata_paired	Campylobacterota	8700	P	23	0	23	0.00001
SRR9678001_1_kneaddata_paired	Spirochaetota	32587	P	16	0	16	0.00000
SRR9678001_1_kneaddata_paired	Firmicutes_C	17613	P	13	0	13	0.00000
SRR9678001_1_kneaddata_paired	Firmicutes_I	18140	P	12	0	12	0.00000
SRR9678001_1_kneaddata_paired	Thermotogota	33086	P	3	0	3	0.00000
SRR9678001_1_kneaddata_paired	Elusimicrobiota	11888	P	2	0	2	0.00000
SRR9678002_1_kneaddata_paired	Proteobacteria	22518	P	1360723	3179	1363902	0.43341
SRR9678002_1_kneaddata_paired	Bacteroidota	4587	P	1131063	8270	1139333	0.36205
SRR9678002_1_kneaddata_paired	Verrucomicrobiota	33333	P	522112	4703	526815	0.16741
SRR9678002_1_kneaddata_paired	Firmicutes_A	14608	P	86347	629	86976	0.02764
SRR9678002_1_kneaddata_paired	Firmicutes	12188	P	17097	160	17257	0.00548
SRR9678002_1_kneaddata_paired	Deferribacterota	10822	P	5092	12	5104	0.00162
SRR9678002_1_kneaddata_paired	Actinobacteriota	615	P	3283	7	3290	0.00105
SRR9678002_1_kneaddata_paired	Desulfobacterota_A	11509	P	2826	9	2835	0.00090
SRR9678002_1_kneaddata_paired	Cyanobacteria	9876	P	1181	10	1191	0.00038
SRR9678002_1_kneaddata_paired	Campylobacterota	8700	P	144	0	144	0.00005
SRR9678002_1_kneaddata_paired	Firmicutes_B	17289	P	17	0	17	0.00001
SRR9678002_1_kneaddata_paired	Spirochaetota	32587	P	14	0	14	0.00000
SRR9678002_1_kneaddata_paired	Elusimicrobiota	11888	P	2	0	2	0.00000
SRR9678002_1_kneaddata_paired	Firmicutes_C	17613	P	1	0	1	0.00000
SRR9678002_1_kneaddata_paired	Firmicutes_I	18140	P	1	0	1	0.00000
SRR9678003_1_kneaddata_paired	Bacteroidota	4587	P	1165899	10627	1176526	0.53442
SRR9678003_1_kneaddata_paired	Proteobacteria	22518	P	722561	2094	724655	0.32917
SRR9678003_1_kneaddata_paired	Firmicutes_A	14608	P	222532	1351	223883	0.10170
SRR9678003_1_kneaddata_paired	Firmicutes	12188	P	37169	171	37340	0.01696
SRR9678003_1_kneaddata_paired	Verrucomicrobiota	33333	P	28211	302	28513	0.01295
SRR9678003_1_kneaddata_paired	Deferribacterota	10822	P	5657	14	5671	0.00258
SRR9678003_1_kneaddata_paired	Desulfobacterota_A	11509	P	2321	11	2332	0.00106
SRR9678003_1_kneaddata_paired	Cyanobacteria	9876	P	1764	67	1831	0.00083
SRR9678003_1_kneaddata_paired	Actinobacteriota	615	P	645	1	646	0.00029
SRR9678003_1_kneaddata_paired	Firmicutes_B	17289	P	33	0	33	0.00002
SRR9678003_1_kneaddata_paired	Spirochaetota	32587	P	25	0	25	0.00001
SRR9678003_1_kneaddata_paired	Campylobacterota	8700	P	15	0	15	0.00001
SRR9678003_1_kneaddata_paired	Firmicutes_C	17613	P	7	0	7	0.00000
SRR9678003_1_kneaddata_paired	Elusimicrobiota	11888	P	1	0	1	0.00000
SRR9678003_1_kneaddata_paired	Firmicutes_I	18140	P	1	0	1	0.00000
SRR9678003_1_kneaddata_paired	Thermotogota	33086	P	1	0	1	0.00000
SRR9678004_1_kneaddata_paired	Bacteroidota	4587	P	3653325	42154	3695479	0.59393
SRR9678004_1_kneaddata_paired	Firmicutes_A	14608	P	2327897	13687	2341584	0.37633
SRR9678004_1_kneaddata_paired	Firmicutes	12188	P	101901	544	102445	0.01646
SRR9678004_1_kneaddata_paired	Desulfobacterota_A	11509	P	35073	120	35193	0.00566
SRR9678004_1_kneaddata_paired	Proteobacteria	22518	P	25328	23	25351	0.00407
SRR9678004_1_kneaddata_paired	Actinobacteriota	615	P	20353	83	20436	0.00328
SRR9678004_1_kneaddata_paired	Cyanobacteria	9876	P	779	9	788	0.00013
SRR9678004_1_kneaddata_paired	Verrucomicrobiota	33333	P	354	13	367	0.00006
SRR9678004_1_kneaddata_paired	Deferribacterota	10822	P	177	0	177	0.00003
SRR9678004_1_kneaddata_paired	Spirochaetota	32587	P	127	0	127	0.00002
SRR9678004_1_kneaddata_paired	Firmicutes_B	17289	P	56	1	57	0.00001
SRR9678004_1_kneaddata_paired	Campylobacterota	8700	P	51	0	51	0.00001
SRR9678004_1_kneaddata_paired	Firmicutes_I	18140	P	25	0	25	0.00000
SRR9678004_1_kneaddata_paired	Firmicutes_C	17613	P	22	0	22	0.00000
SRR9678004_1_kneaddata_paired	Elusimicrobiota	11888	P	13	0	13	0.00000
SRR9678004_1_kneaddata_paired	Thermotogota	33086	P	3	0	3	0.00000
SRR9678005_1_kneaddata_paired	Bacteroidota	4587	P	4803693	44434	4848127	0.80852
SRR9678005_1_kneaddata_paired	Firmicutes_A	14608	P	500895	4926	505821	0.08436
SRR9678005_1_kneaddata_paired	Proteobacteria	22518	P	325271	730	326001	0.05437
SRR9678005_1_kneaddata_paired	Firmicutes	12188	P	161825	2608	164433	0.02742
SRR9678005_1_kneaddata_paired	Actinobacteriota	615	P	131867	563	132430	0.02209
SRR9678005_1_kneaddata_paired	Desulfobacterota_A	11509	P	13425	86	13511	0.00225
SRR9678005_1_kneaddata_paired	Verrucomicrobiota	33333	P	3974	271	4245	0.00071
SRR9678005_1_kneaddata_paired	Cyanobacteria	9876	P	899	59	958	0.00016
SRR9678005_1_kneaddata_paired	Deferribacterota	10822	P	336	1	337	0.00006
SRR9678005_1_kneaddata_paired	Firmicutes_B	17289	P	236	10	246	0.00004
SRR9678005_1_kneaddata_paired	Spirochaetota	32587	P	86	0	86	0.00001
SRR9678005_1_kneaddata_paired	Campylobacterota	8700	P	75	0	75	0.00001
SRR9678005_1_kneaddata_paired	Firmicutes_I	18140	P	27	0	27	0.00000
SRR9678005_1_kneaddata_paired	Firmicutes_C	17613	P	26	0	26	0.00000
SRR9678005_1_kneaddata_paired	Elusimicrobiota	11888	P	5	0	5	0.00000
SRR9678006_1_kneaddata_paired	Proteobacteria	22518	P	1241907	3312	1245219	0.32828
SRR9678006_1_kneaddata_paired	Bacteroidota	4587	P	1153362	6037	1159399	0.30565
SRR9678006_1_kneaddata_paired	Verrucomicrobiota	33333	P	666105	7964	674069	0.17771
SRR9678006_1_kneaddata_paired	Firmicutes_A	14608	P	639158	3734	642892	0.16949
SRR9678006_1_kneaddata_paired	Firmicutes	12188	P	55572	534	56106	0.01479
SRR9678006_1_kneaddata_paired	Desulfobacterota_A	11509	P	7639	38	7677	0.00202
SRR9678006_1_kneaddata_paired	Cyanobacteria	9876	P	3387	127	3514	0.00093
SRR9678006_1_kneaddata_paired	Actinobacteriota	615	P	2145	6	2151	0.00057
SRR9678006_1_kneaddata_paired	Deferribacterota	10822	P	1749	5	1754	0.00046
SRR9678006_1_kneaddata_paired	Campylobacterota	8700	P	264	0	264	0.00007
SRR9678006_1_kneaddata_paired	Firmicutes_B	17289	P	54	1	55	0.00001
SRR9678006_1_kneaddata_paired	Spirochaetota	32587	P	34	0	34	0.00001
SRR9678006_1_kneaddata_paired	Firmicutes_C	17613	P	18	0	18	0.00000
SRR9678006_1_kneaddata_paired	Thermotogota	33086	P	9	0	9	0.00000
SRR9678006_1_kneaddata_paired	Firmicutes_I	18140	P	8	0	8	0.00000
SRR9678006_1_kneaddata_paired	Elusimicrobiota	11888	P	3	0	3	0.00000
SRR9678007_1_kneaddata_paired	Bacteroidota	4587	P	2058351	15829	2074180	0.50281
SRR9678007_1_kneaddata_paired	Proteobacteria	22518	P	1846784	5520	1852304	0.44902
SRR9678007_1_kneaddata_paired	Firmicutes_A	14608	P	162794	1317	164111	0.03978
SRR9678007_1_kneaddata_paired	Firmicutes	12188	P	21333	418	21751	0.00527
SRR9678007_1_kneaddata_paired	Desulfobacterota_A	11509	P	6422	19	6441	0.00156
SRR9678007_1_kneaddata_paired	Actinobacteriota	615	P	2373	7	2380	0.00058
SRR9678007_1_kneaddata_paired	Cyanobacteria	9876	P	2303	85	2388	0.00058
SRR9678007_1_kneaddata_paired	Verrucomicrobiota	33333	P	880	9	889	0.00022
SRR9678007_1_kneaddata_paired	Deferribacterota	10822	P	624	1	625	0.00015
SRR9678007_1_kneaddata_paired	Campylobacterota	8700	P	45	0	45	0.00001
SRR9678007_1_kneaddata_paired	Firmicutes_B	17289	P	27	0	27	0.00001
SRR9678007_1_kneaddata_paired	Spirochaetota	32587	P	25	0	25	0.00001
SRR9678007_1_kneaddata_paired	Firmicutes_C	17613	P	6	0	6	0.00000
SRR9678007_1_kneaddata_paired	Firmicutes_I	18140	P	4	0	4	0.00000
SRR9678007_1_kneaddata_paired	Elusimicrobiota	11888	P	2	0	2	0.00000
SRR9678008_1_kneaddata_paired	Proteobacteria	22518	P	1921063	5275	1926338	0.50913
SRR9678008_1_kneaddata_paired	Bacteroidota	4587	P	1645425	13932	1659357	0.43857
SRR9678008_1_kneaddata_paired	Firmicutes_A	14608	P	70396	543	70939	0.01875
SRR9678008_1_kneaddata_paired	Verrucomicrobiota	33333	P	64631	656	65287	0.01726
SRR9678008_1_kneaddata_paired	Firmicutes	12188	P	56072	312	56384	0.01490
SRR9678008_1_kneaddata_paired	Desulfobacterota_A	11509	P	2923	9	2932	0.00078
SRR9678008_1_kneaddata_paired	Cyanobacteria	9876	P	1571	55	1626	0.00043
SRR9678008_1_kneaddata_paired	Actinobacteriota	615	P	511	1	512	0.00014
SRR9678008_1_kneaddata_paired	Deferribacterota	10822	P	153	0	153	0.00004
SRR9678008_1_kneaddata_paired	Campylobacterota	8700	P	43	0	43	0.00001
SRR9678008_1_kneaddata_paired	Firmicutes_B	17289	P	11	0	11	0.00000
SRR9678008_1_kneaddata_paired	Spirochaetota	32587	P	10	0	10	0.00000
SRR9678008_1_kneaddata_paired	Firmicutes_I	18140	P	6	0	6	0.00000
SRR9678008_1_kneaddata_paired	Firmicutes_C	17613	P	1	0	1	0.00000
SRR9678009_1_kneaddata_paired	Bacteroidota	4587	P	2473957	26018	2499975	0.56037
SRR9678009_1_kneaddata_paired	Proteobacteria	22518	P	1794484	5277	1799761	0.40342
SRR9678009_1_kneaddata_paired	Firmicutes_A	14608	P	78311	961	79272	0.01777
SRR9678009_1_kneaddata_paired	Firmicutes	12188	P	58552	712	59264	0.01328
SRR9678009_1_kneaddata_paired	Verrucomicrobiota	33333	P	11310	146	11456	0.00257
SRR9678009_1_kneaddata_paired	Cyanobacteria	9876	P	5330	278	5608	0.00126
SRR9678009_1_kneaddata_paired	Actinobacteriota	615	P	3144	5	3149	0.00071
SRR9678009_1_kneaddata_paired	Desulfobacterota_A	11509	P	2511	8	2519	0.00056
SRR9678009_1_kneaddata_paired	Deferribacterota	10822	P	257	0	257	0.00006
SRR9678009_1_kneaddata_paired	Campylobacterota	8700	P	26	0	26	0.00001
SRR9678009_1_kneaddata_paired	Spirochaetota	32587	P	9	0	9	0.00000
SRR9678009_1_kneaddata_paired	Firmicutes_B	17289	P	4	0	4	0.00000
SRR9678009_1_kneaddata_paired	Firmicutes_I	18140	P	3	0	3	0.00000
SRR9678010_1_kneaddata_paired	Bacteroidota	4587	P	2203222	22302	2225524	0.54607
SRR9678010_1_kneaddata_paired	Firmicutes_A	14608	P	1387809	13243	1401052	0.34377
SRR9678010_1_kneaddata_paired	Proteobacteria	22518	P	246760	782	247542	0.06074
SRR9678010_1_kneaddata_paired	Firmicutes	12188	P	170505	1890	172395	0.04230
SRR9678010_1_kneaddata_paired	Desulfobacterota_A	11509	P	19011	152	19163	0.00470
SRR9678010_1_kneaddata_paired	Actinobacteriota	615	P	6284	26	6310	0.00155
SRR9678010_1_kneaddata_paired	Cyanobacteria	9876	P	1828	55	1883	0.00046
SRR9678010_1_kneaddata_paired	Deferribacterota	10822	P	729	3	732	0.00018
SRR9678010_1_kneaddata_paired	Verrucomicrobiota	33333	P	496	14	510	0.00013
SRR9678010_1_kneaddata_paired	Campylobacterota	8700	P	150	0	150	0.00004
SRR9678010_1_kneaddata_paired	Firmicutes_B	17289	P	137	7	144	0.00004
SRR9678010_1_kneaddata_paired	Spirochaetota	32587	P	69	0	69	0.00002
SRR9678010_1_kneaddata_paired	Firmicutes_C	17613	P	27	0	27	0.00001
SRR9678010_1_kneaddata_paired	Firmicutes_I	18140	P	26	0	26	0.00001
SRR9678010_1_kneaddata_paired	Elusimicrobiota	11888	P	5	0	5	0.00000
SRR9678010_1_kneaddata_paired	Thermotogota	33086	P	2	0	2	0.00000
SRR9678011_1_kneaddata_paired	Bacteroidota	4587	P	2002677	16181	2018858	0.70996
SRR9678011_1_kneaddata_paired	Firmicutes_A	14608	P	434671	2768	437439	0.15383
SRR9678011_1_kneaddata_paired	Proteobacteria	22518	P	190797	627	191424	0.06732
SRR9678011_1_kneaddata_paired	Verrucomicrobiota	33333	P	113317	1726	115043	0.04046
SRR9678011_1_kneaddata_paired	Firmicutes	12188	P	66021	403	66424	0.02336
SRR9678011_1_kneaddata_paired	Desulfobacterota_A	11509	P	9677	57	9734	0.00342
SRR9678011_1_kneaddata_paired	Cyanobacteria	9876	P	2864	73	2937	0.00103
SRR9678011_1_kneaddata_paired	Actinobacteriota	615	P	1122	3	1125	0.00040
SRR9678011_1_kneaddata_paired	Firmicutes_B	17289	P	267	11	278	0.00010
SRR9678011_1_kneaddata_paired	Deferribacterota	10822	P	130	0	130	0.00005
SRR9678011_1_kneaddata_paired	Campylobacterota	8700	P	125	0	125	0.00004
SRR9678011_1_kneaddata_paired	Spirochaetota	32587	P	55	0	55	0.00002
SRR9678011_1_kneaddata_paired	Firmicutes_I	18140	P	26	0	26	0.00001
SRR9678011_1_kneaddata_paired	Firmicutes_C	17613	P	21	0	21	0.00001
SRR9678011_1_kneaddata_paired	Thermotogota	33086	P	5	0	5	0.00000
SRR9678011_1_kneaddata_paired	Elusimicrobiota	11888	P	2	0	2	0.00000
SRR9678012_1_kneaddata_paired	Bacteroidota	4587	P	2216708	17816	2234524	0.57879
SRR9678012_1_kneaddata_paired	Firmicutes_A	14608	P	1102747	11475	1114222	0.28861
SRR9678012_1_kneaddata_paired	Verrucomicrobiota	33333	P	280945	3810	284755	0.07376
SRR9678012_1_kneaddata_paired	Proteobacteria	22518	P	136022	249	136271	0.03530
SRR9678012_1_kneaddata_paired	Firmicutes	12188	P	77867	655	78522	0.02034
SRR9678012_1_kneaddata_paired	Desulfobacterota_A	11509	P	7399	63	7462	0.00193
SRR9678012_1_kneaddata_paired	Cyanobacteria	9876	P	2702	45	2747	0.00071
SRR9678012_1_kneaddata_paired	Actinobacteriota	615	P	1464	11	1475	0.00038
SRR9678012_1_kneaddata_paired	Deferribacterota	10822	P	305	0	305	0.00008
SRR9678012_1_kneaddata_paired	Campylobacterota	8700	P	166	0	166	0.00004
SRR9678012_1_kneaddata_paired	Firmicutes_B	17289	P	155	5	160	0.00004
SRR9678012_1_kneaddata_paired	Spirochaetota	32587	P	54	0	54	0.00001
SRR9678012_1_kneaddata_paired	Firmicutes_I	18140	P	14	0	14	0.00000
SRR9678012_1_kneaddata_paired	Firmicutes_C	17613	P	13	0	13	0.00000
SRR9678012_1_kneaddata_paired	Elusimicrobiota	11888	P	7	0	7	0.00000
SRR9678012_1_kneaddata_paired	Thermotogota	33086	P	2	0	2	0.00000
SRR9678013_1_kneaddata_paired	Firmicutes_A	14608	P	3454211	27215	3481426	0.59746
SRR9678013_1_kneaddata_paired	Bacteroidota	4587	P	1901361	13111	1914472	0.32855
SRR9678013_1_kneaddata_paired	Proteobacteria	22518	P	158900	715	159615	0.02739
SRR9678013_1_kneaddata_paired	Verrucomicrobiota	33333	P	139963	2471	142434	0.02444
SRR9678013_1_kneaddata_paired	Firmicutes	12188	P	75093	1141	76234	0.01308
SRR9678013_1_kneaddata_paired	Desulfobacterota_A	11509	P	44327	147	44474	0.00763
SRR9678013_1_kneaddata_paired	Actinobacteriota	615	P	5589	47	5636	0.00097
SRR9678013_1_kneaddata_paired	Cyanobacteria	9876	P	1497	36	1533	0.00026
SRR9678013_1_kneaddata_paired	Deferribacterota	10822	P	736	2	738	0.00013
SRR9678013_1_kneaddata_paired	Spirochaetota	32587	P	176	0	176	0.00003
SRR9678013_1_kneaddata_paired	Firmicutes_B	17289	P	151	7	158	0.00003
SRR9678013_1_kneaddata_paired	Campylobacterota	8700	P	122	0	122	0.00002
SRR9678013_1_kneaddata_paired	Firmicutes_I	18140	P	22	0	22	0.00000
SRR9678013_1_kneaddata_paired	Firmicutes_C	17613	P	21	0	21	0.00000
SRR9678013_1_kneaddata_paired	Elusimicrobiota	11888	P	6	0	6	0.00000
SRR9678013_1_kneaddata_paired	Thermotogota	33086	P	4	0	4	0.00000
SRR9678014_1_kneaddata_paired	Firmicutes_A	14608	P	3555235	21326	3576561	0.67740
SRR9678014_1_kneaddata_paired	Bacteroidota	4587	P	1619074	14451	1633525	0.30939
SRR9678014_1_kneaddata_paired	Desulfobacterota_A	11509	P	34526	61	34587	0.00655
SRR9678014_1_kneaddata_paired	Firmicutes	12188	P	23546	341	23887	0.00452
SRR9678014_1_kneaddata_paired	Proteobacteria	22518	P	5330	7	5337	0.00101
SRR9678014_1_kneaddata_paired	Actinobacteriota	615	P	2865	12	2877	0.00054
SRR9678014_1_kneaddata_paired	Deferribacterota	10822	P	1993	6	1999	0.00038
SRR9678014_1_kneaddata_paired	Cyanobacteria	9876	P	652	9	661	0.00013
SRR9678014_1_kneaddata_paired	Verrucomicrobiota	33333	P	132	5	137	0.00003
SRR9678014_1_kneaddata_paired	Firmicutes_B	17289	P	114	3	117	0.00002
SRR9678014_1_kneaddata_paired	Spirochaetota	32587	P	72	0	72	0.00001
SRR9678014_1_kneaddata_paired	Campylobacterota	8700	P	38	0	38	0.00001
SRR9678014_1_kneaddata_paired	Firmicutes_C	17613	P	22	0	22	0.00000
SRR9678014_1_kneaddata_paired	Firmicutes_I	18140	P	17	0	17	0.00000
SRR9678014_1_kneaddata_paired	Elusimicrobiota	11888	P	3	0	3	0.00000
SRR9678014_1_kneaddata_paired	Thermotogota	33086	P	3	0	3	0.00000
SRR9678015_1_kneaddata_paired	Bacteroidota	4587	P	2844866	23195	2868061	0.77309
SRR9678015_1_kneaddata_paired	Proteobacteria	22518	P	245961	1719	247680	0.06676
SRR9678015_1_kneaddata_paired	Firmicutes	12188	P	173899	2334	176233	0.04750
SRR9678015_1_kneaddata_paired	Verrucomicrobiota	33333	P	161599	2887	164486	0.04434
SRR9678015_1_kneaddata_paired	Firmicutes_A	14608	P	152577	1910	154487	0.04164
SRR9678015_1_kneaddata_paired	Actinobacteriota	615	P	71315	362	71677	0.01932
SRR9678015_1_kneaddata_paired	Desulfobacterota_A	11509	P	14278	93	14371	0.00387
SRR9678015_1_kneaddata_paired	Campylobacterota	8700	P	11815	0	11815	0.00318
SRR9678015_1_kneaddata_paired	Cyanobacteria	9876	P	865	46	911	0.00025
SRR9678015_1_kneaddata_paired	Deferribacterota	10822	P	72	0	72	0.00002
SRR9678015_1_kneaddata_paired	Spirochaetota	32587	P	56	0	56	0.00002
SRR9678015_1_kneaddata_paired	Firmicutes_B	17289	P	17	0	17	0.00000
SRR9678015_1_kneaddata_paired	Firmicutes_C	17613	P	9	0	9	0.00000
SRR9678015_1_kneaddata_paired	Elusimicrobiota	11888	P	5	0	5	0.00000
SRR9678015_1_kneaddata_paired	Firmicutes_I	18140	P	5	0	5	0.00000
T1_TMAO_B10_PL22_kneaddata	Bacteroidota	4587	P	3514992	34841	3549833	0.62536
T1_TMAO_B10_PL22_kneaddata	Firmicutes_A	14608	P	1828723	23520	1852243	0.32630
T1_TMAO_B10_PL22_kneaddata	Desulfobacterota_A	11509	P	140752	320	141072	0.02485
T1_TMAO_B10_PL22_kneaddata	Firmicutes	12188	P	64096	5122	69218	0.01219
T1_TMAO_B10_PL22_kneaddata	Proteobacteria	22518	P	34131	218	34349	0.00605
T1_TMAO_B10_PL22_kneaddata	Actinobacteriota	615	P	15581	307	15888	0.00280
T1_TMAO_B10_PL22_kneaddata	Cyanobacteria	9876	P	7457	89	7546	0.00133
T1_TMAO_B10_PL22_kneaddata	Firmicutes_B	17289	P	4830	516	5346	0.00094
T1_TMAO_B10_PL22_kneaddata	Spirochaetota	32587	P	351	0	351	0.00006
T1_TMAO_B10_PL22_kneaddata	Verrucomicrobiota	33333	P	290	19	309	0.00005
T1_TMAO_B10_PL22_kneaddata	Campylobacterota	8700	P	237	0	237	0.00004
T1_TMAO_B10_PL22_kneaddata	Firmicutes_I	18140	P	35	0	35	0.00001
T1_TMAO_B10_PL22_kneaddata	Firmicutes_C	17613	P	27	0	27	0.00000
T1_TMAO_B10_PL22_kneaddata	Thermotogota	33086	P	13	0	13	0.00000
T1_TMAO_B10_PL22_kneaddata	Deferribacterota	10822	P	10	0	10	0.00000
T1_TMAO_B10_PL22_kneaddata	Elusimicrobiota	11888	P	1	0	1	0.00000
T2_TMAO_B12_PL24_kneaddata	Firmicutes_A	14608	P	2173295	20461	2193756	0.61739
T2_TMAO_B12_PL24_kneaddata	Bacteroidota	4587	P	1002476	12162	1014638	0.28555
T2_TMAO_B12_PL24_kneaddata	Campylobacterota	8700	P	236308	12	236320	0.06651
T2_TMAO_B12_PL24_kneaddata	Desulfobacterota_A	11509	P	50364	155	50519	0.01422
T2_TMAO_B12_PL24_kneaddata	Firmicutes	12188	P	37121	1791	38912	0.01095
T2_TMAO_B12_PL24_kneaddata	Cyanobacteria	9876	P	10175	130	10305	0.00290
T2_TMAO_B12_PL24_kneaddata	Actinobacteriota	615	P	3975	32	4007	0.00113
T2_TMAO_B12_PL24_kneaddata	Proteobacteria	22518	P	2996	41	3037	0.00085
T2_TMAO_B12_PL24_kneaddata	Verrucomicrobiota	33333	P	1324	25	1349	0.00038
T2_TMAO_B12_PL24_kneaddata	Spirochaetota	32587	P	185	0	185	0.00005
T2_TMAO_B12_PL24_kneaddata	Firmicutes_B	17289	P	154	17	171	0.00005
T2_TMAO_B12_PL24_kneaddata	Firmicutes_I	18140	P	27	0	27	0.00001
T2_TMAO_B12_PL24_kneaddata	Firmicutes_C	17613	P	20	0	20	0.00001
T2_TMAO_B12_PL24_kneaddata	Deferribacterota	10822	P	12	0	12	0.00000
T2_TMAO_B12_PL24_kneaddata	Elusimicrobiota	11888	P	6	0	6	0.00000
T2_TMAO_B12_PL24_kneaddata	Thermotogota	33086	P	2	0	2	0.00000
T3_TMAO_C8_PL32_kneaddata	Firmicutes_A	14608	P	6613284	46373	6659657	0.66723
T3_TMAO_C8_PL32_kneaddata	Bacteroidota	4587	P	3138463	39541	3178004	0.31841
T3_TMAO_C8_PL32_kneaddata	Firmicutes	12188	P	64927	1859	66786	0.00669
T3_TMAO_C8_PL32_kneaddata	Desulfobacterota_A	11509	P	36480	132	36612	0.00367
T3_TMAO_C8_PL32_kneaddata	Cyanobacteria	9876	P	29106	219	29325	0.00294
T3_TMAO_C8_PL32_kneaddata	Actinobacteriota	615	P	4496	84	4580	0.00046
T3_TMAO_C8_PL32_kneaddata	Proteobacteria	22518	P	2743	38	2781	0.00028
T3_TMAO_C8_PL32_kneaddata	Firmicutes_B	17289	P	1630	142	1772	0.00018
T3_TMAO_C8_PL32_kneaddata	Verrucomicrobiota	33333	P	1091	34	1125	0.00011
T3_TMAO_C8_PL32_kneaddata	Spirochaetota	32587	P	170	0	170	0.00002
T3_TMAO_C8_PL32_kneaddata	Campylobacterota	8700	P	83	0	83	0.00001
T3_TMAO_C8_PL32_kneaddata	Firmicutes_I	18140	P	45	0	45	0.00000
T3_TMAO_C8_PL32_kneaddata	Firmicutes_C	17613	P	34	0	34	0.00000
T3_TMAO_C8_PL32_kneaddata	Deferribacterota	10822	P	16	0	16	0.00000
T3_TMAO_C8_PL32_kneaddata	Elusimicrobiota	11888	P	4	0	4	0.00000
T3_TMAO_C8_PL32_kneaddata	Thermotogota	33086	P	4	0	4	0.00000
T4_TMAO_D10_PL46_kneaddata	Firmicutes_A	14608	P	4217184	23496	4240680	0.75707
T4_TMAO_D10_PL46_kneaddata	Bacteroidota	4587	P	1235329	23870	1259199	0.22480
T4_TMAO_D10_PL46_kneaddata	Firmicutes	12188	P	47799	2089	49888	0.00891
T4_TMAO_D10_PL46_kneaddata	Verrucomicrobiota	33333	P	38570	429	38999	0.00696
T4_TMAO_D10_PL46_kneaddata	Actinobacteriota	615	P	10322	211	10533	0.00188
T4_TMAO_D10_PL46_kneaddata	Proteobacteria	22518	P	1008	16	1024	0.00018
T4_TMAO_D10_PL46_kneaddata	Cyanobacteria	9876	P	733	15	748	0.00013
T4_TMAO_D10_PL46_kneaddata	Desulfobacterota_A	11509	P	150	20	170	0.00003
T4_TMAO_D10_PL46_kneaddata	Campylobacterota	8700	P	49	0	49	0.00001
T4_TMAO_D10_PL46_kneaddata	Firmicutes_B	17289	P	40	3	43	0.00001
T4_TMAO_D10_PL46_kneaddata	Firmicutes_I	18140	P	34	0	34	0.00001
T4_TMAO_D10_PL46_kneaddata	Spirochaetota	32587	P	33	0	33	0.00001
T4_TMAO_D10_PL46_kneaddata	Deferribacterota	10822	P	32	0	32	0.00001
T4_TMAO_D10_PL46_kneaddata	Firmicutes_C	17613	P	8	0	8	0.00000
T4_TMAO_D10_PL46_kneaddata	Elusimicrobiota	11888	P	2	0	2	0.00000
T4_TMAO_D10_PL46_kneaddata	Thermotogota	33086	P	2	0	2	0.00000
T5_TMAO_E1_PL49_kneaddata	Firmicutes_A	14608	P	2791588	23638	2815226	0.59957
T5_TMAO_E1_PL49_kneaddata	Bacteroidota	4587	P	1141358	10710	1152068	0.24536
T5_TMAO_E1_PL49_kneaddata	Verrucomicrobiota	33333	P	518373	5570	523943	0.11159
T5_TMAO_E1_PL49_kneaddata	Desulfobacterota_A	11509	P	125484	189	125673	0.02676
T5_TMAO_E1_PL49_kneaddata	Firmicutes	12188	P	56744	2730	59474	0.01267
T5_TMAO_E1_PL49_kneaddata	Actinobacteriota	615	P	11861	163	12024	0.00256
T5_TMAO_E1_PL49_kneaddata	Cyanobacteria	9876	P	2412	33	2445	0.00052
T5_TMAO_E1_PL49_kneaddata	Firmicutes_B	17289	P	2270	196	2466	0.00053
T5_TMAO_E1_PL49_kneaddata	Proteobacteria	22518	P	1652	17	1669	0.00036
T5_TMAO_E1_PL49_kneaddata	Spirochaetota	32587	P	340	0	340	0.00007
T5_TMAO_E1_PL49_kneaddata	Campylobacterota	8700	P	56	0	56	0.00001
T5_TMAO_E1_PL49_kneaddata	Deferribacterota	10822	P	22	0	22	0.00000
T5_TMAO_E1_PL49_kneaddata	Firmicutes_I	18140	P	18	0	18	0.00000
T5_TMAO_E1_PL49_kneaddata	Firmicutes_C	17613	P	15	0	15	0.00000
T5_TMAO_E1_PL49_kneaddata	Elusimicrobiota	11888	P	1	0	1	0.00000
